Day,Date,Month,Season,Year,Hour,RestMH,MUMBAI,MH_STATE
1,1,1,1,2013,1,11289,1652,12941
1,1,1,1,2013,2,11116,1525,12641
1,1,1,1,2013,3,11019,1441,12460
1,1,1,1,2013,4,10889,1391,12280
1,1,1,1,2013,5,11201,1373,12574
1,1,1,1,2013,6,11865,1455,13320
1,1,1,1,2013,7,12951,1535,14486
1,1,1,1,2013,8,13526,1636,15162
1,1,1,1,2013,9,13535,1817,15352
1,1,1,1,2013,10,13716,2089,15805
1,1,1,1,2013,11,13944,2278,16222
1,1,1,1,2013,12,13930,2348,16278
1,1,1,1,2013,13,13632,2347,15979
1,1,1,1,2013,14,13299,2248,15547
1,1,1,1,2013,15,13332,2227,15559
1,1,1,1,2013,16,13418,2198,15616
1,1,1,1,2013,17,12795,2188,14983
1,1,1,1,2013,18,11790,2183,13973
1,1,1,1,2013,19,12202,2290,14492
1,1,1,1,2013,20,12085,2330,14415
1,1,1,1,2013,21,11691,2253,13944
1,1,1,1,2013,22,11226,2112,13338
1,1,1,1,2013,23,11379,1948,13327
1,1,1,1,2013,24,11160,1743,12903
1,2,1,1,2013,1,11143,1621,12764
1,2,1,1,2013,2,11019,1478,12497
1,2,1,1,2013,3,10789,1413,12202
1,2,1,1,2013,4,10933,1387,12320
1,2,1,1,2013,5,10942,1392,12334
1,2,1,1,2013,6,12128,1496,13624
1,2,1,1,2013,7,12980,1650,14630
1,2,1,1,2013,8,13229,1800,15029
1,2,1,1,2013,9,13566,2062,15628
1,2,1,1,2013,10,13828,2333,16161
1,2,1,1,2013,11,14061,2537,16598
1,2,1,1,2013,12,13901,2566,16467
1,2,1,1,2013,13,13646,2544,16190
1,2,1,1,2013,14,13126,2445,15571
1,2,1,1,2013,15,13331,2460,15791
1,2,1,1,2013,16,13395,2434,15829
1,2,1,1,2013,17,13035,2417,15452
1,2,1,1,2013,18,12076,2388,14464
1,2,1,1,2013,19,12529,2517,15046
1,2,1,1,2013,20,12239,2448,14687
1,2,1,1,2013,21,11810,2273,14083
1,2,1,1,2013,22,11280,2097,13377
1,2,1,1,2013,23,11295,1883,13178
1,2,1,1,2013,24,10964,1665,12629
1,3,1,1,2013,1,11080,1544,12624
1,3,1,1,2013,2,10951,1418,12369
1,3,1,1,2013,3,11019,1347,12366
1,3,1,1,2013,4,11052,1298,12350
1,3,1,1,2013,5,11050,1305,12355
1,3,1,1,2013,6,11990,1418,13408
1,3,1,1,2013,7,12757,1573,14330
1,3,1,1,2013,8,13716,1716,15432
1,3,1,1,2013,9,13917,1961,15878
1,3,1,1,2013,10,14074,2235,16309
1,3,1,1,2013,11,14258,2406,16664
1,3,1,1,2013,12,13756,2426,16182
1,3,1,1,2013,13,13844,2394,16238
1,3,1,1,2013,14,13486,2297,15783
1,3,1,1,2013,15,13595,2313,15908
1,3,1,1,2013,16,13626,2314,15940
1,3,1,1,2013,17,13174,2306,15480
1,3,1,1,2013,18,12312,2298,14610
1,3,1,1,2013,19,12643,2384,15027
1,3,1,1,2013,20,12360,2365,14725
1,3,1,1,2013,21,11851,2212,14063
1,3,1,1,2013,22,11630,2033,13663
1,3,1,1,2013,23,11616,1841,13457
1,3,1,1,2013,24,11373,1613,12986
1,4,1,1,2013,1,11158,1449,12607
1,4,1,1,2013,2,10870,1325,12195
1,4,1,1,2013,3,10913,1259,12172
1,4,1,1,2013,4,10982,1240,12222
1,4,1,1,2013,5,11218,1237,12455
1,4,1,1,2013,6,11983,1358,13341
1,4,1,1,2013,7,12683,1525,14208
1,4,1,1,2013,8,13152,1659,14811
1,4,1,1,2013,9,13180,1912,15092
1,4,1,1,2013,10,13347,2195,15542
1,4,1,1,2013,11,13020,2344,15364
1,4,1,1,2013,12,13194,2393,15587
1,4,1,1,2013,13,13099,2375,15474
1,4,1,1,2013,14,12827,2271,15098
1,4,1,1,2013,15,12630,2269,14899
1,4,1,1,2013,16,12408,2274,14682
1,4,1,1,2013,17,12211,2282,14493
1,4,1,1,2013,18,11240,2252,13492
1,4,1,1,2013,19,12016,2355,14371
1,4,1,1,2013,20,12076,2327,14403
1,4,1,1,2013,21,11504,2184,13688
1,4,1,1,2013,22,11264,2000,13264
1,4,1,1,2013,23,11333,1823,13156
1,4,1,1,2013,24,10681,1628,12309
2,5,1,1,2013,1,10854,1428,12282
2,5,1,1,2013,2,10838,1298,12136
2,5,1,1,2013,3,10848,1224,12072
2,5,1,1,2013,4,10910,1187,12097
2,5,1,1,2013,5,11075,1197,12272
2,5,1,1,2013,6,11594,1300,12894
2,5,1,1,2013,7,12328,1426,13754
2,5,1,1,2013,8,13230,1545,14775
2,5,1,1,2013,9,13394,1767,15161
2,5,1,1,2013,10,13706,2024,15730
2,5,1,1,2013,11,13814,2213,16027
2,5,1,1,2013,12,14057,2249,16306
2,5,1,1,2013,13,13079,2229,15308
2,5,1,1,2013,14,13064,2082,15146
2,5,1,1,2013,15,13183,2083,15266
2,5,1,1,2013,16,13225,2053,15278
2,5,1,1,2013,17,12658,2054,14712
2,5,1,1,2013,18,11783,2038,13821
2,5,1,1,2013,19,12363,2160,14523
2,5,1,1,2013,20,12348,2134,14482
2,5,1,1,2013,21,12290,2071,14361
2,5,1,1,2013,22,11746,1919,13665
2,5,1,1,2013,23,11399,1742,13141
2,5,1,1,2013,24,11359,1561,12920
2,6,1,1,2013,1,11108,1351,12459
2,6,1,1,2013,2,11000,1224,12224
2,6,1,1,2013,3,11053,1162,12215
2,6,1,1,2013,4,11059,1124,12183
2,6,1,1,2013,5,11304,1132,12436
2,6,1,1,2013,6,11526,1218,12744
2,6,1,1,2013,7,12228,1309,13537
2,6,1,1,2013,8,13046,1379,14425
2,6,1,1,2013,9,13429,1498,14927
2,6,1,1,2013,10,13724,1647,15371
2,6,1,1,2013,11,14207,1756,15963
2,6,1,1,2013,12,14083,1761,15844
2,6,1,1,2013,13,13591,1755,15346
2,6,1,1,2013,14,13085,1683,14768
2,6,1,1,2013,15,13086,1598,14684
2,6,1,1,2013,16,12948,1526,14474
2,6,1,1,2013,17,12398,1529,13927
2,6,1,1,2013,18,11671,1579,13250
2,6,1,1,2013,19,12220,1766,13986
2,6,1,1,2013,20,12373,1845,14218
2,6,1,1,2013,21,12010,1781,13791
2,6,1,1,2013,22,11478,1717,13195
2,6,1,1,2013,23,10907,1579,12486
2,6,1,1,2013,24,10860,1399,12259
1,8,1,1,2013,1,10964,1326,12290
1,8,1,1,2013,2,10806,1202,12008
1,8,1,1,2013,3,10730,1142,11872
1,8,1,1,2013,4,10677,1112,11789
1,8,1,1,2013,5,10952,1124,12076
1,8,1,1,2013,6,11867,1257,13124
1,8,1,1,2013,7,12495,1485,13980
1,8,1,1,2013,8,13501,1646,15147
1,8,1,1,2013,9,13731,1874,15605
1,8,1,1,2013,10,13979,2133,16112
1,8,1,1,2013,11,13967,2302,16269
1,8,1,1,2013,12,13909,2313,16222
1,8,1,1,2013,13,13700,2307,16007
1,8,1,1,2013,14,13308,2232,15540
1,8,1,1,2013,15,13305,2258,15563
1,8,1,1,2013,16,13191,2257,15448
1,8,1,1,2013,17,12815,2244,15059
1,8,1,1,2013,18,12148,2222,14370
1,8,1,1,2013,19,12443,2298,14741
1,8,1,1,2013,20,12297,2301,14598
1,8,1,1,2013,21,12040,2172,14212
1,8,1,1,2013,22,11342,1999,13341
1,8,1,1,2013,23,11452,1814,13266
1,8,1,1,2013,24,11151,1576,12727
1,9,1,1,2013,1,11114,1377,12491
1,9,1,1,2013,2,11115,1256,12371
1,9,1,1,2013,3,10990,1201,12191
1,9,1,1,2013,4,10934,1173,12107
1,9,1,1,2013,5,11376,1183,12559
1,9,1,1,2013,6,11817,1325,13142
1,9,1,1,2013,7,12621,1530,14151
1,9,1,1,2013,8,13762,1685,15447
1,9,1,1,2013,9,13880,1935,15815
1,9,1,1,2013,10,14095,2210,16305
1,9,1,1,2013,11,14016,2389,16405
1,9,1,1,2013,12,13908,2422,16330
1,9,1,1,2013,13,13760,2406,16166
1,9,1,1,2013,14,13484,2314,15798
1,9,1,1,2013,15,13320,2348,15668
1,9,1,1,2013,16,13563,2355,15918
1,9,1,1,2013,17,13181,2362,15543
1,9,1,1,2013,18,12363,2336,14699
1,9,1,1,2013,19,12728,2403,15131
1,9,1,1,2013,20,12351,2408,14759
1,9,1,1,2013,21,11842,2318,14160
1,9,1,1,2013,22,11187,2158,13345
1,9,1,1,2013,23,11062,1913,12975
1,9,1,1,2013,24,11245,1691,12936
1,10,1,1,2013,1,11125,1472,12597
1,10,1,1,2013,2,11066,1346,12412
1,10,1,1,2013,3,11102,1279,12381
1,10,1,1,2013,4,11062,1252,12314
1,10,1,1,2013,5,11261,1254,12515
1,10,1,1,2013,6,11776,1387,13163
1,10,1,1,2013,7,12834,1579,14413
1,10,1,1,2013,8,13842,1755,15597
1,10,1,1,2013,9,14006,1980,15986
1,10,1,1,2013,10,14146,2262,16408
1,10,1,1,2013,11,14272,2452,16724
1,10,1,1,2013,12,14142,2477,16619
1,10,1,1,2013,13,14011,2460,16471
1,10,1,1,2013,14,13547,2329,15876
1,10,1,1,2013,15,13518,2343,15861
1,10,1,1,2013,16,13418,2324,15742
1,10,1,1,2013,17,13074,2319,15393
1,10,1,1,2013,18,12345,2298,14643
1,10,1,1,2013,19,12629,2346,14975
1,10,1,1,2013,20,12277,2347,14624
1,10,1,1,2013,21,11789,2214,14003
1,10,1,1,2013,22,11141,2038,13179
1,10,1,1,2013,23,11495,1841,13336
1,10,1,1,2013,24,11374,1613,12987
1,11,1,1,2013,1,11279,1445,12724
1,11,1,1,2013,2,10956,1307,12263
1,11,1,1,2013,3,10789,1251,12040
1,11,1,1,2013,4,10924,1220,12144
1,11,1,1,2013,5,11073,1224,12297
1,11,1,1,2013,6,11977,1350,13327
1,11,1,1,2013,7,12891,1556,14447
1,11,1,1,2013,8,13313,1721,15034
1,11,1,1,2013,9,13468,1973,15441
1,11,1,1,2013,10,13793,2245,16038
1,11,1,1,2013,11,13741,2430,16171
1,11,1,1,2013,12,13620,2477,16097
1,11,1,1,2013,13,13350,2470,15820
1,11,1,1,2013,14,13029,2341,15370
1,11,1,1,2013,15,12788,2378,15166
1,11,1,1,2013,16,12780,2374,15154
1,11,1,1,2013,17,12122,2382,14504
1,11,1,1,2013,18,11574,2342,13916
1,11,1,1,2013,19,11944,2400,14344
1,11,1,1,2013,20,11881,2397,14278
1,11,1,1,2013,21,11386,2252,13638
1,11,1,1,2013,22,10866,2048,12914
1,11,1,1,2013,23,10639,1877,12516
1,11,1,1,2013,24,10973,1711,12684
2,12,1,1,2013,1,10785,1511,12296
2,12,1,1,2013,2,10888,1371,12259
2,12,1,1,2013,3,10657,1308,11965
2,12,1,1,2013,4,10845,1286,12131
2,12,1,1,2013,5,10994,1286,12280
2,12,1,1,2013,6,11482,1395,12877
2,12,1,1,2013,7,12338,1501,13839
2,12,1,1,2013,8,13538,1607,15145
2,12,1,1,2013,9,13877,1830,15707
2,12,1,1,2013,10,14135,2105,16240
2,12,1,1,2013,11,14151,2302,16453
2,12,1,1,2013,12,14290,2328,16618
2,12,1,1,2013,13,14071,2324,16395
2,12,1,1,2013,14,13615,2207,15822
2,12,1,1,2013,15,13566,2190,15756
2,12,1,1,2013,16,13817,2162,15979
2,12,1,1,2013,17,13155,2149,15304
2,12,1,1,2013,18,12180,2141,14321
2,12,1,1,2013,19,12725,2269,14994
2,12,1,1,2013,20,12287,2310,14597
2,12,1,1,2013,21,11780,2183,13963
2,12,1,1,2013,22,11597,2038,13635
2,12,1,1,2013,23,11184,1881,13065
2,12,1,1,2013,24,11070,1712,12782
2,13,1,1,2013,1,11108,1505,12613
2,13,1,1,2013,2,10987,1386,12373
2,13,1,1,2013,3,10931,1325,12256
2,13,1,1,2013,4,10940,1281,12221
2,13,1,1,2013,5,11233,1279,12512
2,13,1,1,2013,6,11791,1350,13141
2,13,1,1,2013,7,12685,1412,14097
2,13,1,1,2013,8,13448,1498,14946
2,13,1,1,2013,9,13954,1574,15528
2,13,1,1,2013,10,14008,1715,15723
2,13,1,1,2013,11,14709,1833,16542
2,13,1,1,2013,12,14256,1856,16112
2,13,1,1,2013,13,13920,1853,15773
2,13,1,1,2013,14,13418,1780,15198
2,13,1,1,2013,15,13493,1708,15201
2,13,1,1,2013,16,13573,1663,15236
2,13,1,1,2013,17,12953,1658,14611
2,13,1,1,2013,18,12020,1703,13723
2,13,1,1,2013,19,12078,1840,13918
2,13,1,1,2013,20,11937,1886,13823
2,13,1,1,2013,21,11647,1886,13533
2,13,1,1,2013,22,11434,1867,13301
2,13,1,1,2013,23,11122,1782,12904
2,13,1,1,2013,24,11067,1695,12762
1,14,1,1,2013,1,10907,1449,12356
1,14,1,1,2013,2,10919,1329,12248
1,14,1,1,2013,3,10779,1271,12050
1,14,1,1,2013,4,10852,1254,12106
1,14,1,1,2013,5,11092,1260,12352
1,14,1,1,2013,6,11531,1380,12911
1,14,1,1,2013,7,12761,1541,14302
1,14,1,1,2013,8,13490,1691,15181
1,14,1,1,2013,9,14008,1950,15958
1,14,1,1,2013,10,14349,2238,16587
1,14,1,1,2013,11,14496,2433,16929
1,14,1,1,2013,12,14327,2478,16805
1,14,1,1,2013,13,14189,2466,16655
1,14,1,1,2013,14,13608,2361,15969
1,14,1,1,2013,15,13523,2381,15904
1,14,1,1,2013,16,13645,2374,16019
1,14,1,1,2013,17,13097,2359,15456
1,14,1,1,2013,18,12040,2323,14363
1,14,1,1,2013,19,11865,2358,14223
1,14,1,1,2013,20,11973,2353,14326
1,14,1,1,2013,21,11737,2279,14016
1,14,1,1,2013,22,11615,2064,13679
1,14,1,1,2013,23,11100,1935,13035
1,14,1,1,2013,24,11109,1686,12795
1,15,1,1,2013,1,11181,1539,12720
1,15,1,1,2013,2,11046,1410,12456
1,15,1,1,2013,3,11082,1341,12423
1,15,1,1,2013,4,10955,1302,12257
1,15,1,1,2013,5,11333,1323,12656
1,15,1,1,2013,6,11991,1430,13421
1,15,1,1,2013,7,12777,1621,14398
1,15,1,1,2013,8,13864,1757,15621
1,15,1,1,2013,9,14197,1985,16182
1,15,1,1,2013,10,14314,2273,16587
1,15,1,1,2013,11,14348,2458,16806
1,15,1,1,2013,12,14281,2492,16773
1,15,1,1,2013,13,13976,2527,16503
1,15,1,1,2013,14,13845,2412,16257
1,15,1,1,2013,15,13819,2453,16272
1,15,1,1,2013,16,13606,2452,16058
1,15,1,1,2013,17,13702,2460,16162
1,15,1,1,2013,18,12428,2444,14872
1,15,1,1,2013,19,12748,2479,15227
1,15,1,1,2013,20,12691,2475,15166
1,15,1,1,2013,21,12421,2267,14688
1,15,1,1,2013,22,12037,2138,14175
1,15,1,1,2013,23,11515,1929,13444
1,15,1,1,2013,24,11677,1746,13423
1,16,1,1,2013,1,11527,1537,13064
1,16,1,1,2013,2,11476,1403,12879
1,16,1,1,2013,3,11334,1339,12673
1,16,1,1,2013,4,11461,1307,12768
1,16,1,1,2013,5,11747,1317,13064
1,16,1,1,2013,6,12257,1433,13690
1,16,1,1,2013,7,13226,1634,14860
1,16,1,1,2013,8,14076,1795,15871
1,16,1,1,2013,9,14365,2011,16376
1,16,1,1,2013,10,14475,2284,16759
1,16,1,1,2013,11,14383,2492,16875
1,16,1,1,2013,12,14343,2550,16893
1,16,1,1,2013,13,13865,2540,16405
1,16,1,1,2013,14,13613,2434,16047
1,16,1,1,2013,15,13544,2428,15972
1,16,1,1,2013,16,13764,2405,16169
1,16,1,1,2013,17,13060,2360,15420
1,16,1,1,2013,18,12461,2314,14775
1,16,1,1,2013,19,12545,2406,14951
1,16,1,1,2013,20,12812,2425,15237
1,16,1,1,2013,21,12133,2310,14443
1,16,1,1,2013,22,11624,2138,13762
1,16,1,1,2013,23,11792,1968,13760
1,16,1,1,2013,24,11534,1786,13320
1,17,1,1,2013,1,11538,1545,13083
1,17,1,1,2013,2,11367,1416,12783
1,17,1,1,2013,3,11526,1350,12876
1,17,1,1,2013,4,11567,1325,12892
1,17,1,1,2013,5,11791,1325,13116
1,17,1,1,2013,6,12509,1437,13946
1,17,1,1,2013,7,13323,1635,14958
1,17,1,1,2013,8,13947,1787,15734
1,17,1,1,2013,9,14228,2026,16254
1,17,1,1,2013,10,14327,2316,16643
1,17,1,1,2013,11,14146,2490,16636
1,17,1,1,2013,12,13931,2540,16471
1,17,1,1,2013,13,13081,2532,15613
1,17,1,1,2013,14,12946,2385,15331
1,17,1,1,2013,15,12905,2403,15308
1,17,1,1,2013,16,12968,2409,15377
1,17,1,1,2013,17,12681,2408,15089
1,17,1,1,2013,18,11603,2369,13972
1,17,1,1,2013,19,12623,2408,15031
1,17,1,1,2013,20,13094,2409,15503
1,17,1,1,2013,21,12651,2266,14917
1,17,1,1,2013,22,12045,2129,14174
1,17,1,1,2013,23,11747,1954,13701
1,17,1,1,2013,24,11471,1761,13232
1,18,1,1,2013,1,11366,1543,12909
1,18,1,1,2013,2,11417,1406,12823
1,18,1,1,2013,3,11394,1348,12742
1,18,1,1,2013,4,11595,1316,12911
1,18,1,1,2013,5,11705,1325,13030
1,18,1,1,2013,6,12120,1431,13551
1,18,1,1,2013,7,13032,1628,14660
1,18,1,1,2013,8,13967,1815,15782
1,18,1,1,2013,9,13971,2035,16006
1,18,1,1,2013,10,13916,2281,16197
1,18,1,1,2013,11,13749,2475,16224
1,18,1,1,2013,12,13611,2488,16099
1,18,1,1,2013,13,13163,2451,15614
1,18,1,1,2013,14,12711,2297,15008
1,18,1,1,2013,15,12286,2284,14570
1,18,1,1,2013,16,12395,2267,14662
1,18,1,1,2013,17,12058,2262,14320
1,18,1,1,2013,18,11336,2242,13578
1,18,1,1,2013,19,11780,2306,14086
1,18,1,1,2013,20,11999,2324,14323
1,18,1,1,2013,21,11563,2155,13718
1,18,1,1,2013,22,11213,1972,13185
1,18,1,1,2013,23,11223,1771,12994
1,18,1,1,2013,24,11289,1564,12853
2,19,1,1,2013,1,11112,1362,12474
2,19,1,1,2013,2,10951,1236,12187
2,19,1,1,2013,3,11027,1184,12211
2,19,1,1,2013,4,10956,1152,12108
2,19,1,1,2013,5,11060,1154,12214
2,19,1,1,2013,6,11499,1260,12759
2,19,1,1,2013,7,11809,1411,13220
2,19,1,1,2013,8,13066,1548,14614
2,19,1,1,2013,9,13633,1774,15407
2,19,1,1,2013,10,13934,2032,15966
2,19,1,1,2013,11,13971,2172,16143
2,19,1,1,2013,12,13853,2174,16027
2,19,1,1,2013,13,13332,2157,15489
2,19,1,1,2013,14,13235,2024,15259
2,19,1,1,2013,15,13265,2013,15278
2,19,1,1,2013,16,13335,2014,15349
2,19,1,1,2013,17,12918,2006,14924
2,19,1,1,2013,18,11854,2010,13864
2,19,1,1,2013,19,12445,2122,14567
2,19,1,1,2013,20,12280,2166,14446
2,19,1,1,2013,21,11799,2081,13880
2,19,1,1,2013,22,11333,1933,13266
2,19,1,1,2013,23,11686,1749,13435
2,19,1,1,2013,24,11490,1558,13048
2,20,1,1,2013,1,11393,1368,12761
2,20,1,1,2013,2,11171,1241,12412
2,20,1,1,2013,3,11211,1173,12384
2,20,1,1,2013,4,10966,1136,12102
2,20,1,1,2013,5,11242,1147,12389
2,20,1,1,2013,6,11557,1238,12795
2,20,1,1,2013,7,12034,1313,13347
2,20,1,1,2013,8,13533,1369,14902
2,20,1,1,2013,9,13483,1513,14996
2,20,1,1,2013,10,14145,1659,15804
2,20,1,1,2013,11,14193,1773,15966
2,20,1,1,2013,12,14075,1791,15866
2,20,1,1,2013,13,13794,1788,15582
2,20,1,1,2013,14,13298,1704,15002
2,20,1,1,2013,15,13209,1630,14839
2,20,1,1,2013,16,13259,1581,14840
2,20,1,1,2013,17,12754,1576,14330
2,20,1,1,2013,18,11589,1611,13200
2,20,1,1,2013,19,12032,1778,13810
2,20,1,1,2013,20,12153,1895,14048
2,20,1,1,2013,21,11851,1854,13705
2,20,1,1,2013,22,11511,1794,13305
2,20,1,1,2013,23,11208,1697,12905
2,20,1,1,2013,24,11268,1538,12806
1,21,1,1,2013,1,11252,1334,12586
1,21,1,1,2013,2,10872,1215,12087
1,21,1,1,2013,3,11014,1161,12175
1,21,1,1,2013,4,11148,1125,12273
1,21,1,1,2013,5,11359,1149,12508
1,21,1,1,2013,6,11943,1273,13216
1,21,1,1,2013,7,12706,1483,14189
1,21,1,1,2013,8,13455,1642,15097
1,21,1,1,2013,9,13955,1889,15844
1,21,1,1,2013,10,13976,2163,16139
1,21,1,1,2013,11,14143,2315,16458
1,21,1,1,2013,12,13926,2364,16290
1,21,1,1,2013,13,13698,2328,16026
1,21,1,1,2013,14,13362,2242,15604
1,21,1,1,2013,15,13311,2255,15566
1,21,1,1,2013,16,13283,2252,15535
1,21,1,1,2013,17,12905,2246,15151
1,21,1,1,2013,18,11737,2247,13984
1,21,1,1,2013,19,12283,2274,14557
1,21,1,1,2013,20,12395,2318,14713
1,21,1,1,2013,21,12156,2139,14295
1,21,1,1,2013,22,11653,1981,13634
1,21,1,1,2013,23,11424,1788,13212
1,21,1,1,2013,24,11728,1568,13296
1,22,1,1,2013,1,11281,1406,12687
1,22,1,1,2013,2,11150,1287,12437
1,22,1,1,2013,3,11139,1213,12352
1,22,1,1,2013,4,11276,1186,12462
1,22,1,1,2013,5,11529,1213,12742
1,22,1,1,2013,6,11756,1339,13095
1,22,1,1,2013,7,12663,1557,14220
1,22,1,1,2013,8,13571,1737,15308
1,22,1,1,2013,9,14187,1974,16161
1,22,1,1,2013,10,14267,2238,16505
1,22,1,1,2013,11,14212,2390,16602
1,22,1,1,2013,12,13995,2431,16426
1,22,1,1,2013,13,13663,2404,16067
1,22,1,1,2013,14,13480,2306,15786
1,22,1,1,2013,15,13364,2330,15694
1,22,1,1,2013,16,13509,2337,15846
1,22,1,1,2013,17,13082,2328,15410
1,22,1,1,2013,18,12035,2304,14339
1,22,1,1,2013,19,12714,2350,15064
1,22,1,1,2013,20,12800,2381,15181
1,22,1,1,2013,21,12110,2203,14313
1,22,1,1,2013,22,11753,2027,13780
1,22,1,1,2013,23,11576,1859,13435
1,22,1,1,2013,24,11591,1648,13239
1,23,1,1,2013,1,11371,1438,12809
1,23,1,1,2013,2,11370,1307,12677
1,23,1,1,2013,3,11351,1245,12596
1,23,1,1,2013,4,11438,1217,12655
1,23,1,1,2013,5,11598,1244,12842
1,23,1,1,2013,6,12225,1356,13581
1,23,1,1,2013,7,12899,1563,14462
1,23,1,1,2013,8,14089,1745,15834
1,23,1,1,2013,9,14114,1977,16091
1,23,1,1,2013,10,14258,2244,16502
1,23,1,1,2013,11,14394,2422,16816
1,23,1,1,2013,12,13859,2467,16326
1,23,1,1,2013,13,13988,2449,16437
1,23,1,1,2013,14,13396,2331,15727
1,23,1,1,2013,15,13433,2338,15771
1,23,1,1,2013,16,13559,2357,15916
1,23,1,1,2013,17,13218,2345,15563
1,23,1,1,2013,18,12227,2335,14562
1,23,1,1,2013,19,12923,2367,15290
1,23,1,1,2013,20,12948,2416,15364
1,23,1,1,2013,21,12577,2244,14821
1,23,1,1,2013,22,12004,2076,14080
1,23,1,1,2013,23,11783,1883,13666
1,23,1,1,2013,24,11589,1660,13249
1,24,1,1,2013,1,11369,1455,12824
1,24,1,1,2013,2,11181,1322,12503
1,24,1,1,2013,3,11515,1255,12770
1,24,1,1,2013,4,11211,1230,12441
1,24,1,1,2013,5,11225,1244,12469
1,24,1,1,2013,6,11911,1358,13269
1,24,1,1,2013,7,12989,1562,14551
1,24,1,1,2013,8,14086,1732,15818
1,24,1,1,2013,9,14216,1968,16184
1,24,1,1,2013,10,13919,2245,16164
1,24,1,1,2013,11,13821,2420,16241
1,24,1,1,2013,12,13216,2444,15660
1,24,1,1,2013,13,13125,2418,15543
1,24,1,1,2013,14,12701,2301,15002
1,24,1,1,2013,15,12830,2320,15150
1,24,1,1,2013,16,13045,2316,15361
1,24,1,1,2013,17,12459,2324,14783
1,24,1,1,2013,18,11775,2316,14091
1,24,1,1,2013,19,12182,2359,14541
1,24,1,1,2013,20,12567,2386,14953
1,24,1,1,2013,21,12087,2242,14329
1,24,1,1,2013,22,11730,2051,13781
1,24,1,1,2013,23,11538,1844,13382
1,24,1,1,2013,24,11493,1644,13137
3,25,1,1,2013,1,10907,1493,12400
3,25,1,1,2013,2,10960,1341,12301
3,25,1,1,2013,3,10887,1272,12159
3,25,1,1,2013,4,10872,1241,12113
3,25,1,1,2013,5,11031,1267,12298
3,25,1,1,2013,6,11506,1360,12866
3,25,1,1,2013,7,12281,1489,13770
3,25,1,1,2013,8,13273,1647,14920
3,25,1,1,2013,9,13804,1862,15666
3,25,1,1,2013,10,13881,2166,16047
3,25,1,1,2013,11,13444,2359,15803
3,25,1,1,2013,12,13180,2390,15570
3,25,1,1,2013,13,12987,2374,15361
3,25,1,1,2013,14,12701,2222,14923
3,25,1,1,2013,15,12441,2210,14651
3,25,1,1,2013,16,12698,2185,14883
3,25,1,1,2013,17,12055,2184,14239
3,25,1,1,2013,18,11600,2161,13761
3,25,1,1,2013,19,12267,2235,14502
3,25,1,1,2013,20,12666,2295,14961
3,25,1,1,2013,21,12352,2175,14527
3,25,1,1,2013,22,11714,1991,13705
3,25,1,1,2013,23,11424,1819,13243
3,25,1,1,2013,24,11150,1651,12801
2,26,1,1,2013,1,10946,1466,12412
2,26,1,1,2013,2,10976,1328,12304
2,26,1,1,2013,3,10753,1272,12025
2,26,1,1,2013,4,11003,1232,12235
2,26,1,1,2013,5,11320,1238,12558
2,26,1,1,2013,6,11862,1327,13189
2,26,1,1,2013,7,12900,1427,14327
2,26,1,1,2013,8,13034,1465,14499
2,26,1,1,2013,9,12727,1557,14284
2,26,1,1,2013,10,12413,1678,14091
2,26,1,1,2013,11,12181,1743,13924
2,26,1,1,2013,12,12054,1753,13807
2,26,1,1,2013,13,12067,1756,13823
2,26,1,1,2013,14,11531,1679,13210
2,26,1,1,2013,15,11322,1628,12950
2,26,1,1,2013,16,11240,1586,12826
2,26,1,1,2013,17,10899,1592,12491
2,26,1,1,2013,18,10425,1633,12058
2,26,1,1,2013,19,10818,1817,12635
2,26,1,1,2013,20,11098,1949,13047
2,26,1,1,2013,21,10626,1946,12572
2,26,1,1,2013,22,9738,1885,11623
2,26,1,1,2013,23,10366,1672,12038
2,26,1,1,2013,24,10394,1453,11847
2,27,1,1,2013,1,10023,1385,11408
2,27,1,1,2013,2,9839,1254,11093
2,27,1,1,2013,3,9948,1212,11160
2,27,1,1,2013,4,10015,1174,11189
2,27,1,1,2013,5,10349,1172,11521
2,27,1,1,2013,6,10933,1247,12180
2,27,1,1,2013,7,11300,1340,12640
2,27,1,1,2013,8,12444,1412,13856
2,27,1,1,2013,9,12977,1561,14538
2,27,1,1,2013,10,13482,1737,15219
2,27,1,1,2013,11,13513,1856,15369
2,27,1,1,2013,12,13374,1860,15234
2,27,1,1,2013,13,13056,1851,14907
2,27,1,1,2013,14,12761,1769,14530
2,27,1,1,2013,15,12655,1708,14363
2,27,1,1,2013,16,12744,1647,14391
2,27,1,1,2013,17,12364,1626,13990
2,27,1,1,2013,18,11282,1646,12928
2,27,1,1,2013,19,11779,1792,13571
2,27,1,1,2013,20,12012,1960,13972
2,27,1,1,2013,21,11567,1942,13509
2,27,1,1,2013,22,10771,1869,12640
2,27,1,1,2013,23,11010,1726,12736
2,27,1,1,2013,24,10961,1562,12523
1,28,1,1,2013,1,10755,1398,12153
1,28,1,1,2013,2,10715,1272,11987
1,28,1,1,2013,3,10689,1217,11906
1,28,1,1,2013,4,10678,1190,11868
1,28,1,1,2013,5,10955,1207,12162
1,28,1,1,2013,6,11818,1330,13148
1,28,1,1,2013,7,12318,1534,13852
1,28,1,1,2013,8,13235,1691,14926
1,28,1,1,2013,9,13509,1931,15440
1,28,1,1,2013,10,14027,2214,16241
1,28,1,1,2013,11,13671,2391,16062
1,28,1,1,2013,12,13698,2431,16129
1,28,1,1,2013,13,13457,2413,15870
1,28,1,1,2013,14,13168,2319,15487
1,28,1,1,2013,15,13052,2344,15396
1,28,1,1,2013,16,13178,2325,15503
1,28,1,1,2013,17,12596,2350,14946
1,28,1,1,2013,18,11505,2281,13786
1,28,1,1,2013,19,12256,2323,14579
1,28,1,1,2013,20,12624,2371,14995
1,28,1,1,2013,21,12283,2242,14525
1,28,1,1,2013,22,11477,2047,13524
1,28,1,1,2013,23,11322,1831,13153
1,28,1,1,2013,24,11286,1629,12915
1,29,1,1,2013,1,11125,1453,12578
1,29,1,1,2013,2,11001,1319,12320
1,29,1,1,2013,3,11013,1256,12269
1,29,1,1,2013,4,10854,1223,12077
1,29,1,1,2013,5,11198,1233,12431
1,29,1,1,2013,6,11900,1366,13266
1,29,1,1,2013,7,12397,1581,13978
1,29,1,1,2013,8,13219,1745,14964
1,29,1,1,2013,9,13642,1972,15614
1,29,1,1,2013,10,13597,2246,15843
1,29,1,1,2013,11,13518,2446,15964
1,29,1,1,2013,12,13453,2459,15912
1,29,1,1,2013,13,13357,2434,15791
1,29,1,1,2013,14,12871,2295,15166
1,29,1,1,2013,15,12984,2322,15306
1,29,1,1,2013,16,12857,2337,15194
1,29,1,1,2013,17,12613,2346,14959
1,29,1,1,2013,18,11457,2325,13782
1,29,1,1,2013,19,12001,2370,14371
1,29,1,1,2013,20,12466,2439,14905
1,29,1,1,2013,21,12144,2327,14471
1,29,1,1,2013,22,11321,2103,13424
1,29,1,1,2013,23,11448,1855,13303
1,29,1,1,2013,24,11490,1631,13121
1,30,1,1,2013,1,11115,1479,12594
1,30,1,1,2013,2,11017,1354,12371
1,30,1,1,2013,3,11012,1282,12294
1,30,1,1,2013,4,11000,1244,12244
1,30,1,1,2013,5,11294,1267,12561
1,30,1,1,2013,6,12021,1371,13392
1,30,1,1,2013,7,12667,1571,14238
1,30,1,1,2013,8,13247,1768,15015
1,30,1,1,2013,9,13581,1977,15558
1,30,1,1,2013,10,13897,2259,16156
1,30,1,1,2013,11,13886,2442,16328
1,30,1,1,2013,12,13669,2477,16146
1,30,1,1,2013,13,13286,2445,15731
1,30,1,1,2013,14,13039,2338,15377
1,30,1,1,2013,15,13169,2355,15524
1,30,1,1,2013,16,13009,2362,15371
1,30,1,1,2013,17,12824,2354,15178
1,30,1,1,2013,18,11905,2326,14231
1,30,1,1,2013,19,12305,2353,14658
1,30,1,1,2013,20,13142,2413,15555
1,30,1,1,2013,21,12561,2367,14928
1,30,1,1,2013,22,12143,1953,14096
1,30,1,1,2013,23,11370,1857,13227
1,30,1,1,2013,24,11296,1690,12986
1,31,1,1,2013,1,11227,1492,12719
1,31,1,1,2013,2,10906,1341,12247
1,31,1,1,2013,3,10978,1277,12255
1,31,1,1,2013,4,10921,1255,12176
1,31,1,1,2013,5,11181,1258,12439
1,31,1,1,2013,6,12112,1377,13489
1,31,1,1,2013,7,12790,1580,14370
1,31,1,1,2013,8,13281,1770,15051
1,31,1,1,2013,9,13663,1999,15662
1,31,1,1,2013,10,13583,2276,15859
1,31,1,1,2013,11,13592,2447,16039
1,31,1,1,2013,12,13346,2468,15814
1,31,1,1,2013,13,13098,2444,15542
1,31,1,1,2013,14,12770,2335,15105
1,31,1,1,2013,15,12785,2333,15118
1,31,1,1,2013,16,12947,2326,15273
1,31,1,1,2013,17,12481,2304,14785
1,31,1,1,2013,18,11454,2278,13732
1,31,1,1,2013,19,12052,2331,14383
1,31,1,1,2013,20,12397,2376,14773
1,31,1,1,2013,21,11855,2290,14145
1,31,1,1,2013,22,11460,1994,13454
1,31,1,1,2013,23,11089,1792,12881
1,31,1,1,2013,24,10797,1656,12453
1,1,2,1,2013,1,10786,1494,12280
1,1,2,1,2013,2,10585,1353,11938
1,1,2,1,2013,3,10551,1277,11828
1,1,2,1,2013,4,10731,1245,11976
1,1,2,1,2013,5,11054,1260,12314
1,1,2,1,2013,6,12137,1394,13531
1,1,2,1,2013,7,12581,1584,14165
1,1,2,1,2013,8,13254,1752,15006
1,1,2,1,2013,9,13240,1999,15239
1,1,2,1,2013,10,13577,2280,15857
1,1,2,1,2013,11,13616,2477,16093
1,1,2,1,2013,12,13367,2510,15877
1,1,2,1,2013,13,12979,2494,15473
1,1,2,1,2013,14,12517,2369,14886
1,1,2,1,2013,15,12573,2378,14951
1,1,2,1,2013,16,12688,2377,15065
1,1,2,1,2013,17,12319,2385,14704
1,1,2,1,2013,18,11197,2362,13559
1,1,2,1,2013,19,11655,2383,14038
1,1,2,1,2013,20,12283,2431,14714
1,1,2,1,2013,21,11611,2302,13913
1,1,2,1,2013,22,11113,2093,13206
1,1,2,1,2013,23,11339,1911,13250
1,1,2,1,2013,24,11198,1701,12899
2,2,2,1,2013,1,11028,1503,12531
2,2,2,1,2013,2,10933,1377,12310
2,2,2,1,2013,3,11050,1313,12363
2,2,2,1,2013,4,11134,1287,12421
2,2,2,1,2013,5,11137,1331,12468
2,2,2,1,2013,6,11635,1403,13038
2,2,2,1,2013,7,12515,1530,14045
2,2,2,1,2013,8,13417,1671,15088
2,2,2,1,2013,9,13436,1897,15333
2,2,2,1,2013,10,13814,2179,15993
2,2,2,1,2013,11,14008,2357,16365
2,2,2,1,2013,12,13790,2394,16184
2,2,2,1,2013,13,13374,2373,15747
2,2,2,1,2013,14,13189,2249,15438
2,2,2,1,2013,15,13283,2233,15516
2,2,2,1,2013,16,13337,2212,15549
2,2,2,1,2013,17,12769,2183,14952
2,2,2,1,2013,18,11923,2184,14107
2,2,2,1,2013,19,12284,2251,14535
2,2,2,1,2013,20,12448,2316,14764
2,2,2,1,2013,21,12126,2202,14328
2,2,2,1,2013,22,11475,2063,13538
2,2,2,1,2013,23,11572,1920,13492
2,2,2,1,2013,24,11631,1764,13395
2,3,2,1,2013,1,11246,1546,12792
2,3,2,1,2013,2,11231,1417,12648
2,3,2,1,2013,3,11163,1365,12528
2,3,2,1,2013,4,11366,1309,12675
2,3,2,1,2013,5,11637,1307,12944
2,3,2,1,2013,6,11927,1418,13345
2,3,2,1,2013,7,12237,1469,13706
2,3,2,1,2013,8,13192,1540,14732
2,3,2,1,2013,9,13495,1652,15147
2,3,2,1,2013,10,13934,1781,15715
2,3,2,1,2013,11,14211,1866,16077
2,3,2,1,2013,12,13895,1879,15774
2,3,2,1,2013,13,13638,1873,15511
2,3,2,1,2013,14,13079,1809,14888
2,3,2,1,2013,15,13202,1753,14955
2,3,2,1,2013,16,13242,1703,14945
2,3,2,1,2013,17,12669,1693,14362
2,3,2,1,2013,18,11614,1694,13308
2,3,2,1,2013,19,12372,1850,14222
2,3,2,1,2013,20,12505,1960,14465
2,3,2,1,2013,21,11907,1945,13852
2,3,2,1,2013,22,11443,1911,13354
2,3,2,1,2013,23,11176,1847,13023
2,3,2,1,2013,24,11123,1754,12877
1,4,2,1,2013,1,11283,1571,12854
1,4,2,1,2013,2,11301,1423,12724
1,4,2,1,2013,3,11271,1321,12592
1,4,2,1,2013,4,11209,1279,12488
1,4,2,1,2013,5,11487,1306,12793
1,4,2,1,2013,6,12070,1457,13527
1,4,2,1,2013,7,12638,1649,14287
1,4,2,1,2013,8,13579,1824,15403
1,4,2,1,2013,9,13844,2083,15927
1,4,2,1,2013,10,14264,2326,16590
1,4,2,1,2013,11,14382,2512,16894
1,4,2,1,2013,12,14140,2557,16697
1,4,2,1,2013,13,13870,2509,16379
1,4,2,1,2013,14,13375,2407,15782
1,4,2,1,2013,15,13506,2438,15944
1,4,2,1,2013,16,13509,2421,15930
1,4,2,1,2013,17,13098,2404,15502
1,4,2,1,2013,18,11768,2357,14125
1,4,2,1,2013,19,12144,2381,14525
1,4,2,1,2013,20,12200,2447,14647
1,4,2,1,2013,21,12158,2314,14472
1,4,2,1,2013,22,11901,2136,14037
1,4,2,1,2013,23,11638,1958,13596
1,4,2,1,2013,24,11788,1786,13574
1,5,2,1,2013,1,11741,1582,13323
1,5,2,1,2013,2,11669,1446,13115
1,5,2,1,2013,3,11626,1382,13008
1,5,2,1,2013,4,11593,1350,12943
1,5,2,1,2013,5,11876,1347,13223
1,5,2,1,2013,6,12499,1502,14001
1,5,2,1,2013,7,13035,1678,14713
1,5,2,1,2013,8,13668,1844,15512
1,5,2,1,2013,9,13988,2106,16094
1,5,2,1,2013,10,14022,2387,16409
1,5,2,1,2013,11,14147,2563,16710
1,5,2,1,2013,12,13903,2586,16489
1,5,2,1,2013,13,13371,2563,15934
1,5,2,1,2013,14,13049,2427,15476
1,5,2,1,2013,15,13220,2438,15658
1,5,2,1,2013,16,13361,2429,15790
1,5,2,1,2013,17,12826,2421,15247
1,5,2,1,2013,18,11766,2363,14129
1,5,2,1,2013,19,12255,2381,14636
1,5,2,1,2013,20,12511,2445,14956
1,5,2,1,2013,21,12199,2284,14483
1,5,2,1,2013,22,11728,2076,13804
1,5,2,1,2013,23,12107,1894,14001
1,5,2,1,2013,24,11931,1730,13661
1,6,2,1,2013,1,11948,1554,13502
1,6,2,1,2013,2,11801,1423,13224
1,6,2,1,2013,3,11718,1352,13070
1,6,2,1,2013,4,11762,1303,13065
1,6,2,1,2013,5,11931,1309,13240
1,6,2,1,2013,6,12302,1455,13757
1,6,2,1,2013,7,12909,1637,14546
1,6,2,1,2013,8,13840,1805,15645
1,6,2,1,2013,9,14213,2044,16257
1,6,2,1,2013,10,14170,2276,16446
1,6,2,1,2013,11,14347,2458,16805
1,6,2,1,2013,12,14053,2494,16547
1,6,2,1,2013,13,13699,2450,16149
1,6,2,1,2013,14,13399,2317,15716
1,6,2,1,2013,15,13534,2321,15855
1,6,2,1,2013,16,13571,2309,15880
1,6,2,1,2013,17,13064,2308,15372
1,6,2,1,2013,18,12240,2268,14508
1,6,2,1,2013,19,12216,2285,14501
1,6,2,1,2013,20,12362,2359,14721
1,6,2,1,2013,21,12243,2229,14472
1,6,2,1,2013,22,11708,2019,13727
1,6,2,1,2013,23,11414,1831,13245
1,6,2,1,2013,24,11550,1630,13180
1,7,2,1,2013,1,11367,1439,12806
1,7,2,1,2013,2,11373,1327,12700
1,7,2,1,2013,3,11216,1254,12470
1,7,2,1,2013,4,11200,1210,12410
1,7,2,1,2013,5,11415,1205,12620
1,7,2,1,2013,6,12068,1322,13390
1,7,2,1,2013,7,12690,1511,14201
1,7,2,1,2013,8,13367,1683,15050
1,7,2,1,2013,9,13718,1948,15666
1,7,2,1,2013,10,13843,2233,16076
1,7,2,1,2013,11,13881,2341,16222
1,7,2,1,2013,12,13457,2360,15817
1,7,2,1,2013,13,13078,2331,15409
1,7,2,1,2013,14,12973,2202,15175
1,7,2,1,2013,15,13128,2231,15359
1,7,2,1,2013,16,13024,2238,15262
1,7,2,1,2013,17,12642,2243,14885
1,7,2,1,2013,18,11272,2228,13500
1,7,2,1,2013,19,11674,2267,13941
1,7,2,1,2013,20,12198,2322,14520
1,7,2,1,2013,21,11953,2197,14150
1,7,2,1,2013,22,11757,2011,13768
1,7,2,1,2013,23,11514,1831,13345
1,7,2,1,2013,24,11514,1633,13147
1,8,2,1,2013,1,11275,1429,12704
1,8,2,1,2013,2,11121,1288,12409
1,8,2,1,2013,3,11044,1228,12272
1,8,2,1,2013,4,11095,1206,12301
1,8,2,1,2013,5,11339,1225,12564
1,8,2,1,2013,6,12180,1353,13533
1,8,2,1,2013,7,12775,1560,14335
1,8,2,1,2013,8,13288,1727,15015
1,8,2,1,2013,9,13322,1967,15289
1,8,2,1,2013,10,13333,2255,15588
1,8,2,1,2013,11,13243,2437,15680
1,8,2,1,2013,12,12937,2487,15424
1,8,2,1,2013,13,12534,2460,14994
1,8,2,1,2013,14,12510,2325,14835
1,8,2,1,2013,15,12273,2339,14612
1,8,2,1,2013,16,12630,2358,14988
1,8,2,1,2013,17,12164,2356,14520
1,8,2,1,2013,18,11088,2319,13407
1,8,2,1,2013,19,11534,2325,13859
1,8,2,1,2013,20,12170,2384,14554
1,8,2,1,2013,21,11761,2262,14023
1,8,2,1,2013,22,11366,2056,13422
1,8,2,1,2013,23,11248,1890,13138
1,8,2,1,2013,24,11152,1647,12799
2,9,2,1,2013,1,11036,1464,12500
2,9,2,1,2013,2,10827,1333,12160
2,9,2,1,2013,3,10797,1280,12077
2,9,2,1,2013,4,10914,1249,12163
2,9,2,1,2013,5,11202,1264,12466
2,9,2,1,2013,6,11850,1361,13211
2,9,2,1,2013,7,12615,1490,14105
2,9,2,1,2013,8,12990,1621,14611
2,9,2,1,2013,9,13612,1855,15467
2,9,2,1,2013,10,13819,2132,15951
2,9,2,1,2013,11,13646,2331,15977
2,9,2,1,2013,12,13523,2385,15908
2,9,2,1,2013,13,13235,2367,15602
2,9,2,1,2013,14,13107,2234,15341
2,9,2,1,2013,15,13268,2229,15497
2,9,2,1,2013,16,13452,2219,15671
2,9,2,1,2013,17,12995,2175,15170
2,9,2,1,2013,18,11618,2159,13777
2,9,2,1,2013,19,11683,2213,13896
2,9,2,1,2013,20,12033,2319,14352
2,9,2,1,2013,21,11878,2226,14104
2,9,2,1,2013,22,11399,2065,13464
2,9,2,1,2013,23,11184,1908,13092
2,9,2,1,2013,24,11280,1758,13038
2,10,2,1,2013,1,11553,1569,13122
2,10,2,1,2013,2,11306,1436,12742
2,10,2,1,2013,3,11268,1356,12624
2,10,2,1,2013,4,11384,1304,12688
2,10,2,1,2013,5,11543,1309,12852
2,10,2,1,2013,6,11958,1395,13353
2,10,2,1,2013,7,12167,1462,13629
2,10,2,1,2013,8,13128,1517,14645
2,10,2,1,2013,9,13402,1651,15053
2,10,2,1,2013,10,13903,1810,15713
2,10,2,1,2013,11,13999,1895,15894
2,10,2,1,2013,12,13686,1933,15619
2,10,2,1,2013,13,13487,1919,15406
2,10,2,1,2013,14,13211,1832,15043
2,10,2,1,2013,15,13207,1772,14979
2,10,2,1,2013,16,13285,1734,15019
2,10,2,1,2013,17,12779,1722,14501
2,10,2,1,2013,18,11730,1767,13497
2,10,2,1,2013,19,11621,1878,13499
2,10,2,1,2013,20,11881,2033,13914
2,10,2,1,2013,21,11683,2011,13694
2,10,2,1,2013,22,11360,1967,13327
2,10,2,1,2013,23,11500,1859,13359
2,10,2,1,2013,24,11579,1708,13287
1,11,2,1,2013,1,11549,1528,13077
1,11,2,1,2013,2,11377,1400,12777
1,11,2,1,2013,3,11432,1338,12770
1,11,2,1,2013,4,11338,1302,12640
1,11,2,1,2013,5,11630,1315,12945
1,11,2,1,2013,6,12119,1440,13559
1,11,2,1,2013,7,12579,1657,14236
1,11,2,1,2013,8,13427,1830,15257
1,11,2,1,2013,9,13841,2082,15923
1,11,2,1,2013,10,14128,2391,16519
1,11,2,1,2013,11,14216,2612,16828
1,11,2,1,2013,12,14149,2665,16814
1,11,2,1,2013,13,13812,2637,16449
1,11,2,1,2013,14,13474,2523,15997
1,11,2,1,2013,15,13587,2549,16136
1,11,2,1,2013,16,13742,2538,16280
1,11,2,1,2013,17,13257,2517,15774
1,11,2,1,2013,18,11771,2459,14230
1,11,2,1,2013,19,12069,2444,14513
1,11,2,1,2013,20,12221,2492,14713
1,11,2,1,2013,21,12198,2362,14560
1,11,2,1,2013,22,11788,2188,13976
1,11,2,1,2013,23,11600,2032,13632
1,11,2,1,2013,24,11164,1850,13014
1,12,2,1,2013,1,11384,1644,13028
1,12,2,1,2013,2,11321,1510,12831
1,12,2,1,2013,3,11169,1437,12606
1,12,2,1,2013,4,11073,1404,12477
1,12,2,1,2013,5,11323,1414,12737
1,12,2,1,2013,6,11905,1528,13433
1,12,2,1,2013,7,12493,1718,14211
1,12,2,1,2013,8,13239,1868,15107
1,12,2,1,2013,9,13484,2125,15609
1,12,2,1,2013,10,13755,2421,16176
1,12,2,1,2013,11,13546,2639,16185
1,12,2,1,2013,12,13212,2689,15901
1,12,2,1,2013,13,13138,2670,15808
1,12,2,1,2013,14,12864,2568,15432
1,12,2,1,2013,15,13038,2602,15640
1,12,2,1,2013,16,13156,2619,15775
1,12,2,1,2013,17,12869,2592,15461
1,12,2,1,2013,18,11832,2553,14385
1,12,2,1,2013,19,11756,2548,14304
1,12,2,1,2013,20,12293,2567,14860
1,12,2,1,2013,21,12188,2421,14609
1,12,2,1,2013,22,11813,2271,14084
1,12,2,1,2013,23,11928,2088,14016
1,12,2,1,2013,24,11761,1932,13693
1,13,2,1,2013,1,11565,1701,13266
1,13,2,1,2013,2,11470,1558,13028
1,13,2,1,2013,3,11398,1481,12879
1,13,2,1,2013,4,11469,1455,12924
1,13,2,1,2013,5,11653,1460,13113
1,13,2,1,2013,6,12409,1587,13996
1,13,2,1,2013,7,12516,1747,14263
1,13,2,1,2013,8,13300,1898,15198
1,13,2,1,2013,9,13707,2164,15871
1,13,2,1,2013,10,14011,2474,16485
1,13,2,1,2013,11,14218,2697,16915
1,13,2,1,2013,12,13804,2768,16572
1,13,2,1,2013,13,13467,2735,16202
1,13,2,1,2013,14,13423,2644,16067
1,13,2,1,2013,15,13470,2684,16154
1,13,2,1,2013,16,13623,2698,16321
1,13,2,1,2013,17,13041,2698,15739
1,13,2,1,2013,18,12130,2632,14762
1,13,2,1,2013,19,12289,2602,14891
1,13,2,1,2013,20,12512,2642,15154
1,13,2,1,2013,21,12314,2508,14822
1,13,2,1,2013,22,12063,2339,14402
1,13,2,1,2013,23,12005,2193,14198
1,13,2,1,2013,24,11968,2055,14023
1,14,2,1,2013,1,11700,1841,13541
1,14,2,1,2013,2,11676,1670,13346
1,14,2,1,2013,3,11562,1577,13139
1,14,2,1,2013,4,11787,1537,13324
1,14,2,1,2013,5,11875,1525,13400
1,14,2,1,2013,6,12384,1636,14020
1,14,2,1,2013,7,12935,1797,14732
1,14,2,1,2013,8,13396,1943,15339
1,14,2,1,2013,9,13700,2204,15904
1,14,2,1,2013,10,13898,2526,16424
1,14,2,1,2013,11,14041,2750,16791
1,14,2,1,2013,12,13692,2812,16504
1,14,2,1,2013,13,13305,2803,16108
1,14,2,1,2013,14,13284,2653,15937
1,14,2,1,2013,15,13384,2734,16118
1,14,2,1,2013,16,13507,2736,16243
1,14,2,1,2013,17,12878,2721,15599
1,14,2,1,2013,18,12136,2653,14789
1,14,2,1,2013,19,12233,2621,14854
1,14,2,1,2013,20,12745,2645,15390
1,14,2,1,2013,21,12373,2515,14888
1,14,2,1,2013,22,11984,2348,14332
1,14,2,1,2013,23,11835,2216,14051
1,14,2,1,2013,24,11633,2069,13702
1,15,2,1,2013,1,11550,1879,13429
1,15,2,1,2013,2,11335,1716,13051
1,15,2,1,2013,3,11384,1626,13010
1,15,2,1,2013,4,11310,1570,12880
1,15,2,1,2013,5,11386,1562,12948
1,15,2,1,2013,6,11984,1680,13664
1,15,2,1,2013,7,12732,1816,14548
1,15,2,1,2013,8,13003,1950,14953
1,15,2,1,2013,9,13010,2214,15224
1,15,2,1,2013,10,13162,2541,15703
1,15,2,1,2013,11,13236,2738,15974
1,15,2,1,2013,12,12900,2822,15722
1,15,2,1,2013,13,12744,2802,15546
1,15,2,1,2013,14,12557,2678,15235
1,15,2,1,2013,15,12262,2721,14983
1,15,2,1,2013,16,12366,2711,15077
1,15,2,1,2013,17,11786,2687,14473
1,15,2,1,2013,18,11127,2613,13740
1,15,2,1,2013,19,11989,2583,14572
1,15,2,1,2013,20,12279,2650,14929
1,15,2,1,2013,21,11577,2506,14083
1,15,2,1,2013,22,11562,2330,13892
1,15,2,1,2013,23,11750,2197,13947
1,15,2,1,2013,24,11884,2066,13950
2,16,2,1,2013,1,11584,1880,13464
2,16,2,1,2013,2,11326,1701,13027
2,16,2,1,2013,3,11341,1606,12947
2,16,2,1,2013,4,11111,1550,12661
2,16,2,1,2013,5,11150,1549,12699
2,16,2,1,2013,6,11389,1621,13010
2,16,2,1,2013,7,12058,1724,13782
2,16,2,1,2013,8,12769,1840,14609
2,16,2,1,2013,9,13096,2033,15129
2,16,2,1,2013,10,13235,2309,15544
2,16,2,1,2013,11,12978,2515,15493
2,16,2,1,2013,12,12791,2557,15348
2,16,2,1,2013,13,12523,2519,15042
2,16,2,1,2013,14,11967,2376,14343
2,16,2,1,2013,15,11852,2359,14211
2,16,2,1,2013,16,11938,2262,14200
2,16,2,1,2013,17,11448,2226,13674
2,16,2,1,2013,18,10837,2216,13053
2,16,2,1,2013,19,11374,2221,13595
2,16,2,1,2013,20,12285,2343,14628
2,16,2,1,2013,21,11583,2218,13801
2,16,2,1,2013,22,11260,2070,13330
2,16,2,1,2013,23,11305,1893,13198
2,16,2,1,2013,24,11113,1709,12822
2,17,2,1,2013,1,11042,1580,12622
2,17,2,1,2013,2,10740,1453,12193
2,17,2,1,2013,3,10665,1375,12040
2,17,2,1,2013,4,10680,1331,12011
2,17,2,1,2013,5,10765,1330,12095
2,17,2,1,2013,6,11426,1396,12822
2,17,2,1,2013,7,11817,1459,13276
2,17,2,1,2013,8,12211,1511,13722
2,17,2,1,2013,9,12600,1612,14212
2,17,2,1,2013,10,13004,1735,14739
2,17,2,1,2013,11,13271,1808,15079
2,17,2,1,2013,12,13184,1832,15016
2,17,2,1,2013,13,12662,1818,14480
2,17,2,1,2013,14,12240,1742,13982
2,17,2,1,2013,15,12306,1700,14006
2,17,2,1,2013,16,12361,1662,14023
2,17,2,1,2013,17,12053,1651,13704
2,17,2,1,2013,18,11236,1680,12916
2,17,2,1,2013,19,11598,1781,13379
2,17,2,1,2013,20,11621,1955,13576
2,17,2,1,2013,21,11538,1941,13479
2,17,2,1,2013,22,11164,1851,13015
2,17,2,1,2013,23,10814,1731,12545
2,17,2,1,2013,24,10845,1621,12466
1,18,2,1,2013,1,10647,1432,12079
1,18,2,1,2013,2,10549,1317,11866
1,18,2,1,2013,3,10529,1265,11794
1,18,2,1,2013,4,10247,1222,11469
1,18,2,1,2013,5,10518,1232,11750
1,18,2,1,2013,6,11386,1363,12749
1,18,2,1,2013,7,11768,1561,13329
1,18,2,1,2013,8,12966,1707,14673
1,18,2,1,2013,9,12822,1952,14774
1,18,2,1,2013,10,13025,2239,15264
1,18,2,1,2013,11,13126,2439,15565
1,18,2,1,2013,12,12874,2481,15355
1,18,2,1,2013,13,13095,2472,15567
1,18,2,1,2013,14,12643,2370,15013
1,18,2,1,2013,15,12591,2379,14970
1,18,2,1,2013,16,12674,2371,15045
1,18,2,1,2013,17,12184,2369,14553
1,18,2,1,2013,18,11451,2337,13788
1,18,2,1,2013,19,12060,2334,14394
1,18,2,1,2013,20,12264,2395,14659
1,18,2,1,2013,21,11970,2289,14259
1,18,2,1,2013,22,11675,2091,13766
1,18,2,1,2013,23,11540,1875,13415
1,18,2,1,2013,24,11337,1672,13009
3,19,2,1,2013,1,11168,1523,12691
3,19,2,1,2013,2,10781,1399,12180
3,19,2,1,2013,3,10573,1337,11910
3,19,2,1,2013,4,10533,1291,11824
3,19,2,1,2013,5,10725,1300,12025
3,19,2,1,2013,6,11596,1372,12968
3,19,2,1,2013,7,12525,1506,14031
3,19,2,1,2013,8,12904,1664,14568
3,19,2,1,2013,9,13576,1925,15501
3,19,2,1,2013,10,13936,2222,16158
3,19,2,1,2013,11,13974,2428,16402
3,19,2,1,2013,12,13799,2490,16289
3,19,2,1,2013,13,13517,2480,15997
3,19,2,1,2013,14,13170,2335,15505
3,19,2,1,2013,15,13481,2355,15836
3,19,2,1,2013,16,13100,2360,15460
3,19,2,1,2013,17,12839,2376,15215
3,19,2,1,2013,18,11858,2348,14206
3,19,2,1,2013,19,12172,2346,14518
3,19,2,1,2013,20,12378,2433,14811
3,19,2,1,2013,21,12138,2292,14430
3,19,2,1,2013,22,11973,2136,14109
3,19,2,1,2013,23,11856,1948,13804
3,19,2,1,2013,24,11710,1759,13469
1,20,2,1,2013,1,11197,1566,12763
1,20,2,1,2013,2,11061,1432,12493
1,20,2,1,2013,3,11112,1369,12481
1,20,2,1,2013,4,11062,1325,12387
1,20,2,1,2013,5,11356,1332,12688
1,20,2,1,2013,6,11979,1424,13403
1,20,2,1,2013,7,12591,1586,14177
1,20,2,1,2013,8,13064,1706,14770
1,20,2,1,2013,9,13289,1947,15236
1,20,2,1,2013,10,13730,2251,15981
1,20,2,1,2013,11,13810,2469,16279
1,20,2,1,2013,12,13637,2548,16185
1,20,2,1,2013,13,13318,2538,15856
1,20,2,1,2013,14,12924,2405,15329
1,20,2,1,2013,15,12882,2442,15324
1,20,2,1,2013,16,13245,2443,15688
1,20,2,1,2013,17,12574,2425,14999
1,20,2,1,2013,18,11613,2392,14005
1,20,2,1,2013,19,12245,2363,14608
1,20,2,1,2013,20,13027,2451,15478
1,20,2,1,2013,21,12429,2362,14791
1,20,2,1,2013,22,11864,2151,14015
1,20,2,1,2013,23,11691,1953,13644
1,20,2,1,2013,24,11848,1774,13622
1,21,2,1,2013,1,11485,1600,13085
1,21,2,1,2013,2,11285,1464,12749
1,21,2,1,2013,3,11126,1400,12526
1,21,2,1,2013,4,11152,1359,12511
1,21,2,1,2013,5,11297,1365,12662
1,21,2,1,2013,6,11815,1459,13274
1,21,2,1,2013,7,12620,1648,14268
1,21,2,1,2013,8,13351,1779,15130
1,21,2,1,2013,9,13653,2028,15681
1,21,2,1,2013,10,13955,2334,16289
1,21,2,1,2013,11,13931,2559,16490
1,21,2,1,2013,12,13823,2627,16450
1,21,2,1,2013,13,13539,2617,16156
1,21,2,1,2013,14,13185,2498,15683
1,21,2,1,2013,15,13416,2522,15938
1,21,2,1,2013,16,13482,2532,16014
1,21,2,1,2013,17,12880,2519,15399
1,21,2,1,2013,18,11623,2488,14111
1,21,2,1,2013,19,11971,2467,14438
1,21,2,1,2013,20,13091,2547,15638
1,21,2,1,2013,21,12635,2442,15077
1,21,2,1,2013,22,12149,2232,14381
1,21,2,1,2013,23,11578,2045,13623
1,21,2,1,2013,24,11600,1878,13478
2,23,2,1,2013,1,11029,1707,12736
2,23,2,1,2013,2,11133,1542,12675
2,23,2,1,2013,3,11041,1476,12517
2,23,2,1,2013,4,10932,1437,12369
2,23,2,1,2013,5,11270,1438,12708
2,23,2,1,2013,6,11628,1521,13149
2,23,2,1,2013,7,12329,1631,13960
2,23,2,1,2013,8,12788,1734,14522
2,23,2,1,2013,9,13113,1969,15082
2,23,2,1,2013,10,13498,2243,15741
2,23,2,1,2013,11,13410,2443,15853
2,23,2,1,2013,12,13305,2502,15807
2,23,2,1,2013,13,12998,2481,15479
2,23,2,1,2013,14,12726,2333,15059
2,23,2,1,2013,15,13020,2325,15345
2,23,2,1,2013,16,12906,2311,15217
2,23,2,1,2013,17,12332,2276,14608
2,23,2,1,2013,18,11310,2241,13551
2,23,2,1,2013,19,11881,2257,14138
2,23,2,1,2013,20,12370,2404,14774
2,23,2,1,2013,21,12124,2296,14420
2,23,2,1,2013,22,11721,2129,13850
2,23,2,1,2013,23,11403,1962,13365
2,23,2,1,2013,24,11561,1808,13369
2,24,2,1,2013,1,11518,1616,13134
2,24,2,1,2013,2,11188,1483,12671
2,24,2,1,2013,3,11279,1414,12693
2,24,2,1,2013,4,11209,1365,12574
2,24,2,1,2013,5,11275,1370,12645
2,24,2,1,2013,6,11527,1445,12972
2,24,2,1,2013,7,11942,1497,13439
2,24,2,1,2013,8,12603,1527,14130
2,24,2,1,2013,9,12496,1641,14137
2,24,2,1,2013,10,13005,1807,14812
2,24,2,1,2013,11,13089,1903,14992
2,24,2,1,2013,12,13024,1918,14942
2,24,2,1,2013,13,12648,1881,14529
2,24,2,1,2013,14,12518,1806,14324
2,24,2,1,2013,15,12354,1754,14108
2,24,2,1,2013,16,12614,1714,14328
2,24,2,1,2013,17,12078,1737,13815
2,24,2,1,2013,18,11156,1727,12883
2,24,2,1,2013,19,11555,1796,13351
2,24,2,1,2013,20,12385,1989,14374
2,24,2,1,2013,21,11896,2000,13896
2,24,2,1,2013,22,11485,1953,13438
2,24,2,1,2013,23,11130,1858,12988
2,24,2,1,2013,24,11546,1718,13264
1,25,2,1,2013,1,11480,1549,13029
1,25,2,1,2013,2,11275,1408,12683
1,25,2,1,2013,3,11310,1345,12655
1,25,2,1,2013,4,11283,1310,12593
1,25,2,1,2013,5,11536,1308,12844
1,25,2,1,2013,6,12011,1443,13454
1,25,2,1,2013,7,12303,1619,13922
1,25,2,1,2013,8,13110,1757,14867
1,25,2,1,2013,9,13166,2041,15207
1,25,2,1,2013,10,13599,2341,15940
1,25,2,1,2013,11,13796,2569,16365
1,25,2,1,2013,12,13798,2624,16422
1,25,2,1,2013,13,13463,2637,16100
1,25,2,1,2013,14,13129,2528,15657
1,25,2,1,2013,15,13157,2552,15709
1,25,2,1,2013,16,13299,2565,15864
1,25,2,1,2013,17,12840,2548,15388
1,25,2,1,2013,18,11432,2482,13914
1,25,2,1,2013,19,11761,2428,14189
1,25,2,1,2013,20,12830,2476,15306
1,25,2,1,2013,21,12201,2363,14564
1,25,2,1,2013,22,11821,2152,13973
1,25,2,1,2013,23,11520,1961,13481
1,25,2,1,2013,24,11482,1803,13285
1,26,2,1,2013,1,11608,1608,13216
1,26,2,1,2013,2,11470,1479,12949
1,26,2,1,2013,3,11544,1423,12967
1,26,2,1,2013,4,11451,1380,12831
1,26,2,1,2013,5,11586,1385,12971
1,26,2,1,2013,6,12101,1495,13596
1,26,2,1,2013,7,12905,1662,14567
1,26,2,1,2013,8,12875,1812,14687
1,26,2,1,2013,9,13389,2067,15456
1,26,2,1,2013,10,13630,2363,15993
1,26,2,1,2013,11,13751,2565,16316
1,26,2,1,2013,12,13847,2621,16468
1,26,2,1,2013,13,13710,2613,16323
1,26,2,1,2013,14,13252,2493,15745
1,26,2,1,2013,15,13199,2527,15726
1,26,2,1,2013,16,13274,2530,15804
1,26,2,1,2013,17,13122,2520,15642
1,26,2,1,2013,18,11820,2486,14306
1,26,2,1,2013,19,12038,2444,14482
1,26,2,1,2013,20,12949,2521,15470
1,26,2,1,2013,21,12362,2396,14758
1,26,2,1,2013,22,12074,2220,14294
1,26,2,1,2013,23,11757,2036,13793
1,26,2,1,2013,24,11775,1837,13612
1,27,2,1,2013,1,11718,1621,13339
1,27,2,1,2013,2,11699,1501,13200
1,27,2,1,2013,3,11511,1436,12947
1,27,2,1,2013,4,11519,1391,12910
1,27,2,1,2013,5,11580,1398,12978
1,27,2,1,2013,6,11835,1516,13351
1,27,2,1,2013,7,11926,1674,13600
1,27,2,1,2013,8,13188,1834,15022
1,27,2,1,2013,9,13596,2091,15687
1,27,2,1,2013,10,14003,2383,16386
1,27,2,1,2013,11,14238,2570,16808
1,27,2,1,2013,12,14013,2619,16632
1,27,2,1,2013,13,13764,2603,16367
1,27,2,1,2013,14,13238,2479,15717
1,27,2,1,2013,15,13192,2508,15700
1,27,2,1,2013,16,13244,2509,15753
1,27,2,1,2013,17,12965,2510,15475
1,27,2,1,2013,18,11667,2474,14141
1,27,2,1,2013,19,12004,2439,14443
1,27,2,1,2013,20,12859,2514,15373
1,27,2,1,2013,21,12516,2347,14863
1,27,2,1,2013,22,12160,2166,14326
1,27,2,1,2013,23,11586,1995,13581
1,27,2,1,2013,24,11556,1830,13386
1,28,2,1,2013,1,11776,1597,13373
1,28,2,1,2013,2,11626,1477,13103
1,28,2,1,2013,3,11658,1429,13087
1,28,2,1,2013,4,11794,1398,13192
1,28,2,1,2013,5,11710,1370,13080
1,28,2,1,2013,6,12268,1491,13759
1,28,2,1,2013,7,12940,1650,14590
1,28,2,1,2013,8,13415,1822,15237
1,28,2,1,2013,9,13705,2086,15791
1,28,2,1,2013,10,13729,2379,16108
1,28,2,1,2013,11,13957,2571,16528
1,28,2,1,2013,12,13862,2643,16505
1,28,2,1,2013,13,13484,2640,16124
1,28,2,1,2013,14,13451,2522,15973
1,28,2,1,2013,15,13403,2544,15947
1,28,2,1,2013,16,13487,2554,16041
1,28,2,1,2013,17,12748,2532,15280
1,28,2,1,2013,18,11905,2477,14382
1,28,2,1,2013,19,11962,2433,14395
1,28,2,1,2013,20,12995,2515,15510
1,28,2,1,2013,21,12587,2387,14974
1,28,2,1,2013,22,12174,2188,14362
1,28,2,1,2013,23,11838,1958,13796
1,28,2,1,2013,24,11804,1732,13536
1,1,3,1,2013,1,11810,1603,13413
1,1,3,1,2013,2,11443,1476,12919
1,1,3,1,2013,3,11461,1410,12871
1,1,3,1,2013,4,11393,1372,12765
1,1,3,1,2013,5,11633,1375,13008
1,1,3,1,2013,6,12076,1481,13557
1,1,3,1,2013,7,12701,1636,14337
1,1,3,1,2013,8,13368,1794,15162
1,1,3,1,2013,9,13399,2073,15472
1,1,3,1,2013,10,13357,2405,15762
1,1,3,1,2013,11,13436,2630,16066
1,1,3,1,2013,12,13500,2698,16198
1,1,3,1,2013,13,13094,2684,15778
1,1,3,1,2013,14,12692,2553,15245
1,1,3,1,2013,15,12718,2583,15301
1,1,3,1,2013,16,12913,2602,15515
1,1,3,1,2013,17,12557,2597,15154
1,1,3,1,2013,18,11489,2545,14034
1,1,3,1,2013,19,11396,2509,13905
1,1,3,1,2013,20,12754,2554,15308
1,1,3,1,2013,21,12310,2465,14775
1,1,3,1,2013,22,11724,2293,14017
1,1,3,1,2013,23,11442,2087,13529
1,1,3,1,2013,24,11586,1909,13495
2,2,3,1,2013,1,11789,1722,13511
2,2,3,1,2013,2,11529,1560,13089
2,2,3,1,2013,3,11395,1486,12881
2,2,3,1,2013,4,11296,1437,12733
2,2,3,1,2013,5,11520,1435,12955
2,2,3,1,2013,6,11954,1533,13487
2,2,3,1,2013,7,12773,1629,14402
2,2,3,1,2013,8,13278,1740,15018
2,2,3,1,2013,9,13446,1992,15438
2,2,3,1,2013,10,13560,2274,15834
2,2,3,1,2013,11,13802,2497,16299
2,2,3,1,2013,12,13789,2578,16367
2,2,3,1,2013,13,13566,2568,16134
2,2,3,1,2013,14,13275,2432,15707
2,2,3,1,2013,15,13301,2443,15744
2,2,3,1,2013,16,13435,2439,15874
2,2,3,1,2013,17,13128,2415,15543
2,2,3,1,2013,18,12044,2365,14409
2,2,3,1,2013,19,11780,2346,14126
2,2,3,1,2013,20,12981,2439,15420
2,2,3,1,2013,21,12504,2371,14875
2,2,3,1,2013,22,12186,2228,14414
2,2,3,1,2013,23,11688,2062,13750
2,2,3,1,2013,24,11864,1930,13794
2,3,3,1,2013,1,11835,1746,13581
2,3,3,1,2013,2,11667,1595,13262
2,3,3,1,2013,3,11475,1515,12990
2,3,3,1,2013,4,11538,1464,13002
2,3,3,1,2013,5,11754,1454,13208
2,3,3,1,2013,6,12000,1517,13517
2,3,3,1,2013,7,11950,1551,13501
2,3,3,1,2013,8,13151,1582,14733
2,3,3,1,2013,9,13539,1685,15224
2,3,3,1,2013,10,13976,1827,15803
2,3,3,1,2013,11,14137,1951,16088
2,3,3,1,2013,12,13898,1978,15876
2,3,3,1,2013,13,13544,2005,15549
2,3,3,1,2013,14,13180,1931,15111
2,3,3,1,2013,15,13086,1890,14976
2,3,3,1,2013,16,13288,1854,15142
2,3,3,1,2013,17,12351,1833,14184
2,3,3,1,2013,18,11460,1823,13283
2,3,3,1,2013,19,11394,1877,13271
2,3,3,1,2013,20,12870,2091,14961
2,3,3,1,2013,21,12623,2095,14718
2,3,3,1,2013,22,11808,2046,13854
2,3,3,1,2013,23,11598,1971,13569
2,3,3,1,2013,24,11610,1874,13484
1,4,3,1,2013,1,11707,1712,13419
1,4,3,1,2013,2,11608,1573,13181
1,4,3,1,2013,3,11441,1493,12934
1,4,3,1,2013,4,11484,1444,12928
1,4,3,1,2013,5,11695,1445,13140
1,4,3,1,2013,6,12219,1536,13755
1,4,3,1,2013,7,12129,1703,13832
1,4,3,1,2013,8,13115,1841,14956
1,4,3,1,2013,9,13424,2113,15537
1,4,3,1,2013,10,13855,2426,16281
1,4,3,1,2013,11,14125,2667,16792
1,4,3,1,2013,12,13936,2756,16692
1,4,3,1,2013,13,13521,2741,16262
1,4,3,1,2013,14,13209,2628,15837
1,4,3,1,2013,15,13340,2663,16003
1,4,3,1,2013,16,13388,2667,16055
1,4,3,1,2013,17,13277,2671,15948
1,4,3,1,2013,18,11540,2605,14145
1,4,3,1,2013,19,11877,2555,14432
1,4,3,1,2013,20,13231,2586,15817
1,4,3,1,2013,21,12376,2434,14810
1,4,3,1,2013,22,12032,2279,14311
1,4,3,1,2013,23,11710,2152,13862
1,4,3,1,2013,24,11836,1977,13813
1,5,3,1,2013,1,11781,1802,13583
1,5,3,1,2013,2,11647,1641,13288
1,5,3,1,2013,3,11561,1548,13109
1,5,3,1,2013,4,11510,1489,12999
1,5,3,1,2013,5,11609,1508,13117
1,5,3,1,2013,6,12315,1600,13915
1,5,3,1,2013,7,12686,1749,14435
1,5,3,1,2013,8,13440,1878,15318
1,5,3,1,2013,9,13733,2141,15874
1,5,3,1,2013,10,13953,2463,16416
1,5,3,1,2013,11,14238,2695,16933
1,5,3,1,2013,12,14232,2788,17020
1,5,3,1,2013,13,14056,2785,16841
1,5,3,1,2013,14,13693,2682,16375
1,5,3,1,2013,15,13626,2723,16349
1,5,3,1,2013,16,13725,2730,16455
1,5,3,1,2013,17,13404,2718,16122
1,5,3,1,2013,18,11751,2665,14416
1,5,3,1,2013,19,11990,2581,14571
1,5,3,1,2013,20,13253,2614,15867
1,5,3,1,2013,21,12825,2490,15315
1,5,3,1,2013,22,12297,2335,14632
1,5,3,1,2013,23,11959,2254,14213
1,5,3,1,2013,24,11716,2096,13812
1,6,3,1,2013,1,11751,1883,13634
1,6,3,1,2013,2,11711,1713,13424
1,6,3,1,2013,3,11575,1630,13205
1,6,3,1,2013,4,11694,1579,13273
1,6,3,1,2013,5,11716,1564,13280
1,6,3,1,2013,6,12295,1634,13929
1,6,3,1,2013,7,12825,1772,14597
1,6,3,1,2013,8,13615,1907,15522
1,6,3,1,2013,9,13577,2168,15745
1,6,3,1,2013,10,13761,2508,16269
1,6,3,1,2013,11,14171,2721,16892
1,6,3,1,2013,12,14204,2804,17008
1,6,3,1,2013,13,13887,2821,16708
1,6,3,1,2013,14,13527,2728,16255
1,6,3,1,2013,15,13480,2769,16249
1,6,3,1,2013,16,13601,2779,16380
1,6,3,1,2013,17,13316,2802,16118
1,6,3,1,2013,18,12204,2733,14937
1,6,3,1,2013,19,12292,2652,14944
1,6,3,1,2013,20,13306,2676,15982
1,6,3,1,2013,21,12834,2552,15386
1,6,3,1,2013,22,12160,2399,14559
1,6,3,1,2013,23,11792,2252,14044
1,6,3,1,2013,24,12098,2108,14206
1,7,3,1,2013,1,11911,1967,13878
1,7,3,1,2013,2,11895,1792,13687
1,7,3,1,2013,3,11935,1696,13631
1,7,3,1,2013,4,12022,1641,13663
1,7,3,1,2013,5,12423,1628,14051
1,7,3,1,2013,6,12766,1702,14468
1,7,3,1,2013,7,13295,1849,15144
1,7,3,1,2013,8,13712,1982,15694
1,7,3,1,2013,9,13845,2224,16069
1,7,3,1,2013,10,13854,2555,16409
1,7,3,1,2013,11,14057,2810,16867
1,7,3,1,2013,12,14123,2902,17025
1,7,3,1,2013,13,13916,2898,16814
1,7,3,1,2013,14,13758,2806,16564
1,7,3,1,2013,15,13615,2868,16483
1,7,3,1,2013,16,13978,2881,16859
1,7,3,1,2013,17,13456,2870,16326
1,7,3,1,2013,18,12049,2759,14808
1,7,3,1,2013,19,12158,2665,14823
1,7,3,1,2013,20,13245,2704,15949
1,7,3,1,2013,21,12685,2538,15223
1,7,3,1,2013,22,12248,2404,14652
1,7,3,1,2013,23,12169,2277,14446
1,7,3,1,2013,24,12163,2138,14301
1,8,3,1,2013,1,12074,2050,14124
1,8,3,1,2013,2,11973,1867,13840
1,8,3,1,2013,3,11822,1762,13584
1,8,3,1,2013,4,11659,1684,13343
1,8,3,1,2013,5,11998,1672,13670
1,8,3,1,2013,6,12499,1757,14256
1,8,3,1,2013,7,12935,1882,14817
1,8,3,1,2013,8,13469,2009,15478
1,8,3,1,2013,9,13456,2274,15730
1,8,3,1,2013,10,13670,2624,16294
1,8,3,1,2013,11,13732,2881,16613
1,8,3,1,2013,12,13690,2950,16640
1,8,3,1,2013,13,13419,2933,16352
1,8,3,1,2013,14,13151,2856,16007
1,8,3,1,2013,15,13117,2915,16032
1,8,3,1,2013,16,13073,2935,16008
1,8,3,1,2013,17,12948,2916,15864
1,8,3,1,2013,18,11611,2822,14433
1,8,3,1,2013,19,11681,2727,14408
1,8,3,1,2013,20,12866,2744,15610
1,8,3,1,2013,21,12549,2605,15154
1,8,3,1,2013,22,12018,2446,14464
1,8,3,1,2013,23,11983,2319,14302
1,8,3,1,2013,24,12131,2201,14332
2,9,3,1,2013,1,11949,2070,14019
2,9,3,1,2013,2,11839,1906,13745
2,9,3,1,2013,3,11751,1776,13527
2,9,3,1,2013,4,11859,1697,13556
2,9,3,1,2013,5,11982,1678,13660
2,9,3,1,2013,6,12519,1745,14264
2,9,3,1,2013,7,13189,1813,15002
2,9,3,1,2013,8,13690,1877,15567
2,9,3,1,2013,9,13619,2086,15705
2,9,3,1,2013,10,13826,2397,16223
2,9,3,1,2013,11,14005,2628,16633
2,9,3,1,2013,12,14172,2719,16891
2,9,3,1,2013,13,13713,2731,16444
2,9,3,1,2013,14,13688,2626,16314
2,9,3,1,2013,15,13555,2634,16189
2,9,3,1,2013,16,13651,2615,16266
2,9,3,1,2013,17,13512,2577,16089
2,9,3,1,2013,18,11983,2504,14487
2,9,3,1,2013,19,11922,2460,14382
2,9,3,1,2013,20,12776,2576,15352
2,9,3,1,2013,21,12442,2504,14946
2,9,3,1,2013,22,12187,2378,14565
2,9,3,1,2013,23,11971,2306,14277
2,9,3,1,2013,24,12139,2223,14362
3,10,3,1,2013,1,12313,2055,14368
3,10,3,1,2013,2,12258,1877,14135
3,10,3,1,2013,3,12180,1763,13943
3,10,3,1,2013,4,12218,1705,13923
3,10,3,1,2013,5,12508,1672,14180
3,10,3,1,2013,6,12834,1726,14560
3,10,3,1,2013,7,12998,1746,14744
3,10,3,1,2013,8,13461,1750,15211
3,10,3,1,2013,9,13480,1824,15304
3,10,3,1,2013,10,13776,1928,15704
3,10,3,1,2013,11,14180,2008,16188
3,10,3,1,2013,12,14076,2023,16099
3,10,3,1,2013,13,13507,2012,15519
3,10,3,1,2013,14,13195,1982,15177
3,10,3,1,2013,15,13282,1956,15238
3,10,3,1,2013,16,13358,1930,15288
3,10,3,1,2013,17,12864,1922,14786
3,10,3,1,2013,18,11870,1880,13750
3,10,3,1,2013,19,11732,1950,13682
3,10,3,1,2013,20,12735,2104,14839
3,10,3,1,2013,21,12231,2165,14396
3,10,3,1,2013,22,11973,2167,14140
3,10,3,1,2013,23,11945,2165,14110
3,10,3,1,2013,24,11937,2117,14054
1,11,3,1,2013,1,12007,1982,13989
1,11,3,1,2013,2,11967,1818,13785
1,11,3,1,2013,3,11787,1715,13502
1,11,3,1,2013,4,11978,1639,13617
1,11,3,1,2013,5,11989,1624,13613
1,11,3,1,2013,6,12458,1707,14165
1,11,3,1,2013,7,13104,1840,14944
1,11,3,1,2013,8,13552,1961,15513
1,11,3,1,2013,9,13715,2235,15950
1,11,3,1,2013,10,14067,2578,16645
1,11,3,1,2013,11,14351,2800,17151
1,11,3,1,2013,12,14498,2848,17346
1,11,3,1,2013,13,14188,2895,17083
1,11,3,1,2013,14,13920,2785,16705
1,11,3,1,2013,15,13885,2830,16715
1,11,3,1,2013,16,13979,2850,16829
1,11,3,1,2013,17,13694,2830,16524
1,11,3,1,2013,18,12145,2738,14883
1,11,3,1,2013,19,12350,2640,14990
1,11,3,1,2013,20,13343,2685,16028
1,11,3,1,2013,21,13032,2574,15606
1,11,3,1,2013,22,12461,2454,14915
1,11,3,1,2013,23,11888,2315,14203
1,11,3,1,2013,24,11983,2132,14115
1,12,3,1,2013,1,12282,1882,14164
1,12,3,1,2013,2,12169,1715,13884
1,12,3,1,2013,3,12026,1632,13658
1,12,3,1,2013,4,12124,1574,13698
1,12,3,1,2013,5,12335,1606,13941
1,12,3,1,2013,6,12671,1695,14366
1,12,3,1,2013,7,13406,1836,15242
1,12,3,1,2013,8,13968,1967,15935
1,12,3,1,2013,9,13918,2230,16148
1,12,3,1,2013,10,14361,2583,16944
1,12,3,1,2013,11,14482,2814,17296
1,12,3,1,2013,12,14729,2895,17624
1,12,3,1,2013,13,14260,2885,17145
1,12,3,1,2013,14,13904,2769,16673
1,12,3,1,2013,15,13781,2796,16577
1,12,3,1,2013,16,13906,2812,16718
1,12,3,1,2013,17,13512,2783,16295
1,12,3,1,2013,18,12361,2715,15076
1,12,3,1,2013,19,12387,2609,14996
1,12,3,1,2013,20,13305,2683,15988
1,12,3,1,2013,21,12885,2554,15439
1,12,3,1,2013,22,12468,2364,14832
1,12,3,1,2013,23,12582,2238,14820
1,12,3,1,2013,24,12571,2109,14680
1,13,3,1,2013,1,12424,1900,14324
1,13,3,1,2013,2,12222,1737,13959
1,13,3,1,2013,3,12292,1671,13963
1,13,3,1,2013,4,12436,1617,14053
1,13,3,1,2013,5,12599,1591,14190
1,13,3,1,2013,6,12958,1670,14628
1,13,3,1,2013,7,13463,1800,15263
1,13,3,1,2013,8,13995,1957,15952
1,13,3,1,2013,9,14121,2210,16331
1,13,3,1,2013,10,14468,2548,17016
1,13,3,1,2013,11,14520,2785,17305
1,13,3,1,2013,12,14660,2833,17493
1,13,3,1,2013,13,14295,2767,17062
1,13,3,1,2013,14,13934,2727,16661
1,13,3,1,2013,15,13603,2762,16365
1,13,3,1,2013,16,13620,2757,16377
1,13,3,1,2013,17,13502,2731,16233
1,13,3,1,2013,18,12323,2656,14979
1,13,3,1,2013,19,12309,2557,14866
1,13,3,1,2013,20,13257,2618,15875
1,13,3,1,2013,21,13157,2511,15668
1,13,3,1,2013,22,12629,2340,14969
1,13,3,1,2013,23,12267,2186,14453
1,13,3,1,2013,24,12446,2013,14459
1,14,3,1,2013,1,12333,1844,14177
1,14,3,1,2013,2,12206,1684,13890
1,14,3,1,2013,3,12200,1522,13722
1,14,3,1,2013,4,12065,1557,13622
1,14,3,1,2013,5,12440,1538,13978
1,14,3,1,2013,6,12804,1614,14418
1,14,3,1,2013,7,13344,1750,15094
1,14,3,1,2013,8,13299,1889,15188
1,14,3,1,2013,9,13981,2189,16170
1,14,3,1,2013,10,13985,2529,16514
1,14,3,1,2013,11,14257,2743,17000
1,14,3,1,2013,12,14310,2822,17132
1,14,3,1,2013,13,14203,2813,17016
1,14,3,1,2013,14,13889,2717,16606
1,14,3,1,2013,15,13819,2762,16581
1,14,3,1,2013,16,13885,2770,16655
1,14,3,1,2013,17,13459,2750,16209
1,14,3,1,2013,18,12226,2681,14907
1,14,3,1,2013,19,12138,2580,14718
1,14,3,1,2013,20,13416,2656,16072
1,14,3,1,2013,21,13063,2514,15577
1,14,3,1,2013,22,12519,2376,14895
1,14,3,1,2013,23,12467,2263,14730
1,14,3,1,2013,24,12256,2102,14358
1,15,3,1,2013,1,12466,1895,14361
1,15,3,1,2013,2,12304,1719,14023
1,15,3,1,2013,3,12074,1631,13705
1,15,3,1,2013,4,12136,1590,13726
1,15,3,1,2013,5,12205,1593,13798
1,15,3,1,2013,6,12756,1677,14433
1,15,3,1,2013,7,13224,1828,15052
1,15,3,1,2013,8,13508,1959,15467
1,15,3,1,2013,9,13551,2239,15790
1,15,3,1,2013,10,13748,2581,16329
1,15,3,1,2013,11,13647,2829,16476
1,15,3,1,2013,12,13724,2889,16613
1,15,3,1,2013,13,13913,2882,16795
1,15,3,1,2013,14,12797,2771,15568
1,15,3,1,2013,15,13137,2823,15960
1,15,3,1,2013,16,13191,2809,16000
1,15,3,1,2013,17,12787,2795,15582
1,15,3,1,2013,18,11727,2717,14444
1,15,3,1,2013,19,11685,2635,14320
1,15,3,1,2013,20,12655,2694,15349
1,15,3,1,2013,21,11944,2555,14499
1,15,3,1,2013,22,11713,2427,14140
1,15,3,1,2013,23,12190,2252,14442
1,15,3,1,2013,24,11929,2118,14047
2,16,3,1,2013,1,11961,1945,13906
2,16,3,1,2013,2,11693,1772,13465
2,16,3,1,2013,3,11794,1689,13483
2,16,3,1,2013,4,11536,1620,13156
2,16,3,1,2013,5,11607,1617,13224
2,16,3,1,2013,6,12015,1674,13689
2,16,3,1,2013,7,12672,1748,14420
2,16,3,1,2013,8,13066,1848,14914
2,16,3,1,2013,9,13269,2091,15360
2,16,3,1,2013,10,13352,2448,15800
2,16,3,1,2013,11,13760,2639,16399
2,16,3,1,2013,12,13668,2681,16349
2,16,3,1,2013,13,13691,2673,16364
2,16,3,1,2013,14,13399,2622,16021
2,16,3,1,2013,15,13323,2645,15968
2,16,3,1,2013,16,13528,2632,16160
2,16,3,1,2013,17,13019,2600,15619
2,16,3,1,2013,18,11754,2521,14275
2,16,3,1,2013,19,11813,2471,14284
2,16,3,1,2013,20,12966,2598,15564
2,16,3,1,2013,21,12691,2505,15196
2,16,3,1,2013,22,12300,2351,14651
2,16,3,1,2013,23,12192,2263,14455
2,16,3,1,2013,24,12209,2112,14321
2,17,3,1,2013,1,12077,1938,14015
2,17,3,1,2013,2,12367,1771,14138
2,17,3,1,2013,3,11787,1688,13475
2,17,3,1,2013,4,11964,1624,13588
2,17,3,1,2013,5,12044,1618,13662
2,17,3,1,2013,6,12286,1660,13946
2,17,3,1,2013,7,12615,1683,14298
2,17,3,1,2013,8,13321,1693,15014
2,17,3,1,2013,9,13238,1789,15027
2,17,3,1,2013,10,13926,1953,15879
2,17,3,1,2013,11,14074,2061,16135
2,17,3,1,2013,12,13804,2113,15917
2,17,3,1,2013,13,13724,2132,15856
2,17,3,1,2013,14,13427,2048,15475
2,17,3,1,2013,15,13220,2011,15231
2,17,3,1,2013,16,13498,1991,15489
2,17,3,1,2013,17,13084,1961,15045
2,17,3,1,2013,18,11803,1931,13734
2,17,3,1,2013,19,11544,1993,13537
2,17,3,1,2013,20,12660,2193,14853
2,17,3,1,2013,21,12490,2199,14689
2,17,3,1,2013,22,12156,2195,14351
2,17,3,1,2013,23,11992,2145,14137
2,17,3,1,2013,24,12136,2069,14205
1,18,3,1,2013,1,12020,1886,13906
1,18,3,1,2013,2,11973,1725,13698
1,18,3,1,2013,3,11916,1642,13558
1,18,3,1,2013,4,11882,1580,13462
1,18,3,1,2013,5,12214,1585,13799
1,18,3,1,2013,6,12625,1669,14294
1,18,3,1,2013,7,13174,1803,14977
1,18,3,1,2013,8,13470,1944,15414
1,18,3,1,2013,9,13572,2236,15808
1,18,3,1,2013,10,14092,2581,16673
1,18,3,1,2013,11,14523,2842,17365
1,18,3,1,2013,12,14788,2878,17666
1,18,3,1,2013,13,14556,2861,17417
1,18,3,1,2013,14,14248,2816,17064
1,18,3,1,2013,15,14144,2853,16997
1,18,3,1,2013,16,14260,2868,17128
1,18,3,1,2013,17,13724,2854,16578
1,18,3,1,2013,18,12524,2799,15323
1,18,3,1,2013,19,12208,2700,14908
1,18,3,1,2013,20,13364,2772,16136
1,18,3,1,2013,21,13128,2629,15757
1,18,3,1,2013,22,12565,2481,15046
1,18,3,1,2013,23,12622,2375,14997
1,18,3,1,2013,24,12557,2232,14789
1,19,3,1,2013,1,12330,1996,14326
1,19,3,1,2013,2,12260,1822,14082
1,19,3,1,2013,3,12433,1729,14162
1,19,3,1,2013,4,12157,1666,13823
1,19,3,1,2013,5,12285,1646,13931
1,19,3,1,2013,6,12654,1744,14398
1,19,3,1,2013,7,13441,1860,15301
1,19,3,1,2013,8,13744,1979,15723
1,19,3,1,2013,9,14181,2248,16429
1,19,3,1,2013,10,14324,2619,16943
1,19,3,1,2013,11,14668,2824,17492
1,19,3,1,2013,12,14520,2886,17406
1,19,3,1,2013,13,14262,2877,17139
1,19,3,1,2013,14,14050,2742,16792
1,19,3,1,2013,15,13828,2784,16612
1,19,3,1,2013,16,13936,2808,16744
1,19,3,1,2013,17,13627,2793,16420
1,19,3,1,2013,18,12302,2732,15034
1,19,3,1,2013,19,12516,2634,15150
1,19,3,1,2013,20,13541,2695,16236
1,19,3,1,2013,21,13088,2591,15679
1,19,3,1,2013,22,12775,2418,15193
1,19,3,1,2013,23,12357,2306,14663
1,19,3,1,2013,24,12620,2177,14797
1,20,3,1,2013,1,12649,1956,14605
1,20,3,1,2013,2,12510,1778,14288
1,20,3,1,2013,3,12386,1685,14071
1,20,3,1,2013,4,12412,1622,14034
1,20,3,1,2013,5,12579,1612,14191
1,20,3,1,2013,6,12804,1703,14507
1,20,3,1,2013,7,13278,1808,15086
1,20,3,1,2013,8,13456,1929,15385
1,20,3,1,2013,9,13892,2210,16102
1,20,3,1,2013,10,14467,2565,17032
1,20,3,1,2013,11,14583,2817,17400
1,20,3,1,2013,12,14623,2866,17489
1,20,3,1,2013,13,14362,2830,17192
1,20,3,1,2013,14,14069,2755,16824
1,20,3,1,2013,15,13888,2790,16678
1,20,3,1,2013,16,14041,2796,16837
1,20,3,1,2013,17,13583,2774,16357
1,20,3,1,2013,18,12679,2696,15375
1,20,3,1,2013,19,12199,2594,14793
1,20,3,1,2013,20,13521,2651,16172
1,20,3,1,2013,21,13267,2570,15837
1,20,3,1,2013,22,12810,2385,15195
1,20,3,1,2013,23,12511,2228,14739
1,20,3,1,2013,24,12574,2116,14690
1,21,3,1,2013,1,12440,1940,14380
1,21,3,1,2013,2,12579,1771,14350
1,21,3,1,2013,3,12173,1677,13850
1,21,3,1,2013,4,12334,1614,13948
1,21,3,1,2013,5,12633,1606,14239
1,21,3,1,2013,6,12847,1696,14543
1,21,3,1,2013,7,13372,1802,15174
1,21,3,1,2013,8,13543,1924,15467
1,21,3,1,2013,9,13961,2204,16165
1,21,3,1,2013,10,14172,2558,16730
1,21,3,1,2013,11,14629,2812,17441
1,21,3,1,2013,12,14567,2873,17440
1,21,3,1,2013,13,14202,2830,17032
1,21,3,1,2013,14,14017,2755,16772
1,21,3,1,2013,15,13975,2790,16765
1,21,3,1,2013,16,14023,2795,16818
1,21,3,1,2013,17,13619,2774,16393
1,21,3,1,2013,18,12220,2696,14916
1,21,3,1,2013,19,12074,2593,14667
1,21,3,1,2013,20,13537,2651,16188
1,21,3,1,2013,21,13542,2571,16113
1,21,3,1,2013,22,12709,2431,15140
1,21,3,1,2013,23,12527,2333,14860
1,21,3,1,2013,24,12627,2173,14800
1,22,3,1,2013,1,12645,1976,14621
1,22,3,1,2013,2,12402,1805,14207
1,22,3,1,2013,3,12302,1712,14014
1,22,3,1,2013,4,12394,1648,14042
1,22,3,1,2013,5,12652,1638,14290
1,22,3,1,2013,6,13031,1729,14760
1,22,3,1,2013,7,13242,1834,15076
1,22,3,1,2013,8,13709,1958,15667
1,22,3,1,2013,9,13683,2237,15920
1,22,3,1,2013,10,13930,2591,16521
1,22,3,1,2013,11,14290,2844,17134
1,22,3,1,2013,12,13940,2906,16846
1,22,3,1,2013,13,13868,2905,16773
1,22,3,1,2013,14,13255,2833,16088
1,22,3,1,2013,15,13220,2871,16091
1,22,3,1,2013,16,13368,2866,16234
1,22,3,1,2013,17,12688,2852,15540
1,22,3,1,2013,18,11857,2776,14633
1,22,3,1,2013,19,11873,2673,14546
1,22,3,1,2013,20,13116,2730,15846
1,22,3,1,2013,21,12855,2593,15448
1,22,3,1,2013,22,12476,2463,14939
1,22,3,1,2013,23,12338,2319,14657
1,22,3,1,2013,24,12587,2181,14768
2,23,3,1,2013,1,12564,1976,14540
2,23,3,1,2013,2,12584,1803,14387
2,23,3,1,2013,3,12373,1720,14093
2,23,3,1,2013,4,12438,1652,14090
2,23,3,1,2013,5,12582,1649,14231
2,23,3,1,2013,6,12949,1705,14654
2,23,3,1,2013,7,13498,1779,15277
2,23,3,1,2013,8,13784,1879,15663
2,23,3,1,2013,9,13923,2121,16044
2,23,3,1,2013,10,14262,2450,16712
2,23,3,1,2013,11,14417,2675,17092
2,23,3,1,2013,12,14399,2756,17155
2,23,3,1,2013,13,14138,2712,16850
2,23,3,1,2013,14,13944,2591,16535
2,23,3,1,2013,15,13845,2601,16446
2,23,3,1,2013,16,14097,2564,16661
2,23,3,1,2013,17,13545,2508,16053
2,23,3,1,2013,18,12365,2423,14788
2,23,3,1,2013,19,12213,2482,14695
2,23,3,1,2013,20,13375,2534,15909
2,23,3,1,2013,21,13137,2518,15655
2,23,3,1,2013,22,12321,2410,14731
2,23,3,1,2013,23,12555,2211,14766
2,23,3,1,2013,24,12704,2023,14727
2,24,3,1,2013,1,12751,1952,14703
2,24,3,1,2013,2,12564,1785,14349
2,24,3,1,2013,3,12588,1703,14291
2,24,3,1,2013,4,12440,1638,14078
2,24,3,1,2013,5,12688,1632,14320
2,24,3,1,2013,6,13066,1674,14740
2,24,3,1,2013,7,13658,1697,15355
2,24,3,1,2013,8,13821,1707,15528
2,24,3,1,2013,9,13832,1804,15636
2,24,3,1,2013,10,14098,1968,16066
2,24,3,1,2013,11,14612,2077,16689
2,24,3,1,2013,12,14445,2126,16571
2,24,3,1,2013,13,14090,2143,16233
2,24,3,1,2013,14,13839,2058,15897
2,24,3,1,2013,15,13768,2024,15792
2,24,3,1,2013,16,13956,2000,15956
2,24,3,1,2013,17,13455,1973,15428
2,24,3,1,2013,18,11971,1941,13912
2,24,3,1,2013,19,12093,2008,14101
2,24,3,1,2013,20,13300,2205,15505
2,24,3,1,2013,21,13161,2248,15409
2,24,3,1,2013,22,12658,2241,14899
2,24,3,1,2013,23,12529,2196,14725
2,24,3,1,2013,24,12660,2125,14785
1,25,3,1,2013,1,12808,1911,14719
1,25,3,1,2013,2,12565,1749,14314
1,25,3,1,2013,3,12353,1668,14021
1,25,3,1,2013,4,12327,1604,13931
1,25,3,1,2013,5,12517,1612,14129
1,25,3,1,2013,6,13040,1697,14737
1,25,3,1,2013,7,13445,1829,15274
1,25,3,1,2013,8,13915,1971,15886
1,25,3,1,2013,9,13818,2263,16081
1,25,3,1,2013,10,14499,2607,17106
1,25,3,1,2013,11,15009,2867,17876
1,25,3,1,2013,12,15073,2933,18006
1,25,3,1,2013,13,14747,2837,17584
1,25,3,1,2013,14,14237,2826,17063
1,25,3,1,2013,15,14264,2815,17079
1,25,3,1,2013,16,14401,2850,17251
1,25,3,1,2013,17,13908,2834,16742
1,25,3,1,2013,18,12722,2842,15564
1,25,3,1,2013,19,12686,2679,15365
1,25,3,1,2013,20,13593,2755,16348
1,25,3,1,2013,21,13628,2590,16218
1,25,3,1,2013,22,13121,2456,15577
1,25,3,1,2013,23,13087,2316,15403
1,25,3,1,2013,24,12919,2183,15102
1,26,3,1,2013,1,12982,2018,15000
1,26,3,1,2013,2,12764,1829,14593
1,26,3,1,2013,3,12706,1721,14427
1,26,3,1,2013,4,12745,1653,14398
1,26,3,1,2013,5,12913,1648,14561
1,26,3,1,2013,6,13366,1730,15096
1,26,3,1,2013,7,13881,1837,15718
1,26,3,1,2013,8,14160,1976,16136
1,26,3,1,2013,9,14027,2267,16294
1,26,3,1,2013,10,14671,2600,17271
1,26,3,1,2013,11,14976,2845,17821
1,26,3,1,2013,12,14905,2928,17833
1,26,3,1,2013,13,14775,2889,17664
1,26,3,1,2013,14,14424,2779,17203
1,26,3,1,2013,15,14238,2829,17067
1,26,3,1,2013,16,14697,2825,17522
1,26,3,1,2013,17,13942,2765,16707
1,26,3,1,2013,18,12570,2659,15229
1,26,3,1,2013,19,12523,2571,15094
1,26,3,1,2013,20,13094,2614,15708
1,26,3,1,2013,21,12788,2538,15326
1,26,3,1,2013,22,12618,2396,15014
1,26,3,1,2013,23,12404,2242,14646
1,26,3,1,2013,24,12517,2140,14657
3,27,3,1,2013,1,12638,1989,14627
3,27,3,1,2013,2,12378,1810,14188
3,27,3,1,2013,3,12386,1717,14103
3,27,3,1,2013,4,12342,1668,14010
3,27,3,1,2013,5,12287,1631,13918
3,27,3,1,2013,6,12440,1670,14110
3,27,3,1,2013,7,12518,1697,14215
3,27,3,1,2013,8,12520,1666,14186
3,27,3,1,2013,9,12479,1701,14180
3,27,3,1,2013,10,12128,1773,13901
3,27,3,1,2013,11,12447,1773,14220
3,27,3,1,2013,12,12414,1805,14219
3,27,3,1,2013,13,11888,1860,13748
3,27,3,1,2013,14,11795,1902,13697
3,27,3,1,2013,15,11909,1796,13705
3,27,3,1,2013,16,12016,1780,13796
3,27,3,1,2013,17,11793,1782,13575
3,27,3,1,2013,18,11139,1773,12912
3,27,3,1,2013,19,11249,1815,13064
3,27,3,1,2013,20,11940,2021,13961
3,27,3,1,2013,21,11691,2029,13720
3,27,3,1,2013,22,11516,2039,13555
3,27,3,1,2013,23,11250,2015,13265
3,27,3,1,2013,24,11507,1948,13455
1,28,3,1,2013,1,11576,1833,13409
1,28,3,1,2013,2,11215,1687,12902
1,28,3,1,2013,3,11235,1605,12840
1,28,3,1,2013,4,11036,1565,12601
1,28,3,1,2013,5,11127,1555,12682
1,28,3,1,2013,6,11914,1643,13557
1,28,3,1,2013,7,12277,1761,14038
1,28,3,1,2013,8,12591,1903,14494
1,28,3,1,2013,9,13033,2190,15223
1,28,3,1,2013,10,13784,2543,16327
1,28,3,1,2013,11,14153,2820,16973
1,28,3,1,2013,12,14159,2879,17038
1,28,3,1,2013,13,13890,2877,16767
1,28,3,1,2013,14,13653,2787,16440
1,28,3,1,2013,15,13554,2814,16368
1,28,3,1,2013,16,13844,2791,16635
1,28,3,1,2013,17,13249,2755,16004
1,28,3,1,2013,18,11829,2671,14500
1,28,3,1,2013,19,11966,2584,14550
1,28,3,1,2013,20,13003,2615,15618
1,28,3,1,2013,21,12803,2513,15316
1,28,3,1,2013,22,12397,2349,14746
1,28,3,1,2013,23,12562,2209,14771
1,28,3,1,2013,24,12495,2081,14576
3,29,3,1,2013,1,12505,1900,14405
3,29,3,1,2013,2,12600,1732,14332
3,29,3,1,2013,3,12371,1642,14013
3,29,3,1,2013,4,12398,1584,13982
3,29,3,1,2013,5,12465,1578,14043
3,29,3,1,2013,6,12657,1642,14299
3,29,3,1,2013,7,12938,1695,14633
3,29,3,1,2013,8,13181,1782,14963
3,29,3,1,2013,9,13257,2010,15267
3,29,3,1,2013,10,13809,2297,16106
3,29,3,1,2013,11,13787,2528,16315
3,29,3,1,2013,12,13825,2572,16397
3,29,3,1,2013,13,13396,2570,15966
3,29,3,1,2013,14,13109,2486,15595
3,29,3,1,2013,15,13167,2485,15652
3,29,3,1,2013,16,13103,2464,15567
3,29,3,1,2013,17,12671,2429,15100
3,29,3,1,2013,18,11852,2386,14238
3,29,3,1,2013,19,11585,2348,13933
3,29,3,1,2013,20,12620,2455,15075
3,29,3,1,2013,21,12526,2432,14958
3,29,3,1,2013,22,12298,2295,14593
3,29,3,1,2013,23,12438,2148,14586
3,29,3,1,2013,24,12421,1990,14411
2,30,3,1,2013,1,12382,1884,14266
2,30,3,1,2013,2,12328,1716,14044
2,30,3,1,2013,3,12150,1645,13795
2,30,3,1,2013,4,12086,1586,13672
2,30,3,1,2013,5,12166,1572,13738
2,30,3,1,2013,6,12378,1644,14022
2,30,3,1,2013,7,13223,1705,14928
2,30,3,1,2013,8,12961,1796,14757
2,30,3,1,2013,9,13250,2032,15282
2,30,3,1,2013,10,13712,2366,16078
2,30,3,1,2013,11,14257,2624,16881
2,30,3,1,2013,12,14150,2709,16859
2,30,3,1,2013,13,13949,2687,16636
2,30,3,1,2013,14,13718,2547,16265
2,30,3,1,2013,15,13815,2550,16365
2,30,3,1,2013,16,13951,2540,16491
2,30,3,1,2013,17,13588,2511,16099
2,30,3,1,2013,18,12139,2453,14592
2,30,3,1,2013,19,11994,2395,14389
2,30,3,1,2013,20,13085,2521,15606
2,30,3,1,2013,21,12658,2489,15147
2,30,3,1,2013,22,12569,2351,14920
2,30,3,1,2013,23,12576,2203,14779
2,30,3,1,2013,24,12824,2029,14853
2,31,3,1,2013,1,12528,1941,14469
2,31,3,1,2013,2,12490,1781,14271
2,31,3,1,2013,3,12377,1673,14050
2,31,3,1,2013,4,12186,1603,13789
2,31,3,1,2013,5,12076,1596,13672
2,31,3,1,2013,6,12559,1646,14205
2,31,3,1,2013,7,12861,1645,14506
2,31,3,1,2013,8,12936,1660,14596
2,31,3,1,2013,9,13154,1776,14930
2,31,3,1,2013,10,13630,1938,15568
2,31,3,1,2013,11,13847,2077,15924
2,31,3,1,2013,12,13887,2126,16013
2,31,3,1,2013,13,13549,2171,15720
2,31,3,1,2013,14,13166,2116,15282
2,31,3,1,2013,15,13203,2019,15222
2,31,3,1,2013,16,13432,2024,15456
2,31,3,1,2013,17,12707,2002,14709
2,31,3,1,2013,18,11795,1983,13778
2,31,3,1,2013,19,11938,1994,13932
2,31,3,1,2013,20,12390,2210,14600
2,31,3,1,2013,21,12235,2223,14458
2,31,3,1,2013,22,12047,2173,14220
2,31,3,1,2013,23,12211,2103,14314
2,31,3,1,2013,24,12400,2007,14407
1,1,4,2,2013,1,12571,1948,14519
1,1,4,2,2013,2,12409,1789,14198
1,1,4,2,2013,3,12479,1692,14171
1,1,4,2,2013,4,12361,1613,13974
1,1,4,2,2013,5,12211,1660,13871
1,1,4,2,2013,6,12563,1678,14241
1,1,4,2,2013,7,12872,1814,14686
1,1,4,2,2013,8,13171,1928,15099
1,1,4,2,2013,9,13227,2204,15431
1,1,4,2,2013,10,13925,2561,16486
1,1,4,2,2013,11,14175,2810,16985
1,1,4,2,2013,12,14271,2991,17262
1,1,4,2,2013,13,13995,2909,16904
1,1,4,2,2013,14,13672,2794,16466
1,1,4,2,2013,15,13662,2837,16499
1,1,4,2,2013,16,13954,2844,16798
1,1,4,2,2013,17,13674,2808,16482
1,1,4,2,2013,18,12506,2705,15211
1,1,4,2,2013,19,12543,2582,15125
1,1,4,2,2013,20,12893,2636,15529
1,1,4,2,2013,21,12338,2544,14882
1,1,4,2,2013,22,12624,2419,15043
1,1,4,2,2013,23,12632,2318,14950
1,1,4,2,2013,24,12751,2190,14941
1,2,4,2,2013,1,13084,1943,15027
1,2,4,2,2013,2,13042,1758,14800
1,2,4,2,2013,3,12585,1669,14254
1,2,4,2,2013,4,12587,1610,14197
1,2,4,2,2013,5,12721,1601,14322
1,2,4,2,2013,6,13229,1684,14913
1,2,4,2,2013,7,13922,1784,15706
1,2,4,2,2013,8,13975,1929,15904
1,2,4,2,2013,9,14261,2212,16473
1,2,4,2,2013,10,14077,2555,16632
1,2,4,2,2013,11,14579,2795,17374
1,2,4,2,2013,12,14945,2861,17806
1,2,4,2,2013,13,14856,2767,17623
1,2,4,2,2013,14,14685,2638,17323
1,2,4,2,2013,15,14541,2660,17201
1,2,4,2,2013,16,14285,2657,16942
1,2,4,2,2013,17,13918,2639,16557
1,2,4,2,2013,18,13079,2574,15653
1,2,4,2,2013,19,12738,2470,15208
1,2,4,2,2013,20,13728,2515,16243
1,2,4,2,2013,21,13392,2415,15807
1,2,4,2,2013,22,13099,2270,15369
1,2,4,2,2013,23,13133,2146,15279
1,2,4,2,2013,24,13103,2017,15120
1,3,4,2,2013,1,13177,1850,15027
1,3,4,2,2013,2,13081,1687,14768
1,3,4,2,2013,3,13059,1586,14645
1,3,4,2,2013,4,12791,1543,14334
1,3,4,2,2013,5,13032,1564,14596
1,3,4,2,2013,6,13694,1646,15340
1,3,4,2,2013,7,13918,1753,15671
1,3,4,2,2013,8,13905,1867,15772
1,3,4,2,2013,9,13798,2158,15956
1,3,4,2,2013,10,14284,2439,16723
1,3,4,2,2013,11,14600,2723,17323
1,3,4,2,2013,12,14424,2843,17267
1,3,4,2,2013,13,14281,2787,17068
1,3,4,2,2013,14,14003,2676,16679
1,3,4,2,2013,15,13909,2706,16615
1,3,4,2,2013,16,14206,2698,16904
1,3,4,2,2013,17,13838,2654,16492
1,3,4,2,2013,18,12918,2586,15504
1,3,4,2,2013,19,12688,2475,15163
1,3,4,2,2013,20,13104,2561,15665
1,3,4,2,2013,21,13462,2419,15881
1,3,4,2,2013,22,13022,2272,15294
1,3,4,2,2013,23,13206,2194,15400
1,3,4,2,2013,24,13323,2026,15349
1,4,4,2,2013,1,13003,1912,14915
1,4,4,2,2013,2,12690,1748,14438
1,4,4,2,2013,3,12625,1653,14278
1,4,4,2,2013,4,12437,1593,14030
1,4,4,2,2013,5,12684,1580,14264
1,4,4,2,2013,6,13237,1674,14911
1,4,4,2,2013,7,13540,1777,15317
1,4,4,2,2013,8,13834,1924,15758
1,4,4,2,2013,9,13789,2208,15997
1,4,4,2,2013,10,13980,2545,16525
1,4,4,2,2013,11,14372,2796,17168
1,4,4,2,2013,12,14031,2885,16916
1,4,4,2,2013,13,13704,2867,16571
1,4,4,2,2013,14,13512,2771,16283
1,4,4,2,2013,15,13701,2820,16521
1,4,4,2,2013,16,13979,2821,16800
1,4,4,2,2013,17,13610,2814,16424
1,4,4,2,2013,18,12164,2744,14908
1,4,4,2,2013,19,12258,2620,14878
1,4,4,2,2013,20,12867,2669,15536
1,4,4,2,2013,21,12947,2577,15524
1,4,4,2,2013,22,12786,2423,15209
1,4,4,2,2013,23,12984,2298,15282
1,4,4,2,2013,24,12959,2184,15143
1,5,4,2,2013,1,12884,1985,14869
1,5,4,2,2013,2,12908,1824,14732
1,5,4,2,2013,3,12639,1696,14335
1,5,4,2,2013,4,12652,1629,14281
1,5,4,2,2013,5,12828,1618,14446
1,5,4,2,2013,6,13001,1726,14727
1,5,4,2,2013,7,13121,1828,14949
1,5,4,2,2013,8,13524,1954,15478
1,5,4,2,2013,9,13627,2263,15890
1,5,4,2,2013,10,13803,2633,16436
1,5,4,2,2013,11,14082,2875,16957
1,5,4,2,2013,12,13950,2934,16884
1,5,4,2,2013,13,13658,2921,16579
1,5,4,2,2013,14,13328,2842,16170
1,5,4,2,2013,15,13329,2853,16182
1,5,4,2,2013,16,13504,2887,16391
1,5,4,2,2013,17,13135,2870,16005
1,5,4,2,2013,18,12040,2810,14850
1,5,4,2,2013,19,11731,2686,14417
1,5,4,2,2013,20,12735,2731,15466
1,5,4,2,2013,21,12850,2660,15510
1,5,4,2,2013,22,12895,2469,15364
1,5,4,2,2013,23,13286,2286,15572
1,5,4,2,2013,24,13060,2294,15354
2,6,4,2,2013,1,12914,2107,15021
2,6,4,2,2013,2,12821,1894,14715
2,6,4,2,2013,3,12429,1762,14191
2,6,4,2,2013,4,12550,1682,14232
2,6,4,2,2013,5,12572,1654,14226
2,6,4,2,2013,6,13051,1722,14773
2,6,4,2,2013,7,13664,1788,15452
2,6,4,2,2013,8,13780,1875,15655
2,6,4,2,2013,9,13818,2144,15962
2,6,4,2,2013,10,14163,2476,16639
2,6,4,2,2013,11,14537,2750,17287
2,6,4,2,2013,12,14528,2809,17337
2,6,4,2,2013,13,14227,2796,17023
2,6,4,2,2013,14,13831,2718,16549
2,6,4,2,2013,15,13776,2717,16493
2,6,4,2,2013,16,13884,2715,16599
2,6,4,2,2013,17,13643,2658,16301
2,6,4,2,2013,18,12489,2427,14916
2,6,4,2,2013,19,12153,2519,14672
2,6,4,2,2013,20,12926,2574,15500
2,6,4,2,2013,21,12895,2524,15419
2,6,4,2,2013,22,12723,2491,15214
2,6,4,2,2013,23,12757,2342,15099
2,6,4,2,2013,24,13223,2290,15513
2,7,4,2,2013,1,13125,2053,15178
2,7,4,2,2013,2,13103,1853,14956
2,7,4,2,2013,3,13207,1740,14947
2,7,4,2,2013,4,12733,1688,14421
2,7,4,2,2013,5,12770,1685,14455
2,7,4,2,2013,6,13276,1719,14995
2,7,4,2,2013,7,13803,1723,15526
2,7,4,2,2013,8,13838,1729,15567
2,7,4,2,2013,9,13792,1818,15610
2,7,4,2,2013,10,13818,1941,15759
2,7,4,2,2013,11,14253,2054,16307
2,7,4,2,2013,12,14062,2108,16170
2,7,4,2,2013,13,13908,2111,16019
2,7,4,2,2013,14,13654,2073,15727
2,7,4,2,2013,15,13627,2047,15674
2,7,4,2,2013,16,13808,2029,15837
2,7,4,2,2013,17,13406,2019,15425
2,7,4,2,2013,18,11786,1998,13784
2,7,4,2,2013,19,11527,2028,13555
2,7,4,2,2013,20,12488,2190,14678
2,7,4,2,2013,21,12635,2241,14876
2,7,4,2,2013,22,12424,2240,14664
2,7,4,2,2013,23,12608,2215,14823
2,7,4,2,2013,24,12589,2175,14764
1,9,4,2,2013,1,13451,1995,15446
1,9,4,2,2013,2,13189,1839,15028
1,9,4,2,2013,3,12822,1757,14579
1,9,4,2,2013,4,12635,1717,14352
1,9,4,2,2013,5,12628,1720,14348
1,9,4,2,2013,6,13241,1781,15022
1,9,4,2,2013,7,13498,1876,15374
1,9,4,2,2013,8,13863,1983,15846
1,9,4,2,2013,9,13792,2228,16020
1,9,4,2,2013,10,14598,2550,17148
1,9,4,2,2013,11,14938,2783,17721
1,9,4,2,2013,12,14662,2940,17602
1,9,4,2,2013,13,14511,2935,17446
1,9,4,2,2013,14,14158,2874,17032
1,9,4,2,2013,15,14326,2887,17213
1,9,4,2,2013,16,14510,2925,17435
1,9,4,2,2013,17,14214,2913,17127
1,9,4,2,2013,18,12795,2844,15639
1,9,4,2,2013,19,12639,2728,15367
1,9,4,2,2013,20,13267,2782,16049
1,9,4,2,2013,21,13329,2660,15989
1,9,4,2,2013,22,13250,2517,15767
1,9,4,2,2013,23,13405,2391,15796
1,9,4,2,2013,24,13404,2245,15649
1,10,4,2,2013,1,13174,2044,15218
1,10,4,2,2013,2,13079,1867,14946
1,10,4,2,2013,3,12923,1747,14670
1,10,4,2,2013,4,12854,1694,14548
1,10,4,2,2013,5,13021,1676,14697
1,10,4,2,2013,6,13311,1728,15039
1,10,4,2,2013,7,13453,1761,15214
1,10,4,2,2013,8,13333,1832,15165
1,10,4,2,2013,9,13465,2002,15467
1,10,4,2,2013,10,13514,2243,15757
1,10,4,2,2013,11,14083,2423,16506
1,10,4,2,2013,12,13997,2481,16478
1,10,4,2,2013,13,13721,2484,16205
1,10,4,2,2013,14,13728,2401,16129
1,10,4,2,2013,15,13635,2395,16030
1,10,4,2,2013,16,13759,2400,16159
1,10,4,2,2013,17,13366,2381,15747
1,10,4,2,2013,18,12212,2327,14539
1,10,4,2,2013,19,11319,2321,13640
1,10,4,2,2013,20,13053,2486,15539
1,10,4,2,2013,21,12900,2474,15374
1,10,4,2,2013,22,12673,2359,15032
1,10,4,2,2013,23,12731,2279,15010
1,10,4,2,2013,24,12748,2185,14933
3,11,4,2,2013,1,13174,2044,15218
3,11,4,2,2013,2,13079,1867,14946
3,11,4,2,2013,3,12923,1747,14670
3,11,4,2,2013,4,12854,1694,14548
3,11,4,2,2013,5,13021,1676,14697
3,11,4,2,2013,6,13311,1728,15039
3,11,4,2,2013,7,13453,1761,15214
3,11,4,2,2013,8,13333,1832,15165
3,11,4,2,2013,9,13465,2002,15467
3,11,4,2,2013,10,13514,2243,15757
3,11,4,2,2013,11,14083,2423,16506
3,11,4,2,2013,12,13997,2481,16478
3,11,4,2,2013,13,13721,2484,16205
3,11,4,2,2013,14,13728,2401,16129
3,11,4,2,2013,15,13635,2395,16030
3,11,4,2,2013,16,13759,2400,16159
3,11,4,2,2013,17,13366,2381,15747
3,11,4,2,2013,18,12212,2327,14539
3,11,4,2,2013,19,11319,2321,13640
3,11,4,2,2013,20,13053,2486,15539
3,11,4,2,2013,21,12900,2474,15374
3,11,4,2,2013,22,12673,2359,15032
3,11,4,2,2013,23,12731,2279,15010
3,11,4,2,2013,24,12748,2185,14933
1,12,4,2,2013,1,12819,2001,14820
1,12,4,2,2013,2,12561,1829,14390
1,12,4,2,2013,3,12627,1721,14348
1,12,4,2,2013,4,12378,1654,14032
1,12,4,2,2013,5,12518,1640,14158
1,12,4,2,2013,6,12844,1725,14569
1,12,4,2,2013,7,13275,1791,15066
1,12,4,2,2013,8,13439,1924,15363
1,12,4,2,2013,9,13430,2240,15670
1,12,4,2,2013,10,13645,2642,16287
1,12,4,2,2013,11,13978,2911,16889
1,12,4,2,2013,12,13542,2960,16502
1,12,4,2,2013,13,13811,2958,16769
1,12,4,2,2013,14,13667,2861,16528
1,12,4,2,2013,15,13688,2914,16602
1,12,4,2,2013,16,14029,2932,16961
1,12,4,2,2013,17,13478,2923,16401
1,12,4,2,2013,18,12444,2827,15271
1,12,4,2,2013,19,11712,2703,14415
1,12,4,2,2013,20,12827,2754,15581
1,12,4,2,2013,21,13003,2656,15659
1,12,4,2,2013,22,12730,2510,15240
1,12,4,2,2013,23,12825,2371,15196
1,12,4,2,2013,24,13341,2268,15609
2,13,4,2,2013,1,13172,2115,15287
2,13,4,2,2013,2,13082,1904,14986
2,13,4,2,2013,3,12976,1791,14767
2,13,4,2,2013,4,12663,1709,14372
2,13,4,2,2013,5,12758,1691,14449
2,13,4,2,2013,6,13216,1741,14957
2,13,4,2,2013,7,13402,1787,15189
2,13,4,2,2013,8,13465,1868,15333
2,13,4,2,2013,9,13526,2098,15624
2,13,4,2,2013,10,14175,2406,16581
2,13,4,2,2013,11,14638,2656,17294
2,13,4,2,2013,12,14386,2790,17176
2,13,4,2,2013,13,14163,2834,16997
2,13,4,2,2013,14,13929,2728,16657
2,13,4,2,2013,15,13939,2801,16740
2,13,4,2,2013,16,14357,2788,17145
2,13,4,2,2013,17,13833,2761,16594
2,13,4,2,2013,18,12688,2640,15328
2,13,4,2,2013,19,12536,2645,15181
2,13,4,2,2013,20,12952,2793,15745
2,13,4,2,2013,21,12996,2651,15647
2,13,4,2,2013,22,12892,2532,15424
2,13,4,2,2013,23,12862,2454,15316
2,13,4,2,2013,24,12970,2376,15346
3,14,4,2,2013,1,13111,2167,15278
3,14,4,2,2013,2,12976,1975,14951
3,14,4,2,2013,3,12976,1840,14816
3,14,4,2,2013,4,12900,1756,14656
3,14,4,2,2013,5,12922,1728,14650
3,14,4,2,2013,6,13195,1738,14933
3,14,4,2,2013,7,13296,1733,15029
3,14,4,2,2013,8,13473,1760,15233
3,14,4,2,2013,9,13564,1846,15410
3,14,4,2,2013,10,13798,1986,15784
3,14,4,2,2013,11,14192,2119,16311
3,14,4,2,2013,12,14317,2185,16502
3,14,4,2,2013,13,14148,2224,16372
3,14,4,2,2013,14,13702,2162,15864
3,14,4,2,2013,15,13879,2121,16000
3,14,4,2,2013,16,14063,2049,16112
3,14,4,2,2013,17,13470,2027,15497
3,14,4,2,2013,18,12203,2039,14242
3,14,4,2,2013,19,11888,2068,13956
3,14,4,2,2013,20,13168,2267,15435
3,14,4,2,2013,21,13132,2315,15447
3,14,4,2,2013,22,12651,2312,14963
3,14,4,2,2013,23,13236,2305,15541
3,14,4,2,2013,24,13192,2275,15467
1,15,4,2,2013,1,13268,2078,15346
1,15,4,2,2013,2,13017,1886,14903
1,15,4,2,2013,3,12876,1774,14650
1,15,4,2,2013,4,13052,1714,14766
1,15,4,2,2013,5,12983,1681,14664
1,15,4,2,2013,6,13252,1746,14998
1,15,4,2,2013,7,13623,1835,15458
1,15,4,2,2013,8,13647,1969,15616
1,15,4,2,2013,9,13830,2265,16095
1,15,4,2,2013,10,14303,2632,16935
1,15,4,2,2013,11,14637,2890,17527
1,15,4,2,2013,12,14480,2962,17442
1,15,4,2,2013,13,13965,2935,16900
1,15,4,2,2013,14,13712,2814,16526
1,15,4,2,2013,15,13704,2881,16585
1,15,4,2,2013,16,13955,2904,16859
1,15,4,2,2013,17,13425,2883,16308
1,15,4,2,2013,18,12347,2806,15153
1,15,4,2,2013,19,12100,2685,14785
1,15,4,2,2013,20,13211,2760,15971
1,15,4,2,2013,21,13230,2664,15894
1,15,4,2,2013,22,12904,2488,15392
1,15,4,2,2013,23,13168,2353,15521
1,15,4,2,2013,24,13198,2256,15454
1,16,4,2,2013,1,13166,2104,15270
1,16,4,2,2013,2,12996,1898,14894
1,16,4,2,2013,3,12840,1775,14615
1,16,4,2,2013,4,12655,1709,14364
1,16,4,2,2013,5,12759,1685,14444
1,16,4,2,2013,6,13252,1745,14997
1,16,4,2,2013,7,13858,1811,15669
1,16,4,2,2013,8,13715,1939,15654
1,16,4,2,2013,9,13599,2238,15837
1,16,4,2,2013,10,14159,2597,16756
1,16,4,2,2013,11,14498,2854,17352
1,16,4,2,2013,12,14285,2911,17196
1,16,4,2,2013,13,13992,2890,16882
1,16,4,2,2013,14,13776,2796,16572
1,16,4,2,2013,15,13527,2832,16359
1,16,4,2,2013,16,13803,2863,16666
1,16,4,2,2013,17,13566,2844,16410
1,16,4,2,2013,18,12426,2785,15211
1,16,4,2,2013,19,12185,2638,14823
1,16,4,2,2013,20,12971,2743,15714
1,16,4,2,2013,21,12962,2646,15608
1,16,4,2,2013,22,13074,2449,15523
1,16,4,2,2013,23,13214,2319,15533
1,16,4,2,2013,24,13334,2247,15581
1,17,4,2,2013,1,13210,2065,15275
1,17,4,2,2013,2,12973,1878,14851
1,17,4,2,2013,3,12870,1769,14639
1,17,4,2,2013,4,12812,1708,14520
1,17,4,2,2013,5,12773,1676,14449
1,17,4,2,2013,6,13244,1739,14983
1,17,4,2,2013,7,13597,1807,15404
1,17,4,2,2013,8,13590,1933,15523
1,17,4,2,2013,9,13846,2234,16080
1,17,4,2,2013,10,14326,2607,16933
1,17,4,2,2013,11,14720,2855,17575
1,17,4,2,2013,12,14656,2926,17582
1,17,4,2,2013,13,14326,2921,17247
1,17,4,2,2013,14,13903,2808,16711
1,17,4,2,2013,15,13653,2838,16491
1,17,4,2,2013,16,14035,2865,16900
1,17,4,2,2013,17,13744,2848,16592
1,17,4,2,2013,18,12430,2768,15198
1,17,4,2,2013,19,12291,2658,14949
1,17,4,2,2013,20,12954,2721,15675
1,17,4,2,2013,21,13132,2590,15722
1,17,4,2,2013,22,12836,2499,15335
1,17,4,2,2013,23,13204,2322,15526
1,17,4,2,2013,24,13302,2182,15484
1,18,4,2,2013,1,13192,2068,15260
1,18,4,2,2013,2,13056,1880,14936
1,18,4,2,2013,3,13024,1777,14801
1,18,4,2,2013,4,12717,1757,14474
1,18,4,2,2013,5,12778,1701,14479
1,18,4,2,2013,6,13166,1725,14891
1,18,4,2,2013,7,13558,1835,15393
1,18,4,2,2013,8,13366,1972,15338
1,18,4,2,2013,9,13938,2089,16027
1,18,4,2,2013,10,13909,2608,16517
1,18,4,2,2013,11,13964,2853,16817
1,18,4,2,2013,12,13608,2884,16492
1,18,4,2,2013,13,13434,2898,16332
1,18,4,2,2013,14,13304,2781,16085
1,18,4,2,2013,15,13265,2831,16096
1,18,4,2,2013,16,13575,2841,16416
1,18,4,2,2013,17,13126,2823,15949
1,18,4,2,2013,18,12257,2740,14997
1,18,4,2,2013,19,11845,2649,14494
1,18,4,2,2013,20,12732,2724,15456
1,18,4,2,2013,21,12510,2614,15124
1,18,4,2,2013,22,12361,2461,14822
1,18,4,2,2013,23,12602,2327,14929
1,18,4,2,2013,24,12720,2239,14959
1,19,4,2,2013,1,12795,2129,14924
1,19,4,2,2013,2,12610,1922,14532
1,19,4,2,2013,3,12527,1773,14300
1,19,4,2,2013,4,12324,1704,14028
1,19,4,2,2013,5,12438,1680,14118
1,19,4,2,2013,6,12886,1750,14636
1,19,4,2,2013,7,13198,1798,14996
1,19,4,2,2013,8,13157,1900,15057
1,19,4,2,2013,9,13512,2157,15669
1,19,4,2,2013,10,13737,2490,16227
1,19,4,2,2013,11,13885,2748,16633
1,19,4,2,2013,12,13767,2802,16569
1,19,4,2,2013,13,13492,2799,16291
1,19,4,2,2013,14,12983,2673,15656
1,19,4,2,2013,15,12885,2719,15604
1,19,4,2,2013,16,12959,2767,15726
1,19,4,2,2013,17,12449,2720,15169
1,19,4,2,2013,18,11736,2662,14398
1,19,4,2,2013,19,11432,2577,14009
1,19,4,2,2013,20,12361,2661,15022
1,19,4,2,2013,21,12237,2536,14773
1,19,4,2,2013,22,11964,2460,14424
1,19,4,2,2013,23,12072,2376,14448
1,19,4,2,2013,24,12569,2261,14830
3,20,4,2,2013,1,12296,2109,14405
3,20,4,2,2013,2,12252,1910,14162
3,20,4,2,2013,3,12224,1819,14043
3,20,4,2,2013,4,12113,1760,13873
3,20,4,2,2013,5,12010,1741,13751
3,20,4,2,2013,6,12570,1798,14368
3,20,4,2,2013,7,13550,1815,15365
3,20,4,2,2013,8,13900,1915,15815
3,20,4,2,2013,9,13746,2134,15880
3,20,4,2,2013,10,13750,2477,16227
3,20,4,2,2013,11,14010,2717,16727
3,20,4,2,2013,12,14344,2778,17122
3,20,4,2,2013,13,14227,2762,16989
3,20,4,2,2013,14,13322,2640,15962
3,20,4,2,2013,15,13670,2652,16322
3,20,4,2,2013,16,13520,2650,16170
3,20,4,2,2013,17,13020,2615,15635
3,20,4,2,2013,18,11994,2545,14539
3,20,4,2,2013,19,11678,2470,14148
3,20,4,2,2013,20,12532,2593,15125
3,20,4,2,2013,21,12419,2585,15004
3,20,4,2,2013,22,12552,2444,14996
3,20,4,2,2013,23,12548,2306,14854
3,20,4,2,2013,24,12565,2202,14767
2,21,4,2,2013,1,12941,2116,15057
2,21,4,2,2013,2,12740,1945,14685
2,21,4,2,2013,3,12397,1825,14222
2,21,4,2,2013,4,12103,1765,13868
2,21,4,2,2013,5,12200,1730,13930
2,21,4,2,2013,6,13028,1762,14790
2,21,4,2,2013,7,13525,1752,15277
2,21,4,2,2013,8,13825,1773,15598
2,21,4,2,2013,9,13511,1837,15348
2,21,4,2,2013,10,13945,1962,15907
2,21,4,2,2013,11,14089,2102,16191
2,21,4,2,2013,12,13924,2126,16050
2,21,4,2,2013,13,13672,2119,15791
2,21,4,2,2013,14,13521,2072,15593
2,21,4,2,2013,15,13417,2059,15476
2,21,4,2,2013,16,13332,2054,15386
2,21,4,2,2013,17,12964,2049,15013
2,21,4,2,2013,18,11838,2017,13855
2,21,4,2,2013,19,12163,2038,14201
2,21,4,2,2013,20,13064,2209,15273
2,21,4,2,2013,21,12883,2244,15127
2,21,4,2,2013,22,12646,2258,14904
2,21,4,2,2013,23,12655,2238,14893
2,21,4,2,2013,24,12866,2194,15060
1,22,4,2,2013,1,12705,2087,14792
1,22,4,2,2013,2,12723,1897,14620
1,22,4,2,2013,3,12616,1788,14404
1,22,4,2,2013,4,12610,1711,14321
1,22,4,2,2013,5,12659,1699,14358
1,22,4,2,2013,6,13256,1754,15010
1,22,4,2,2013,7,13601,1825,15426
1,22,4,2,2013,8,13642,1971,15613
1,22,4,2,2013,9,13867,2294,16161
1,22,4,2,2013,10,14014,2641,16655
1,22,4,2,2013,11,14192,2906,17098
1,22,4,2,2013,12,14154,2957,17111
1,22,4,2,2013,13,14096,2963,17059
1,22,4,2,2013,14,13887,2889,16776
1,22,4,2,2013,15,13535,2949,16484
1,22,4,2,2013,16,13627,2952,16579
1,22,4,2,2013,17,13399,2923,16322
1,22,4,2,2013,18,11904,2818,14722
1,22,4,2,2013,19,11727,2677,14404
1,22,4,2,2013,20,12615,2722,15337
1,22,4,2,2013,21,12848,2615,15463
1,22,4,2,2013,22,12682,2520,15202
1,22,4,2,2013,23,12900,2438,15338
1,22,4,2,2013,24,13059,2328,15387
1,23,4,2,2013,1,13072,2157,15229
1,23,4,2,2013,2,13063,1950,15013
1,23,4,2,2013,3,12939,1832,14771
1,23,4,2,2013,4,12802,1767,14569
1,23,4,2,2013,5,12820,1736,14556
1,23,4,2,2013,6,13288,1808,15096
1,23,4,2,2013,7,13591,1838,15429
1,23,4,2,2013,8,13575,1980,15555
1,23,4,2,2013,9,13961,2288,16249
1,23,4,2,2013,10,14527,2690,17217
1,23,4,2,2013,11,14716,2970,17686
1,23,4,2,2013,12,14701,3050,17751
1,23,4,2,2013,13,14426,3060,17486
1,23,4,2,2013,14,14373,2944,17317
1,23,4,2,2013,15,14279,3001,17280
1,23,4,2,2013,16,14346,3004,17350
1,23,4,2,2013,17,13868,2974,16842
1,23,4,2,2013,18,12195,2886,15081
1,23,4,2,2013,19,11739,2747,14486
1,23,4,2,2013,20,12396,2760,15156
1,23,4,2,2013,21,12824,2634,15458
1,23,4,2,2013,22,12950,2519,15469
1,23,4,2,2013,23,13196,2492,15688
1,23,4,2,2013,24,13201,2360,15561
3,24,4,2,2013,1,13259,2187,15446
3,24,4,2,2013,2,13034,1978,15012
3,24,4,2,2013,3,13083,1873,14956
3,24,4,2,2013,4,12840,1790,14630
3,24,4,2,2013,5,12730,1769,14499
3,24,4,2,2013,6,13150,1819,14969
3,24,4,2,2013,7,13427,1842,15269
3,24,4,2,2013,8,13368,1939,15307
3,24,4,2,2013,9,13327,2149,15476
3,24,4,2,2013,10,14097,2543,16640
3,24,4,2,2013,11,14385,2854,17239
3,24,4,2,2013,12,14513,2950,17463
3,24,4,2,2013,13,14207,2965,17172
3,24,4,2,2013,14,13925,2898,16823
3,24,4,2,2013,15,14222,2939,17161
3,24,4,2,2013,16,14156,2970,17126
3,24,4,2,2013,17,14154,2964,17118
3,24,4,2,2013,18,12654,2840,15494
3,24,4,2,2013,19,12341,2710,15051
3,24,4,2,2013,20,12912,2795,15707
3,24,4,2,2013,21,13172,2765,15937
3,24,4,2,2013,22,12804,2676,15480
3,24,4,2,2013,23,13435,2586,16021
3,24,4,2,2013,24,13480,2460,15940
1,25,4,2,2013,1,13437,2382,15819
1,25,4,2,2013,2,13218,2127,15345
1,25,4,2,2013,3,13142,1953,15095
1,25,4,2,2013,4,12895,1869,14764
1,25,4,2,2013,5,13096,1822,14918
1,25,4,2,2013,6,13352,1863,15215
1,25,4,2,2013,7,13340,1901,15241
1,25,4,2,2013,8,13623,2032,15655
1,25,4,2,2013,9,13802,2334,16136
1,25,4,2,2013,10,14307,2739,17046
1,25,4,2,2013,11,14630,3039,17669
1,25,4,2,2013,12,14446,3133,17579
1,25,4,2,2013,13,14244,3139,17383
1,25,4,2,2013,14,13849,3086,16935
1,25,4,2,2013,15,14012,3132,17144
1,25,4,2,2013,16,14284,3144,17428
1,25,4,2,2013,17,13298,3140,16438
1,25,4,2,2013,18,12362,3020,15382
1,25,4,2,2013,19,11929,2844,14773
1,25,4,2,2013,20,12620,2855,15475
1,25,4,2,2013,21,12130,2767,14897
1,25,4,2,2013,22,11921,2643,14564
1,25,4,2,2013,23,11912,2593,14505
1,25,4,2,2013,24,11788,2587,14375
1,26,4,2,2013,1,11818,2455,14273
1,26,4,2,2013,2,11725,2216,13941
1,26,4,2,2013,3,11465,2037,13502
1,26,4,2,2013,4,11399,1940,13339
1,26,4,2,2013,5,11484,1891,13375
1,26,4,2,2013,6,11961,1925,13886
1,26,4,2,2013,7,11851,1937,13788
1,26,4,2,2013,8,12067,2060,14127
1,26,4,2,2013,9,12221,2359,14580
1,26,4,2,2013,10,12501,2760,15261
1,26,4,2,2013,11,13031,3053,16084
1,26,4,2,2013,12,12855,3137,15992
1,26,4,2,2013,13,12655,3135,15790
1,26,4,2,2013,14,12709,3043,15752
1,26,4,2,2013,15,12887,3116,16003
1,26,4,2,2013,16,13290,3136,16426
1,26,4,2,2013,17,12593,3118,15711
1,26,4,2,2013,18,11849,2997,14846
1,26,4,2,2013,19,11681,2798,14479
1,26,4,2,2013,20,12824,2824,15648
1,26,4,2,2013,21,12873,2736,15609
1,26,4,2,2013,22,12821,2645,15466
1,26,4,2,2013,23,13078,2533,15611
1,26,4,2,2013,24,13321,2503,15824
2,27,4,2,2013,1,12708,2400,15108
2,27,4,2,2013,2,12732,2187,14919
2,27,4,2,2013,3,12853,2024,14877
2,27,4,2,2013,4,12291,1921,14212
2,27,4,2,2013,5,12370,1868,14238
2,27,4,2,2013,6,12743,1900,14643
2,27,4,2,2013,7,12661,1877,14538
2,27,4,2,2013,8,12542,1935,14477
2,27,4,2,2013,9,12761,2158,14919
2,27,4,2,2013,10,13238,2475,15713
2,27,4,2,2013,11,13947,2753,16700
2,27,4,2,2013,12,13627,2874,16501
2,27,4,2,2013,13,13845,2891,16736
2,27,4,2,2013,14,13347,2808,16155
2,27,4,2,2013,15,13866,2839,16705
2,27,4,2,2013,16,14154,2839,16993
2,27,4,2,2013,17,13759,2778,16537
2,27,4,2,2013,18,12799,2685,15484
2,27,4,2,2013,19,12087,2555,14642
2,27,4,2,2013,20,13082,2658,15740
2,27,4,2,2013,21,13194,2648,15842
2,27,4,2,2013,22,13203,2563,15766
2,27,4,2,2013,23,13219,2525,15744
2,27,4,2,2013,24,13518,2527,16045
2,28,4,2,2013,1,13261,2410,15671
2,28,4,2,2013,2,13167,2229,15396
2,28,4,2,2013,3,13066,2084,15150
2,28,4,2,2013,4,12699,1980,14679
2,28,4,2,2013,5,12662,1924,14586
2,28,4,2,2013,6,13010,1941,14951
2,28,4,2,2013,7,12963,1869,14832
2,28,4,2,2013,8,13047,1842,14889
2,28,4,2,2013,9,13124,1914,15038
2,28,4,2,2013,10,13804,2019,15823
2,28,4,2,2013,11,14288,2175,16463
2,28,4,2,2013,12,14257,2231,16488
2,28,4,2,2013,13,14096,2259,16355
2,28,4,2,2013,14,13909,2227,16136
2,28,4,2,2013,15,13857,2245,16102
2,28,4,2,2013,16,14204,2241,16445
2,28,4,2,2013,17,13767,2196,15963
2,28,4,2,2013,18,12725,2153,14878
2,28,4,2,2013,19,12285,2120,14405
2,28,4,2,2013,20,13243,2314,15557
2,28,4,2,2013,21,13206,2399,15605
2,28,4,2,2013,22,13105,2403,15508
2,28,4,2,2013,23,13198,2426,15624
2,28,4,2,2013,24,13302,2463,15765
1,29,4,2,2013,1,13376,2344,15720
1,29,4,2,2013,2,13046,2194,15240
1,29,4,2,2013,3,12759,2068,14827
1,29,4,2,2013,4,12537,1935,14472
1,29,4,2,2013,5,12882,1875,14757
1,29,4,2,2013,6,13315,1946,15261
1,29,4,2,2013,7,13559,1950,15509
1,29,4,2,2013,8,13462,2017,15479
1,29,4,2,2013,9,13621,2292,15913
1,29,4,2,2013,10,14131,2699,16830
1,29,4,2,2013,11,14475,2972,17447
1,29,4,2,2013,12,14474,3070,17544
1,29,4,2,2013,13,14162,3119,17281
1,29,4,2,2013,14,13823,3022,16845
1,29,4,2,2013,15,13865,3077,16942
1,29,4,2,2013,16,14283,3112,17395
1,29,4,2,2013,17,13874,3070,16944
1,29,4,2,2013,18,12721,2949,15670
1,29,4,2,2013,19,12651,2767,15418
1,29,4,2,2013,20,13387,2791,16178
1,29,4,2,2013,21,13529,2809,16338
1,29,4,2,2013,22,13329,2625,15954
1,29,4,2,2013,23,13692,2455,16147
1,29,4,2,2013,24,13361,2616,15977
1,30,4,2,2013,1,13505,2421,15926
1,30,4,2,2013,2,13234,2214,15448
1,30,4,2,2013,3,13045,2076,15121
1,30,4,2,2013,4,12983,1983,14966
1,30,4,2,2013,5,12930,1925,14855
1,30,4,2,2013,6,13357,1966,15323
1,30,4,2,2013,7,13376,1966,15342
1,30,4,2,2013,8,13667,2066,15733
1,30,4,2,2013,9,13568,2370,15938
1,30,4,2,2013,10,14092,2734,16826
1,30,4,2,2013,11,14372,3016,17388
1,30,4,2,2013,12,14313,3148,17461
1,30,4,2,2013,13,14064,3168,17232
1,30,4,2,2013,14,14051,3109,17160
1,30,4,2,2013,15,14051,3185,17236
1,30,4,2,2013,16,14413,3192,17605
1,30,4,2,2013,17,14127,3144,17271
1,30,4,2,2013,18,12872,3017,15889
1,30,4,2,2013,19,12232,2845,15077
1,30,4,2,2013,20,13342,2847,16189
1,30,4,2,2013,21,13641,2741,16382
1,30,4,2,2013,22,13552,2681,16233
1,30,4,2,2013,23,13637,2557,16194
1,30,4,2,2013,24,13659,2524,16183
3,1,5,2,2013,1,13579,2425,16004
3,1,5,2,2013,2,13190,2244,15434
3,1,5,2,2013,3,13047,2115,15162
3,1,5,2,2013,4,12662,2000,14662
3,1,5,2,2013,5,12617,1948,14565
3,1,5,2,2013,6,12703,1970,14673
3,1,5,2,2013,7,12561,1906,14467
3,1,5,2,2013,8,12181,1898,14079
3,1,5,2,2013,9,12165,1959,14124
3,1,5,2,2013,10,12452,2095,14547
3,1,5,2,2013,11,12769,2283,15052
3,1,5,2,2013,12,12888,2365,15253
3,1,5,2,2013,13,12818,2382,15200
3,1,5,2,2013,14,12545,2367,14912
3,1,5,2,2013,15,12672,2423,15095
3,1,5,2,2013,16,12657,2445,15102
3,1,5,2,2013,17,12168,2415,14583
3,1,5,2,2013,18,10719,2375,13094
3,1,5,2,2013,19,10336,2318,12654
3,1,5,2,2013,20,11798,2458,14256
3,1,5,2,2013,21,12059,2547,14606
3,1,5,2,2013,22,12152,2551,14703
3,1,5,2,2013,23,12234,2553,14787
3,1,5,2,2013,24,12221,2561,14782
1,2,5,2,2013,1,12455,2404,14859
1,2,5,2,2013,2,12102,2182,14284
1,2,5,2,2013,3,11990,2020,14010
1,2,5,2,2013,4,11866,1913,13779
1,2,5,2,2013,5,11772,1882,13654
1,2,5,2,2013,6,12314,1914,14228
1,2,5,2,2013,7,12389,1897,14286
1,2,5,2,2013,8,12692,2025,14717
1,2,5,2,2013,9,13117,2339,15456
1,2,5,2,2013,10,13611,2750,16361
1,2,5,2,2013,11,14059,3042,17101
1,2,5,2,2013,12,14068,3119,17187
1,2,5,2,2013,13,13854,3146,17000
1,2,5,2,2013,14,13803,3068,16871
1,2,5,2,2013,15,13999,3092,17091
1,2,5,2,2013,16,13744,3109,16853
1,2,5,2,2013,17,13559,3080,16639
1,2,5,2,2013,18,12245,2953,15198
1,2,5,2,2013,19,11817,2786,14603
1,2,5,2,2013,20,12898,2821,15719
1,2,5,2,2013,21,13104,2736,15840
1,2,5,2,2013,22,12936,2638,15574
1,2,5,2,2013,23,13373,2595,15968
1,2,5,2,2013,24,13202,2566,15768
1,3,5,2,2013,1,13358,2386,15744
1,3,5,2,2013,2,12968,2197,15165
1,3,5,2,2013,3,12888,2055,14943
1,3,5,2,2013,4,12825,1965,14790
1,3,5,2,2013,5,12877,1906,14783
1,3,5,2,2013,6,12920,1929,14849
1,3,5,2,2013,7,13111,1912,15023
1,3,5,2,2013,8,12993,2024,15017
1,3,5,2,2013,9,12958,2311,15269
1,3,5,2,2013,10,13571,2696,16267
1,3,5,2,2013,11,13455,2986,16441
1,3,5,2,2013,12,13539,3047,16586
1,3,5,2,2013,13,13264,3047,16311
1,3,5,2,2013,14,13181,2994,16175
1,3,5,2,2013,15,13149,3033,16182
1,3,5,2,2013,16,13204,3044,16248
1,3,5,2,2013,17,12756,3016,15772
1,3,5,2,2013,18,12186,2935,15121
1,3,5,2,2013,19,11880,2759,14639
1,3,5,2,2013,20,13002,2796,15798
1,3,5,2,2013,21,12884,2701,15585
1,3,5,2,2013,22,12730,2587,15317
1,3,5,2,2013,23,13073,2536,15609
1,3,5,2,2013,24,13057,2523,15580
2,4,5,2,2013,1,13155,2383,15538
2,4,5,2,2013,2,12920,2168,15088
2,4,5,2,2013,3,12694,2028,14722
2,4,5,2,2013,4,12608,1934,14542
2,4,5,2,2013,5,12477,1868,14345
2,4,5,2,2013,6,12977,1905,14882
2,4,5,2,2013,7,13194,1885,15079
2,4,5,2,2013,8,13024,1942,14966
2,4,5,2,2013,9,13332,2151,15483
2,4,5,2,2013,10,13725,2493,16218
2,4,5,2,2013,11,13948,2786,16734
2,4,5,2,2013,12,14041,2908,16949
2,4,5,2,2013,13,13856,2906,16762
2,4,5,2,2013,14,13689,2798,16487
2,4,5,2,2013,15,13843,2856,16699
2,4,5,2,2013,16,14120,2848,16968
2,4,5,2,2013,17,13720,2777,16497
2,4,5,2,2013,18,12399,2666,15065
2,4,5,2,2013,19,12266,2576,14842
2,4,5,2,2013,20,12913,2677,15590
2,4,5,2,2013,21,13216,2621,15837
2,4,5,2,2013,22,13143,2544,15687
2,4,5,2,2013,23,13314,2479,15793
2,4,5,2,2013,24,13402,2448,15850
2,5,5,2,2013,1,13531,2344,15875
2,5,5,2,2013,2,13370,2173,15543
2,5,5,2,2013,3,13045,2031,15076
2,5,5,2,2013,4,12828,1926,14754
2,5,5,2,2013,5,12927,1883,14810
2,5,5,2,2013,6,13060,1888,14948
2,5,5,2,2013,7,13151,1819,14970
2,5,5,2,2013,8,13381,1789,15170
2,5,5,2,2013,9,13604,1858,15462
2,5,5,2,2013,10,13758,1970,15728
2,5,5,2,2013,11,13960,2085,16045
2,5,5,2,2013,12,14134,2163,16297
2,5,5,2,2013,13,14119,2186,16305
2,5,5,2,2013,14,13895,2178,16073
2,5,5,2,2013,15,13976,2191,16167
2,5,5,2,2013,16,14180,2203,16383
2,5,5,2,2013,17,13695,2198,15893
2,5,5,2,2013,18,12274,2158,14432
2,5,5,2,2013,19,12068,2065,14133
2,5,5,2,2013,20,12879,2229,15108
2,5,5,2,2013,21,13043,2340,15383
2,5,5,2,2013,22,12860,2366,15226
2,5,5,2,2013,23,13148,2393,15541
2,5,5,2,2013,24,13103,2413,15516
1,6,5,2,2013,1,13446,2324,15770
1,6,5,2,2013,2,13291,2130,15421
1,6,5,2,2013,3,12998,1988,14986
1,6,5,2,2013,4,12615,1892,14507
1,6,5,2,2013,5,12501,1843,14344
1,6,5,2,2013,6,12793,1855,14648
1,6,5,2,2013,7,12896,1860,14756
1,6,5,2,2013,8,13104,1963,15067
1,6,5,2,2013,9,13394,2269,15663
1,6,5,2,2013,10,14061,2648,16709
1,6,5,2,2013,11,14471,2928,17399
1,6,5,2,2013,12,14356,3003,17359
1,6,5,2,2013,13,14042,3017,17059
1,6,5,2,2013,14,13906,2894,16800
1,6,5,2,2013,15,14003,2956,16959
1,6,5,2,2013,16,14340,2979,17319
1,6,5,2,2013,17,13953,2949,16902
1,6,5,2,2013,18,12611,2820,15431
1,6,5,2,2013,19,12333,2643,14976
1,6,5,2,2013,20,13124,2731,15855
1,6,5,2,2013,21,13506,2593,16099
1,6,5,2,2013,22,12927,2531,15458
1,6,5,2,2013,23,13471,2481,15952
1,6,5,2,2013,24,13477,2420,15897
1,7,5,2,2013,1,13562,2324,15886
1,7,5,2,2013,2,13393,2141,15534
1,7,5,2,2013,3,13324,2013,15337
1,7,5,2,2013,4,13003,1926,14929
1,7,5,2,2013,5,12935,1893,14828
1,7,5,2,2013,6,13270,1925,15195
1,7,5,2,2013,7,13358,1904,15262
1,7,5,2,2013,8,13373,2000,15373
1,7,5,2,2013,9,13595,2310,15905
1,7,5,2,2013,10,14177,2662,16839
1,7,5,2,2013,11,14594,2923,17517
1,7,5,2,2013,12,14453,2994,17447
1,7,5,2,2013,13,14311,2966,17277
1,7,5,2,2013,14,13951,2955,16906
1,7,5,2,2013,15,14516,2988,17504
1,7,5,2,2013,16,14552,2989,17541
1,7,5,2,2013,17,14006,2986,16992
1,7,5,2,2013,18,12786,2889,15675
1,7,5,2,2013,19,12125,2713,14838
1,7,5,2,2013,20,13242,2765,16007
1,7,5,2,2013,21,13342,2605,15947
1,7,5,2,2013,22,13383,2528,15911
1,7,5,2,2013,23,13663,2498,16161
1,7,5,2,2013,24,13643,2451,16094
1,9,5,2,2013,1,13723,2347,16070
1,9,5,2,2013,2,13429,2148,15577
1,9,5,2,2013,3,13343,2002,15345
1,9,5,2,2013,4,13058,1899,14957
1,9,5,2,2013,5,13138,1865,15003
1,9,5,2,2013,6,13357,1881,15238
1,9,5,2,2013,7,13240,1884,15124
1,9,5,2,2013,8,13408,1982,15390
1,9,5,2,2013,9,13515,2296,15811
1,9,5,2,2013,10,14095,2656,16751
1,9,5,2,2013,11,14481,2912,17393
1,9,5,2,2013,12,14332,2950,17282
1,9,5,2,2013,13,14188,2982,17170
1,9,5,2,2013,14,13953,2925,16878
1,9,5,2,2013,15,14272,2966,17238
1,9,5,2,2013,16,14451,2988,17439
1,9,5,2,2013,17,14174,2965,17139
1,9,5,2,2013,18,12746,2871,15617
1,9,5,2,2013,19,12397,2628,15025
1,9,5,2,2013,20,13095,2683,15778
1,9,5,2,2013,21,13339,2648,15987
1,9,5,2,2013,22,13296,2571,15867
1,9,5,2,2013,23,13840,2494,16334
1,9,5,2,2013,24,13810,2395,16205
1,10,5,2,2013,1,13778,2345,16123
1,10,5,2,2013,2,13578,2135,15713
1,10,5,2,2013,3,13405,2001,15406
1,10,5,2,2013,4,13139,1911,15050
1,10,5,2,2013,5,13192,1858,15050
1,10,5,2,2013,6,13574,1904,15478
1,10,5,2,2013,7,13506,1873,15379
1,10,5,2,2013,8,13357,1989,15346
1,10,5,2,2013,9,13585,2280,15865
1,10,5,2,2013,10,13954,2640,16594
1,10,5,2,2013,11,14007,2897,16904
1,10,5,2,2013,12,13627,2976,16603
1,10,5,2,2013,13,13472,2980,16452
1,10,5,2,2013,14,13422,2865,16287
1,10,5,2,2013,15,13450,2924,16374
1,10,5,2,2013,16,13779,2976,16755
1,10,5,2,2013,17,13336,2935,16271
1,10,5,2,2013,18,12202,2856,15058
1,10,5,2,2013,19,12040,2638,14678
1,10,5,2,2013,20,12904,2681,15585
1,10,5,2,2013,21,13190,2608,15798
1,10,5,2,2013,22,13022,2518,15540
1,10,5,2,2013,23,13542,2468,16010
1,10,5,2,2013,24,13609,2449,16058
2,11,5,2,2013,1,13579,2343,15922
2,11,5,2,2013,2,13450,2148,15598
2,11,5,2,2013,3,13182,2022,15204
2,11,5,2,2013,4,13000,1927,14927
2,11,5,2,2013,5,12889,1880,14769
2,11,5,2,2013,6,13266,1900,15166
2,11,5,2,2013,7,13190,1860,15050
2,11,5,2,2013,8,13537,1918,15455
2,11,5,2,2013,9,13562,2099,15661
2,11,5,2,2013,10,14137,2378,16515
2,11,5,2,2013,11,14432,2586,17018
2,11,5,2,2013,12,14354,2727,17081
2,11,5,2,2013,13,14161,2751,16912
2,11,5,2,2013,14,13918,2665,16583
2,11,5,2,2013,15,13988,2693,16681
2,11,5,2,2013,16,14163,2695,16858
2,11,5,2,2013,17,13732,2650,16382
2,11,5,2,2013,18,12416,2517,14933
2,11,5,2,2013,19,12285,2447,14732
2,11,5,2,2013,20,12707,2545,15252
2,11,5,2,2013,21,13086,2500,15586
2,11,5,2,2013,22,13113,2466,15579
2,11,5,2,2013,23,13569,2428,15997
2,11,5,2,2013,24,13493,2351,15844
2,12,5,2,2013,1,13822,2319,16141
2,12,5,2,2013,2,13631,2143,15774
2,12,5,2,2013,3,13452,2006,15458
2,12,5,2,2013,4,13062,1922,14984
2,12,5,2,2013,5,12854,1878,14732
2,12,5,2,2013,6,13297,1891,15188
2,12,5,2,2013,7,13125,1825,14950
2,12,5,2,2013,8,12978,1803,14781
2,12,5,2,2013,9,13278,1857,15135
2,12,5,2,2013,10,13639,1944,15583
2,12,5,2,2013,11,14096,2056,16152
2,12,5,2,2013,12,13782,2099,15881
2,12,5,2,2013,13,13863,2112,15975
2,12,5,2,2013,14,13545,2097,15642
2,12,5,2,2013,15,13380,2137,15517
2,12,5,2,2013,16,13764,2155,15919
2,12,5,2,2013,17,13145,2130,15275
2,12,5,2,2013,18,12354,2088,14442
2,12,5,2,2013,19,11822,2050,13872
2,12,5,2,2013,20,12820,2250,15070
2,12,5,2,2013,21,12617,2306,14923
2,12,5,2,2013,22,12662,2315,14977
2,12,5,2,2013,23,13177,2330,15507
2,12,5,2,2013,24,13175,2362,15537
1,13,5,2,2013,1,13402,2269,15671
1,13,5,2,2013,2,13134,2090,15224
1,13,5,2,2013,3,12928,1952,14880
1,13,5,2,2013,4,12626,1869,14495
1,13,5,2,2013,5,12821,1834,14655
1,13,5,2,2013,6,12837,1843,14680
1,13,5,2,2013,7,12715,1853,14568
1,13,5,2,2013,8,13226,1956,15182
1,13,5,2,2013,9,13114,2261,15375
1,13,5,2,2013,10,13978,2632,16610
1,13,5,2,2013,11,14470,2906,17376
1,13,5,2,2013,12,14370,3007,17377
1,13,5,2,2013,13,14024,3014,17038
1,13,5,2,2013,14,13930,2934,16864
1,13,5,2,2013,15,14040,2982,17022
1,13,5,2,2013,16,14359,2995,17354
1,13,5,2,2013,17,13642,2950,16592
1,13,5,2,2013,18,12234,2843,15077
1,13,5,2,2013,19,12003,2685,14688
1,13,5,2,2013,20,12987,2685,15672
1,13,5,2,2013,21,13120,2621,15741
1,13,5,2,2013,22,12892,2560,15452
1,13,5,2,2013,23,13373,2498,15871
1,13,5,2,2013,24,13617,2429,16046
1,14,5,2,2013,1,13536,2364,15900
1,14,5,2,2013,2,13252,2158,15410
1,14,5,2,2013,3,12933,2014,14947
1,14,5,2,2013,4,12774,1914,14688
1,14,5,2,2013,5,12800,1880,14680
1,14,5,2,2013,6,13118,1881,14999
1,14,5,2,2013,7,13175,1869,15044
1,14,5,2,2013,8,13199,1979,15178
1,14,5,2,2013,9,13281,2267,15548
1,14,5,2,2013,10,13759,2638,16397
1,14,5,2,2013,11,14488,2904,17392
1,14,5,2,2013,12,14446,2973,17419
1,14,5,2,2013,13,14087,2978,17065
1,14,5,2,2013,14,13869,2917,16786
1,14,5,2,2013,15,14108,2971,17079
1,14,5,2,2013,16,14455,2976,17431
1,14,5,2,2013,17,13783,2973,16756
1,14,5,2,2013,18,12524,2863,15387
1,14,5,2,2013,19,12236,2702,14938
1,14,5,2,2013,20,12923,2713,15636
1,14,5,2,2013,21,13410,2620,16030
1,14,5,2,2013,22,12902,2522,15424
1,14,5,2,2013,23,13481,2491,15972
1,14,5,2,2013,24,13585,2482,16067
1,15,5,2,2013,1,13404,2317,15721
1,15,5,2,2013,2,13250,2130,15380
1,15,5,2,2013,3,12834,1988,14822
1,15,5,2,2013,4,12882,1901,14783
1,15,5,2,2013,5,12820,1861,14681
1,15,5,2,2013,6,13061,1891,14952
1,15,5,2,2013,7,12806,1864,14670
1,15,5,2,2013,8,13153,1967,15120
1,15,5,2,2013,9,13309,2262,15571
1,15,5,2,2013,10,13864,2639,16503
1,15,5,2,2013,11,14270,2926,17196
1,15,5,2,2013,12,14387,3040,17427
1,15,5,2,2013,13,14078,3026,17104
1,15,5,2,2013,14,13935,2959,16894
1,15,5,2,2013,15,13893,3012,16905
1,15,5,2,2013,16,14088,3028,17116
1,15,5,2,2013,17,13384,2988,16372
1,15,5,2,2013,18,12479,2858,15337
1,15,5,2,2013,19,11866,2662,14528
1,15,5,2,2013,20,12654,2732,15386
1,15,5,2,2013,21,12765,2658,15423
1,15,5,2,2013,22,12939,2498,15437
1,15,5,2,2013,23,13380,2471,15851
1,15,5,2,2013,24,13253,2470,15723
1,16,5,2,2013,1,13242,2305,15547
1,16,5,2,2013,2,13213,2111,15324
1,16,5,2,2013,3,12957,1983,14940
1,16,5,2,2013,4,12796,1941,14737
1,16,5,2,2013,5,12813,1921,14734
1,16,5,2,2013,6,12995,1939,14934
1,16,5,2,2013,7,13095,1970,15065
1,16,5,2,2013,8,13076,2099,15175
1,16,5,2,2013,9,13147,2310,15457
1,16,5,2,2013,10,13732,2596,16328
1,16,5,2,2013,11,14063,2872,16935
1,16,5,2,2013,12,14063,2961,17024
1,16,5,2,2013,13,13957,2967,16924
1,16,5,2,2013,14,13659,2867,16526
1,16,5,2,2013,15,13936,2937,16873
1,16,5,2,2013,16,13963,2947,16910
1,16,5,2,2013,17,13498,2911,16409
1,16,5,2,2013,18,12367,2801,15168
1,16,5,2,2013,19,12011,2650,14661
1,16,5,2,2013,20,12813,2670,15483
1,16,5,2,2013,21,13219,2595,15814
1,16,5,2,2013,22,13144,2546,15690
1,16,5,2,2013,23,13345,2477,15822
1,16,5,2,2013,24,13411,2449,15860
1,17,5,2,2013,1,13448,2335,15783
1,17,5,2,2013,2,13297,2115,15412
1,17,5,2,2013,3,13034,1989,15023
1,17,5,2,2013,4,12873,1927,14800
1,17,5,2,2013,5,12965,1869,14834
1,17,5,2,2013,6,13203,1909,15112
1,17,5,2,2013,7,13246,1897,15143
1,17,5,2,2013,8,13276,1997,15273
1,17,5,2,2013,9,13285,2244,15529
1,17,5,2,2013,10,13600,2566,16166
1,17,5,2,2013,11,13754,2886,16640
1,17,5,2,2013,12,13518,2973,16491
1,17,5,2,2013,13,13636,2976,16612
1,17,5,2,2013,14,13088,2866,15954
1,17,5,2,2013,15,13252,2917,16169
1,17,5,2,2013,16,13748,2941,16689
1,17,5,2,2013,17,13458,2922,16380
1,17,5,2,2013,18,12577,2830,15407
1,17,5,2,2013,19,11966,2662,14628
1,17,5,2,2013,20,12850,2654,15504
1,17,5,2,2013,21,13057,2623,15680
1,17,5,2,2013,22,12984,2528,15512
1,17,5,2,2013,23,13289,2466,15755
1,17,5,2,2013,24,13459,2381,15840
2,18,5,2,2013,1,13386,2349,15735
2,18,5,2,2013,2,13153,2146,15299
2,18,5,2,2013,3,12990,2007,14997
2,18,5,2,2013,4,12863,1933,14796
2,18,5,2,2013,5,12960,1868,14828
2,18,5,2,2013,6,13122,1886,15008
2,18,5,2,2013,7,13005,1837,14842
2,18,5,2,2013,8,13045,1896,14941
2,18,5,2,2013,9,13212,2075,15287
2,18,5,2,2013,10,13952,2409,16361
2,18,5,2,2013,11,14269,2689,16958
2,18,5,2,2013,12,14039,2783,16822
2,18,5,2,2013,13,13725,2781,16506
2,18,5,2,2013,14,13569,2697,16266
2,18,5,2,2013,15,13793,2735,16528
2,18,5,2,2013,16,14040,2740,16780
2,18,5,2,2013,17,13775,2693,16468
2,18,5,2,2013,18,12555,2580,15135
2,18,5,2,2013,19,12580,2470,15050
2,18,5,2,2013,20,13325,2549,15874
2,18,5,2,2013,21,13148,2549,15697
2,18,5,2,2013,22,12972,2504,15476
2,18,5,2,2013,23,13117,2419,15536
2,18,5,2,2013,24,13427,2369,15796
2,19,5,2,2013,1,13715,2299,16014
2,19,5,2,2013,2,13350,2148,15498
2,19,5,2,2013,3,13119,2020,15139
2,19,5,2,2013,4,12986,1922,14908
2,19,5,2,2013,5,13008,1873,14881
2,19,5,2,2013,6,13267,1891,15158
2,19,5,2,2013,7,13308,1817,15125
2,19,5,2,2013,8,13365,1793,15158
2,19,5,2,2013,9,13755,1835,15590
2,19,5,2,2013,10,13910,1928,15838
2,19,5,2,2013,11,14180,2025,16205
2,19,5,2,2013,12,14144,2093,16237
2,19,5,2,2013,13,13879,2080,15959
2,19,5,2,2013,14,13569,2065,15634
2,19,5,2,2013,15,13750,2092,15842
2,19,5,2,2013,16,13952,2107,16059
2,19,5,2,2013,17,13630,2075,15705
2,19,5,2,2013,18,12666,2039,14705
2,19,5,2,2013,19,12342,2028,14370
2,19,5,2,2013,20,13031,2203,15234
2,19,5,2,2013,21,12826,2307,15133
2,19,5,2,2013,22,12737,2332,15069
2,19,5,2,2013,23,12969,2354,15323
2,19,5,2,2013,24,13494,2373,15867
1,20,5,2,2013,1,13530,2295,15825
1,20,5,2,2013,2,13330,2121,15451
1,20,5,2,2013,3,13180,1992,15172
1,20,5,2,2013,4,12947,1899,14846
1,20,5,2,2013,5,13000,1848,14848
1,20,5,2,2013,6,13426,1868,15294
1,20,5,2,2013,7,13660,1858,15518
1,20,5,2,2013,8,13707,1983,15690
1,20,5,2,2013,9,13708,2285,15993
1,20,5,2,2013,10,14396,2658,17054
1,20,5,2,2013,11,14628,2931,17559
1,20,5,2,2013,12,14694,3031,17725
1,20,5,2,2013,13,14411,3065,17476
1,20,5,2,2013,14,14068,2994,17062
1,20,5,2,2013,15,14351,3068,17419
1,20,5,2,2013,16,14096,3086,17182
1,20,5,2,2013,17,13807,3033,16840
1,20,5,2,2013,18,12551,2905,15456
1,20,5,2,2013,19,11913,2707,14620
1,20,5,2,2013,20,12977,2768,15745
1,20,5,2,2013,21,13431,2682,16113
1,20,5,2,2013,22,13181,2604,15785
1,20,5,2,2013,23,13308,2523,15831
1,20,5,2,2013,24,13357,2547,15904
1,21,5,2,2013,1,13359,2398,15757
1,21,5,2,2013,2,13099,2173,15272
1,21,5,2,2013,3,12896,2040,14936
1,21,5,2,2013,4,12769,1949,14718
1,21,5,2,2013,5,12709,1895,14604
1,21,5,2,2013,6,13036,1930,14966
1,21,5,2,2013,7,13035,1903,14938
1,21,5,2,2013,8,13119,2002,15121
1,21,5,2,2013,9,13353,2292,15645
1,21,5,2,2013,10,13363,2665,16028
1,21,5,2,2013,11,13470,2975,16445
1,21,5,2,2013,12,13513,3021,16534
1,21,5,2,2013,13,13437,3021,16458
1,21,5,2,2013,14,13329,2961,16290
1,21,5,2,2013,15,13584,3020,16604
1,21,5,2,2013,16,13947,3021,16968
1,21,5,2,2013,17,13423,2993,16416
1,21,5,2,2013,18,12275,2882,15157
1,21,5,2,2013,19,11884,2736,14620
1,21,5,2,2013,20,13130,2737,15867
1,21,5,2,2013,21,13369,2695,16064
1,21,5,2,2013,22,13123,2582,15705
1,21,5,2,2013,23,13565,2507,16072
1,21,5,2,2013,24,13523,2559,16082
1,22,5,2,2013,1,13481,2389,15870
1,22,5,2,2013,2,13412,2185,15597
1,22,5,2,2013,3,13163,2052,15215
1,22,5,2,2013,4,12896,1987,14883
1,22,5,2,2013,5,12889,1952,14841
1,22,5,2,2013,6,13111,1988,15099
1,22,5,2,2013,7,13246,1978,15224
1,22,5,2,2013,8,12973,2050,15023
1,22,5,2,2013,9,13321,2310,15631
1,22,5,2,2013,10,13754,2614,16368
1,22,5,2,2013,11,14157,2865,17022
1,22,5,2,2013,12,14028,3018,17046
1,22,5,2,2013,13,13983,3066,17049
1,22,5,2,2013,14,13651,3004,16655
1,22,5,2,2013,15,13945,3036,16981
1,22,5,2,2013,16,14226,3045,17271
1,22,5,2,2013,17,13693,3002,16695
1,22,5,2,2013,18,12746,2894,15640
1,22,5,2,2013,19,12310,2727,15037
1,22,5,2,2013,20,13171,2714,15885
1,22,5,2,2013,21,13335,2688,16023
1,22,5,2,2013,22,13219,2628,15847
1,22,5,2,2013,23,13428,2490,15918
1,22,5,2,2013,24,13577,2542,16119
1,23,5,2,2013,1,13628,2422,16050
1,23,5,2,2013,2,13346,2215,15561
1,23,5,2,2013,3,13017,2074,15091
1,23,5,2,2013,4,12904,1986,14890
1,23,5,2,2013,5,12857,1928,14785
1,23,5,2,2013,6,12915,1936,14851
1,23,5,2,2013,7,13019,1909,14928
1,23,5,2,2013,8,13060,2010,15070
1,23,5,2,2013,9,13175,2301,15476
1,23,5,2,2013,10,13486,2664,16150
1,23,5,2,2013,11,13776,2948,16724
1,23,5,2,2013,12,13741,3027,16768
1,23,5,2,2013,13,13214,3062,16276
1,23,5,2,2013,14,13186,2984,16170
1,23,5,2,2013,15,13102,3040,16142
1,23,5,2,2013,16,13315,3090,16405
1,23,5,2,2013,17,13216,3034,16250
1,23,5,2,2013,18,11942,2906,14848
1,23,5,2,2013,19,11806,2694,14500
1,23,5,2,2013,20,12880,2752,15632
1,23,5,2,2013,21,13291,2663,15954
1,23,5,2,2013,22,13012,2571,15583
1,23,5,2,2013,23,13042,2549,15591
1,23,5,2,2013,24,13424,2556,15980
1,24,5,2,2013,1,13449,2442,15891
1,24,5,2,2013,2,13214,2249,15463
1,24,5,2,2013,3,12926,2112,15038
1,24,5,2,2013,4,12974,2004,14978
1,24,5,2,2013,5,12919,1954,14873
1,24,5,2,2013,6,13153,1970,15123
1,24,5,2,2013,7,13030,1939,14969
1,24,5,2,2013,8,12756,2067,14823
1,24,5,2,2013,9,12955,2346,15301
1,24,5,2,2013,10,13099,2683,15782
1,24,5,2,2013,11,13203,2937,16140
1,24,5,2,2013,12,13203,3035,16238
1,24,5,2,2013,13,12944,3078,16022
1,24,5,2,2013,14,12743,3007,15750
1,24,5,2,2013,15,12814,3089,15903
1,24,5,2,2013,16,12855,3092,15947
1,24,5,2,2013,17,12827,3071,15898
1,24,5,2,2013,18,11891,2962,14853
1,24,5,2,2013,19,11515,2796,14311
1,24,5,2,2013,20,12700,2799,15499
1,24,5,2,2013,21,13130,2723,15853
1,24,5,2,2013,22,12940,2628,15568
1,24,5,2,2013,23,13171,2574,15745
1,24,5,2,2013,24,13292,2576,15868
3,25,5,2,2013,1,13267,2494,15761
3,25,5,2,2013,2,13063,2317,15380
3,25,5,2,2013,3,12914,2158,15072
3,25,5,2,2013,4,12930,2044,14974
3,25,5,2,2013,5,12796,1988,14784
3,25,5,2,2013,6,12778,2005,14783
3,25,5,2,2013,7,12849,1946,14795
3,25,5,2,2013,8,12912,1971,14883
3,25,5,2,2013,9,13069,2102,15171
3,25,5,2,2013,10,13246,2373,15619
3,25,5,2,2013,11,13534,2665,16199
3,25,5,2,2013,12,13542,2808,16350
3,25,5,2,2013,13,13366,2821,16187
3,25,5,2,2013,14,13250,2754,16004
3,25,5,2,2013,15,13273,2795,16068
3,25,5,2,2013,16,13665,2803,16468
3,25,5,2,2013,17,13158,2748,15906
3,25,5,2,2013,18,12241,2639,14880
3,25,5,2,2013,19,12063,2542,14605
3,25,5,2,2013,20,12918,2605,15523
3,25,5,2,2013,21,12925,2624,15549
3,25,5,2,2013,22,12936,2581,15517
3,25,5,2,2013,23,12939,2527,15466
3,25,5,2,2013,24,13242,2442,15684
2,26,5,2,2013,1,13604,2435,16039
2,26,5,2,2013,2,13210,2254,15464
2,26,5,2,2013,3,13470,2123,15593
2,26,5,2,2013,4,12920,2029,14949
2,26,5,2,2013,5,12882,1974,14856
2,26,5,2,2013,6,12772,1994,14766
2,26,5,2,2013,7,12445,1921,14366
2,26,5,2,2013,8,12466,1896,14362
2,26,5,2,2013,9,12478,1941,14419
2,26,5,2,2013,10,12797,2030,14827
2,26,5,2,2013,11,13234,2132,15366
2,26,5,2,2013,12,13418,2183,15601
2,26,5,2,2013,13,13400,2192,15592
2,26,5,2,2013,14,13202,2195,15397
2,26,5,2,2013,15,13420,2231,15651
2,26,5,2,2013,16,13569,2242,15811
2,26,5,2,2013,17,13179,2205,15384
2,26,5,2,2013,18,11885,2141,14026
2,26,5,2,2013,19,11878,2107,13985
2,26,5,2,2013,20,12826,2296,15122
2,26,5,2,2013,21,12968,2422,15390
2,26,5,2,2013,22,12711,2455,15166
2,26,5,2,2013,23,13053,2457,15510
2,26,5,2,2013,24,13132,2492,15624
1,27,5,2,2013,1,13391,2438,15829
1,27,5,2,2013,2,12868,2284,15152
1,27,5,2,2013,3,12605,2142,14747
1,27,5,2,2013,4,12426,2041,14467
1,27,5,2,2013,5,12496,1994,14490
1,27,5,2,2013,6,12539,1993,14532
1,27,5,2,2013,7,12597,1961,14558
1,27,5,2,2013,8,12659,2067,14726
1,27,5,2,2013,9,13115,2343,15458
1,27,5,2,2013,10,13491,2742,16233
1,27,5,2,2013,11,13589,3054,16643
1,27,5,2,2013,12,13710,3142,16852
1,27,5,2,2013,13,13689,3185,16874
1,27,5,2,2013,14,13564,3120,16684
1,27,5,2,2013,15,13756,3179,16935
1,27,5,2,2013,16,14000,3192,17192
1,27,5,2,2013,17,13518,3153,16671
1,27,5,2,2013,18,12397,3005,15402
1,27,5,2,2013,19,12197,2794,14991
1,27,5,2,2013,20,12857,2807,15664
1,27,5,2,2013,21,13323,2722,16045
1,27,5,2,2013,22,12809,2653,15462
1,27,5,2,2013,23,13002,2627,15629
1,27,5,2,2013,24,13178,2671,15849
1,28,5,2,2013,1,13071,2536,15607
1,28,5,2,2013,2,12762,2341,15103
1,28,5,2,2013,3,12562,2194,14756
1,28,5,2,2013,4,12193,2099,14292
1,28,5,2,2013,5,12136,2027,14163
1,28,5,2,2013,6,12788,2020,14808
1,28,5,2,2013,7,12845,1985,14830
1,28,5,2,2013,8,12795,2077,14872
1,28,5,2,2013,9,12899,2382,15281
1,28,5,2,2013,10,13475,2756,16231
1,28,5,2,2013,11,13918,3049,16967
1,28,5,2,2013,12,13947,3158,17105
1,28,5,2,2013,13,13709,3191,16900
1,28,5,2,2013,14,13558,3122,16680
1,28,5,2,2013,15,13850,3208,17058
1,28,5,2,2013,16,13929,3217,17146
1,28,5,2,2013,17,13471,3182,16653
1,28,5,2,2013,18,12171,3060,15231
1,28,5,2,2013,19,11670,2851,14521
1,28,5,2,2013,20,12743,2890,15633
1,28,5,2,2013,21,12976,2802,15778
1,28,5,2,2013,22,12723,2690,15413
1,28,5,2,2013,23,13060,2642,15702
1,28,5,2,2013,24,12936,2700,15636
1,29,5,2,2013,1,12951,2590,15541
1,29,5,2,2013,2,12567,2378,14945
1,29,5,2,2013,3,12240,2205,14445
1,29,5,2,2013,4,12084,2089,14173
1,29,5,2,2013,5,12075,2030,14105
1,29,5,2,2013,6,12600,2024,14624
1,29,5,2,2013,7,12255,1975,14230
1,29,5,2,2013,8,12314,2078,14392
1,29,5,2,2013,9,12647,2376,15023
1,29,5,2,2013,10,12874,2760,15634
1,29,5,2,2013,11,13345,3125,16470
1,29,5,2,2013,12,13403,3184,16587
1,29,5,2,2013,13,13341,3199,16540
1,29,5,2,2013,14,13717,3143,16860
1,29,5,2,2013,15,13560,3208,16768
1,29,5,2,2013,16,13665,3211,16876
1,29,5,2,2013,17,13271,3174,16445
1,29,5,2,2013,18,12371,3040,15411
1,29,5,2,2013,19,11549,2802,14351
1,29,5,2,2013,20,12856,2791,15647
1,29,5,2,2013,21,13195,2738,15933
1,29,5,2,2013,22,12855,2653,15508
1,29,5,2,2013,23,12859,2649,15508
1,29,5,2,2013,24,13012,2673,15685
1,30,5,2,2013,1,13125,2558,15683
1,30,5,2,2013,2,12963,2354,15317
1,30,5,2,2013,3,12977,2207,15184
1,30,5,2,2013,4,12510,2074,14584
1,30,5,2,2013,5,12608,2019,14627
1,30,5,2,2013,6,12776,2025,14801
1,30,5,2,2013,7,12705,1977,14682
1,30,5,2,2013,8,12814,2086,14900
1,30,5,2,2013,9,13189,2357,15546
1,30,5,2,2013,10,13261,2745,16006
1,30,5,2,2013,11,13505,3023,16528
1,30,5,2,2013,12,13285,3114,16399
1,30,5,2,2013,13,13238,3146,16384
1,30,5,2,2013,14,13002,3065,16067
1,30,5,2,2013,15,13434,3143,16577
1,30,5,2,2013,16,13468,3176,16644
1,30,5,2,2013,17,12950,3139,16089
1,30,5,2,2013,18,12294,2996,15290
1,30,5,2,2013,19,11187,2736,13923
1,30,5,2,2013,20,12693,2807,15500
1,30,5,2,2013,21,13002,2693,15695
1,30,5,2,2013,22,12810,2614,15424
1,30,5,2,2013,23,12931,2615,15546
1,30,5,2,2013,24,12936,2627,15563
1,31,5,2,2013,1,13070,2554,15624
1,31,5,2,2013,2,12776,2342,15118
1,31,5,2,2013,3,12513,2186,14699
1,31,5,2,2013,4,12346,2071,14417
1,31,5,2,2013,5,12455,2009,14464
1,31,5,2,2013,6,12774,2016,14790
1,31,5,2,2013,7,12830,1973,14803
1,31,5,2,2013,8,12921,2086,15007
1,31,5,2,2013,9,12973,2379,15352
1,31,5,2,2013,10,12983,2823,15806
1,31,5,2,2013,11,13344,3047,16391
1,31,5,2,2013,12,13019,3143,16162
1,31,5,2,2013,13,12883,3141,16024
1,31,5,2,2013,14,12873,3073,15946
1,31,5,2,2013,15,13131,3142,16273
1,31,5,2,2013,16,13317,3153,16470
1,31,5,2,2013,17,12530,3135,15665
1,31,5,2,2013,18,11498,3021,14519
1,31,5,2,2013,19,11435,2808,14243
1,31,5,2,2013,20,12421,2818,15239
1,31,5,2,2013,21,12738,2805,15543
1,31,5,2,2013,22,12572,2689,15261
1,31,5,2,2013,23,12810,2681,15491
1,31,5,2,2013,24,12692,2675,15367
2,1,6,2,2013,1,12958,2490,15448
2,1,6,2,2013,2,12596,2288,14884
2,1,6,2,2013,3,12425,2136,14561
2,1,6,2,2013,4,12270,2038,14308
2,1,6,2,2013,5,12203,1973,14176
2,1,6,2,2013,6,12610,1972,14582
2,1,6,2,2013,7,12591,1930,14521
2,1,6,2,2013,8,12533,1973,14506
2,1,6,2,2013,9,12831,2180,15011
2,1,6,2,2013,10,13259,2513,15772
2,1,6,2,2013,11,13460,2815,16275
2,1,6,2,2013,12,13612,2955,16567
2,1,6,2,2013,13,13290,2950,16240
2,1,6,2,2013,14,13291,2880,16171
2,1,6,2,2013,15,13374,2924,16298
2,1,6,2,2013,16,13559,2930,16489
2,1,6,2,2013,17,12733,2839,15572
2,1,6,2,2013,18,12081,2707,14788
2,1,6,2,2013,19,11618,2573,14191
2,1,6,2,2013,20,12164,2593,14757
2,1,6,2,2013,21,12717,2620,15337
2,1,6,2,2013,22,12410,2580,14990
2,1,6,2,2013,23,12306,2556,14862
2,1,6,2,2013,24,12350,2504,14854
2,2,6,2,2013,1,12120,2481,14601
2,2,6,2,2013,2,12160,2318,14478
2,2,6,2,2013,3,12060,2195,14255
2,2,6,2,2013,4,12068,2087,14155
2,2,6,2,2013,5,12098,2020,14118
2,2,6,2,2013,6,12417,2024,14441
2,2,6,2,2013,7,12497,1923,14420
2,2,6,2,2013,8,12576,1883,14459
2,2,6,2,2013,9,12871,1924,14795
2,2,6,2,2013,10,12932,2013,14945
2,2,6,2,2013,11,13159,2112,15271
2,2,6,2,2013,12,13089,2157,15246
2,2,6,2,2013,13,13066,2198,15264
2,2,6,2,2013,14,12916,2207,15123
2,2,6,2,2013,15,13008,2249,15257
2,2,6,2,2013,16,13019,2274,15293
2,2,6,2,2013,17,12395,2244,14639
2,2,6,2,2013,18,11626,2173,13799
2,2,6,2,2013,19,10572,2095,12667
2,2,6,2,2013,20,11378,2268,13646
2,2,6,2,2013,21,11212,2311,13523
2,2,6,2,2013,22,11120,2364,13484
2,2,6,2,2013,23,11170,2403,13573
2,2,6,2,2013,24,11350,2444,13794
1,3,6,2,2013,1,11279,2342,13621
1,3,6,2,2013,2,11194,2184,13378
1,3,6,2,2013,3,11220,2038,13258
1,3,6,2,2013,4,10999,1940,12939
1,3,6,2,2013,5,10876,1893,12769
1,3,6,2,2013,6,10943,1918,12861
1,3,6,2,2013,7,11227,1882,13109
1,3,6,2,2013,8,11535,1972,13507
1,3,6,2,2013,9,11783,2267,14050
1,3,6,2,2013,10,12079,2656,14735
1,3,6,2,2013,11,12687,2945,15632
1,3,6,2,2013,12,12675,3054,15729
1,3,6,2,2013,13,12848,3106,15954
1,3,6,2,2013,14,12918,3044,15962
1,3,6,2,2013,15,12870,3111,15981
1,3,6,2,2013,16,12840,3106,15946
1,3,6,2,2013,17,12129,3018,15147
1,3,6,2,2013,18,11392,2913,14305
1,3,6,2,2013,19,11090,2771,13861
1,3,6,2,2013,20,11724,2662,14386
1,3,6,2,2013,21,12118,2592,14710
1,3,6,2,2013,22,11540,2470,14010
1,3,6,2,2013,23,11751,2411,14162
1,3,6,2,2013,24,11760,2389,14149
1,4,6,2,2013,1,11598,2235,13833
1,4,6,2,2013,2,11190,2115,13305
1,4,6,2,2013,3,10897,1995,12892
1,4,6,2,2013,4,10568,1913,12481
1,4,6,2,2013,5,10372,1826,12198
1,4,6,2,2013,6,10721,1867,12588
1,4,6,2,2013,7,10887,1861,12748
1,4,6,2,2013,8,11135,1976,13111
1,4,6,2,2013,9,11200,2323,13523
1,4,6,2,2013,10,12106,2671,14777
1,4,6,2,2013,11,12132,2961,15093
1,4,6,2,2013,12,12372,3054,15426
1,4,6,2,2013,13,12893,3068,15961
1,4,6,2,2013,14,12279,3018,15297
1,4,6,2,2013,15,12654,3070,15724
1,4,6,2,2013,16,12874,3074,15948
1,4,6,2,2013,17,12027,3032,15059
1,4,6,2,2013,18,11600,2905,14505
1,4,6,2,2013,19,11148,2803,13951
1,4,6,2,2013,20,11832,2787,14619
1,4,6,2,2013,21,12367,2573,14940
1,4,6,2,2013,22,12302,2498,14800
1,4,6,2,2013,23,12419,2467,14886
1,4,6,2,2013,24,12239,2411,14650
1,5,6,2,2013,1,12089,2381,14470
1,5,6,2,2013,2,12152,2204,14356
1,5,6,2,2013,3,11671,2075,13746
1,5,6,2,2013,4,11193,1961,13154
1,5,6,2,2013,5,11274,1914,13188
1,5,6,2,2013,6,11447,1943,13390
1,5,6,2,2013,7,11354,1932,13286
1,5,6,2,2013,8,11507,2027,13534
1,5,6,2,2013,9,12054,2332,14386
1,5,6,2,2013,10,12527,2722,15249
1,5,6,2,2013,11,12599,2991,15590
1,5,6,2,2013,12,12585,3081,15666
1,5,6,2,2013,13,12813,3088,15901
1,5,6,2,2013,14,12590,3022,15612
1,5,6,2,2013,15,12786,3083,15869
1,5,6,2,2013,16,13180,3100,16280
1,5,6,2,2013,17,12922,3064,15986
1,5,6,2,2013,18,11855,2963,14818
1,5,6,2,2013,19,11609,2757,14366
1,5,6,2,2013,20,12198,2847,15045
1,5,6,2,2013,21,12609,2759,15368
1,5,6,2,2013,22,12245,2652,14897
1,5,6,2,2013,23,12528,2550,15078
1,5,6,2,2013,24,12085,2510,14595
1,6,6,2,2013,1,11943,2460,14403
1,6,6,2,2013,2,11710,2239,13949
1,6,6,2,2013,3,11619,2106,13725
1,6,6,2,2013,4,11650,2000,13650
1,6,6,2,2013,5,11420,1957,13377
1,6,6,2,2013,6,11506,1981,13487
1,6,6,2,2013,7,11373,1968,13341
1,6,6,2,2013,8,11621,2072,13693
1,6,6,2,2013,9,11703,2395,14098
1,6,6,2,2013,10,12297,2779,15076
1,6,6,2,2013,11,12451,3062,15513
1,6,6,2,2013,12,12350,3147,15497
1,6,6,2,2013,13,12141,3178,15319
1,6,6,2,2013,14,12134,3101,15235
1,6,6,2,2013,15,12141,3181,15322
1,6,6,2,2013,16,12076,3183,15259
1,6,6,2,2013,17,12183,3153,15336
1,6,6,2,2013,18,11599,2977,14576
1,6,6,2,2013,19,11462,2944,14406
1,6,6,2,2013,20,11845,2891,14736
1,6,6,2,2013,21,11891,2770,14661
1,6,6,2,2013,22,11571,2687,14258
1,6,6,2,2013,23,11646,2681,14327
1,6,6,2,2013,24,11386,2680,14066
1,7,6,2,2013,1,11165,2479,13644
1,7,6,2,2013,2,10977,2300,13277
1,7,6,2,2013,3,10801,2173,12974
1,7,6,2,2013,4,10817,2084,12901
1,7,6,2,2013,5,10825,2018,12843
1,7,6,2,2013,6,10761,2028,12789
1,7,6,2,2013,7,11135,2018,13153
1,7,6,2,2013,8,11214,2115,13329
1,7,6,2,2013,9,11186,2404,13590
1,7,6,2,2013,10,11224,2748,13972
1,7,6,2,2013,11,11444,3007,14451
1,7,6,2,2013,12,11245,3123,14368
1,7,6,2,2013,13,11175,3109,14284
1,7,6,2,2013,14,10920,2978,13898
1,7,6,2,2013,15,11182,2984,14166
1,7,6,2,2013,16,11379,2990,14369
1,7,6,2,2013,17,11301,2950,14251
1,7,6,2,2013,18,10876,2879,13755
1,7,6,2,2013,19,10716,2767,13483
1,7,6,2,2013,20,11959,2751,14710
1,7,6,2,2013,21,11706,2655,14361
1,7,6,2,2013,22,11599,2482,14081
1,7,6,2,2013,23,11589,2310,13899
1,7,6,2,2013,24,11486,2239,13725
2,8,6,2,2013,1,11570,2087,13657
2,8,6,2,2013,2,11506,1953,13459
2,8,6,2,2013,3,11332,1850,13182
2,8,6,2,2013,4,11061,1785,12846
2,8,6,2,2013,5,11111,1757,12868
2,8,6,2,2013,6,11573,1785,13358
2,8,6,2,2013,7,11581,1800,13381
2,8,6,2,2013,8,11910,1859,13769
2,8,6,2,2013,9,11875,2068,13943
2,8,6,2,2013,10,12176,2387,14563
2,8,6,2,2013,11,12126,2654,14780
2,8,6,2,2013,12,12250,2722,14972
2,8,6,2,2013,13,11944,2783,14727
2,8,6,2,2013,14,11940,2651,14591
2,8,6,2,2013,15,12093,2640,14733
2,8,6,2,2013,16,12223,2601,14824
2,8,6,2,2013,17,11766,2585,14351
2,8,6,2,2013,18,11249,2525,13774
2,8,6,2,2013,19,11528,2422,13950
2,8,6,2,2013,20,11772,2528,14300
2,8,6,2,2013,21,11800,2507,14307
2,8,6,2,2013,22,11690,2393,14083
2,8,6,2,2013,23,11457,2288,13745
2,8,6,2,2013,24,11152,2200,13352
2,9,6,2,2013,1,11094,2076,13170
2,9,6,2,2013,2,10801,1904,12705
2,9,6,2,2013,3,10859,1785,12644
2,9,6,2,2013,4,10479,1653,12132
2,9,6,2,2013,5,10695,1644,12339
2,9,6,2,2013,6,10695,1719,12414
2,9,6,2,2013,7,10933,1668,12601
2,9,6,2,2013,8,10939,1624,12563
2,9,6,2,2013,9,11365,1743,13108
2,9,6,2,2013,10,11307,1908,13215
2,9,6,2,2013,11,11297,1998,13295
2,9,6,2,2013,12,11063,2039,13102
2,9,6,2,2013,13,11101,1984,13085
2,9,6,2,2013,14,10761,1979,12740
2,9,6,2,2013,15,10826,1927,12753
2,9,6,2,2013,16,10686,1878,12564
2,9,6,2,2013,17,10189,1938,12127
2,9,6,2,2013,18,9892,1947,11839
2,9,6,2,2013,19,10097,1957,12054
2,9,6,2,2013,20,11373,2142,13515
2,9,6,2,2013,21,11122,2212,13334
2,9,6,2,2013,22,11024,2099,13123
2,9,6,2,2013,23,10940,2080,13020
2,9,6,2,2013,24,10622,2021,12643
1,10,6,2,2013,1,10622,1853,12475
1,10,6,2,2013,2,10365,1745,12110
1,10,6,2,2013,3,10284,1676,11960
1,10,6,2,2013,4,10098,1639,11737
1,10,6,2,2013,5,10240,1631,11871
1,10,6,2,2013,6,10387,1651,12038
1,10,6,2,2013,7,10285,1729,12014
1,10,6,2,2013,8,10464,1856,12320
1,10,6,2,2013,9,10802,2057,12859
1,10,6,2,2013,10,11025,2320,13345
1,10,6,2,2013,11,11309,2514,13823
1,10,6,2,2013,12,11210,2682,13892
1,10,6,2,2013,13,10950,2682,13632
1,10,6,2,2013,14,11055,2625,13680
1,10,6,2,2013,15,11056,2628,13684
1,10,6,2,2013,16,11132,2612,13744
1,10,6,2,2013,17,11319,2582,13901
1,10,6,2,2013,18,10727,2547,13274
1,10,6,2,2013,19,10877,2471,13348
1,10,6,2,2013,20,11986,2493,14479
1,10,6,2,2013,21,11807,2432,14239
1,10,6,2,2013,22,11648,2314,13962
1,10,6,2,2013,23,11610,2177,13787
1,10,6,2,2013,24,11058,2041,13099
1,11,6,2,2013,1,11109,1833,12942
1,11,6,2,2013,2,10763,1688,12451
1,11,6,2,2013,3,10617,1616,12233
1,11,6,2,2013,4,10476,1558,12034
1,11,6,2,2013,5,10394,1556,11950
1,11,6,2,2013,6,11052,1649,12701
1,11,6,2,2013,7,11087,1732,12819
1,11,6,2,2013,8,11494,1905,13399
1,11,6,2,2013,9,11610,2219,13829
1,11,6,2,2013,10,11642,2593,14235
1,11,6,2,2013,11,11583,2842,14425
1,11,6,2,2013,12,11648,2954,14602
1,11,6,2,2013,13,11507,2953,14460
1,11,6,2,2013,14,11408,2892,14300
1,11,6,2,2013,15,11363,2934,14297
1,11,6,2,2013,16,11313,2927,14240
1,11,6,2,2013,17,11078,2887,13965
1,11,6,2,2013,18,10701,2819,13520
1,11,6,2,2013,19,10670,2692,13362
1,11,6,2,2013,20,11837,2683,14520
1,11,6,2,2013,21,12164,2625,14789
1,11,6,2,2013,22,11748,2502,14250
1,11,6,2,2013,23,11437,2338,13775
1,11,6,2,2013,24,11169,2217,13386
1,12,6,2,2013,1,10808,2031,12839
1,12,6,2,2013,2,10665,1861,12526
1,12,6,2,2013,3,10474,1782,12256
1,12,6,2,2013,4,10273,1730,12003
1,12,6,2,2013,5,10303,1684,11987
1,12,6,2,2013,6,10746,1732,12478
1,12,6,2,2013,7,11234,1816,13050
1,12,6,2,2013,8,11382,1951,13333
1,12,6,2,2013,9,11396,2325,13721
1,12,6,2,2013,10,11728,2638,14366
1,12,6,2,2013,11,11758,2878,14636
1,12,6,2,2013,12,11558,2927,14485
1,12,6,2,2013,13,11405,2879,14284
1,12,6,2,2013,14,11210,2784,13994
1,12,6,2,2013,15,11511,2793,14304
1,12,6,2,2013,16,11396,2827,14223
1,12,6,2,2013,17,11308,2800,14108
1,12,6,2,2013,18,11176,2721,13897
1,12,6,2,2013,19,11325,2606,13931
1,12,6,2,2013,20,12249,2640,14889
1,12,6,2,2013,21,12536,2569,15105
1,12,6,2,2013,22,11989,2512,14501
1,12,6,2,2013,23,11719,2383,14102
1,12,6,2,2013,24,11626,2200,13826
1,13,6,2,2013,1,11486,2015,13501
1,13,6,2,2013,2,11221,1853,13074
1,13,6,2,2013,3,10988,1774,12762
1,13,6,2,2013,4,11027,1727,12754
1,13,6,2,2013,5,11061,1725,12786
1,13,6,2,2013,6,11431,1787,13218
1,13,6,2,2013,7,11583,1858,13441
1,13,6,2,2013,8,12010,1989,13999
1,13,6,2,2013,9,12041,2276,14317
1,13,6,2,2013,10,12315,2607,14922
1,13,6,2,2013,11,11994,2839,14833
1,13,6,2,2013,12,11786,2936,14722
1,13,6,2,2013,13,11350,2933,14283
1,13,6,2,2013,14,11375,2786,14161
1,13,6,2,2013,15,11261,2776,14037
1,13,6,2,2013,16,11478,2734,14212
1,13,6,2,2013,17,11217,2748,13965
1,13,6,2,2013,18,10880,2731,13611
1,13,6,2,2013,19,10933,2657,13590
1,13,6,2,2013,20,11767,2647,14414
1,13,6,2,2013,21,11702,2571,14273
1,13,6,2,2013,22,11573,2371,13944
1,13,6,2,2013,23,11276,2255,13531
1,13,6,2,2013,24,10687,2153,12840
1,14,6,2,2013,1,10342,2027,12369
1,14,6,2,2013,2,10115,1835,11950
1,14,6,2,2013,3,9937,1762,11699
1,14,6,2,2013,4,9912,1708,11620
1,14,6,2,2013,5,9802,1708,11510
1,14,6,2,2013,6,10389,1768,12157
1,14,6,2,2013,7,10653,1844,12497
1,14,6,2,2013,8,10804,2007,12811
1,14,6,2,2013,9,11049,2272,13321
1,14,6,2,2013,10,11268,2526,13794
1,14,6,2,2013,11,11149,2791,13940
1,14,6,2,2013,12,10590,2908,13498
1,14,6,2,2013,13,10448,2876,13324
1,14,6,2,2013,14,10422,2716,13138
1,14,6,2,2013,15,10451,2677,13128
1,14,6,2,2013,16,10168,2659,12827
1,14,6,2,2013,17,10125,2629,12754
1,14,6,2,2013,18,9875,2588,12463
1,14,6,2,2013,19,10311,2545,12856
1,14,6,2,2013,20,10945,2517,13462
1,14,6,2,2013,21,11144,2440,13584
1,14,6,2,2013,22,10932,2362,13294
1,14,6,2,2013,23,10460,2206,12666
1,14,6,2,2013,24,10141,2061,12202
2,15,6,2,2013,1,9656,1935,11591
2,15,6,2,2013,2,9696,1751,11447
2,15,6,2,2013,3,9483,1667,11150
2,15,6,2,2013,4,9277,1618,10895
2,15,6,2,2013,5,9296,1593,10889
2,15,6,2,2013,6,9862,1666,11528
2,15,6,2,2013,7,9916,1746,11662
2,15,6,2,2013,8,10130,1857,11987
2,15,6,2,2013,9,10457,2098,12555
2,15,6,2,2013,10,10918,2402,13320
2,15,6,2,2013,11,10976,2643,13619
2,15,6,2,2013,12,10760,2672,13432
2,15,6,2,2013,13,10490,2672,13162
2,15,6,2,2013,14,10251,2573,12824
2,15,6,2,2013,15,10215,2543,12758
2,15,6,2,2013,16,10317,2528,12845
2,15,6,2,2013,17,10541,2470,13011
2,15,6,2,2013,18,10389,2402,12791
2,15,6,2,2013,19,10883,2390,13273
2,15,6,2,2013,20,11175,2409,13584
2,15,6,2,2013,21,11161,2384,13545
2,15,6,2,2013,22,11004,2291,13295
2,15,6,2,2013,23,10510,2155,12665
2,15,6,2,2013,24,10165,2065,12230
2,16,6,2,2013,1,9907,1883,11790
2,16,6,2,2013,2,9737,1757,11494
2,16,6,2,2013,3,9733,1657,11390
2,16,6,2,2013,4,9692,1593,11285
2,16,6,2,2013,5,9303,1586,10889
2,16,6,2,2013,6,9478,1626,11104
2,16,6,2,2013,7,9904,1645,11549
2,16,6,2,2013,8,10300,1667,11967
2,16,6,2,2013,9,10350,1740,12090
2,16,6,2,2013,10,10562,1830,12392
2,16,6,2,2013,11,10396,2005,12401
2,16,6,2,2013,12,10331,2064,12395
2,16,6,2,2013,13,10068,2045,12113
2,16,6,2,2013,14,9537,1957,11494
2,16,6,2,2013,15,9540,1867,11407
2,16,6,2,2013,16,9509,1829,11338
2,16,6,2,2013,17,9674,1814,11488
2,16,6,2,2013,18,9687,1858,11545
2,16,6,2,2013,19,10081,1964,12045
2,16,6,2,2013,20,10613,2119,12732
2,16,6,2,2013,21,10786,2144,12930
2,16,6,2,2013,22,10576,2110,12686
2,16,6,2,2013,23,10223,2033,12256
2,16,6,2,2013,24,9938,1906,11844
1,17,6,2,2013,1,9699,1755,11454
1,17,6,2,2013,2,9525,1593,11118
1,17,6,2,2013,3,9467,1522,10989
1,17,6,2,2013,4,9457,1492,10949
1,17,6,2,2013,5,9483,1491,10974
1,17,6,2,2013,6,9823,1605,11428
1,17,6,2,2013,7,10091,1730,11821
1,17,6,2,2013,8,10301,1895,12196
1,17,6,2,2013,9,10231,2246,12477
1,17,6,2,2013,10,10580,2583,13163
1,17,6,2,2013,11,10327,2821,13148
1,17,6,2,2013,12,10412,2845,13257
1,17,6,2,2013,13,10299,2785,13084
1,17,6,2,2013,14,10291,2668,12959
1,17,6,2,2013,15,10275,2677,12952
1,17,6,2,2013,16,10400,2710,13110
1,17,6,2,2013,17,10199,2683,12882
1,17,6,2,2013,18,10069,2603,12672
1,17,6,2,2013,19,10525,2488,13013
1,17,6,2,2013,20,11505,2521,14026
1,17,6,2,2013,21,11295,2437,13732
1,17,6,2,2013,22,11150,2300,13450
1,17,6,2,2013,23,10642,2181,12823
1,17,6,2,2013,24,10385,2006,12391
1,18,6,2,2013,1,10051,1853,11904
1,18,6,2,2013,2,10058,1686,11744
1,18,6,2,2013,3,9830,1594,11424
1,18,6,2,2013,4,9761,1554,11315
1,18,6,2,2013,5,9913,1560,11473
1,18,6,2,2013,6,10279,1658,11937
1,18,6,2,2013,7,10630,1809,12439
1,18,6,2,2013,8,10739,1974,12713
1,18,6,2,2013,9,10990,2209,13199
1,18,6,2,2013,10,11402,2498,13900
1,18,6,2,2013,11,11294,2707,14001
1,18,6,2,2013,12,10965,2842,13807
1,18,6,2,2013,13,10762,2819,13581
1,18,6,2,2013,14,10536,2666,13202
1,18,6,2,2013,15,10883,2661,13544
1,18,6,2,2013,16,10719,2643,13362
1,18,6,2,2013,17,10631,2647,13278
1,18,6,2,2013,18,10350,2575,12925
1,18,6,2,2013,19,10689,2537,13226
1,18,6,2,2013,20,11589,2529,14118
1,18,6,2,2013,21,11464,2479,13943
1,18,6,2,2013,22,11081,2315,13396
1,18,6,2,2013,23,11071,2144,13215
1,18,6,2,2013,24,10411,1963,12374
1,19,6,2,2013,1,10076,1859,11935
1,19,6,2,2013,2,10013,1718,11731
1,19,6,2,2013,3,10037,1637,11674
1,19,6,2,2013,4,10064,1573,11637
1,19,6,2,2013,5,10136,1560,11696
1,19,6,2,2013,6,10714,1617,12331
1,19,6,2,2013,7,11093,1689,12782
1,19,6,2,2013,8,11099,1825,12924
1,19,6,2,2013,9,11286,2179,13465
1,19,6,2,2013,10,11644,2507,14151
1,19,6,2,2013,11,11616,2776,14392
1,19,6,2,2013,12,11635,2847,14482
1,19,6,2,2013,13,11299,2840,14139
1,19,6,2,2013,14,10995,2762,13757
1,19,6,2,2013,15,11046,2777,13823
1,19,6,2,2013,16,11067,2781,13848
1,19,6,2,2013,17,11204,2753,13957
1,19,6,2,2013,18,10868,2711,13579
1,19,6,2,2013,19,10881,2602,13483
1,19,6,2,2013,20,11452,2661,14113
1,19,6,2,2013,21,12002,2571,14573
1,19,6,2,2013,22,11848,2442,14290
1,19,6,2,2013,23,11510,2244,13754
1,19,6,2,2013,24,11148,2141,13289
1,20,6,2,2013,1,10931,1908,12839
1,20,6,2,2013,2,10747,1748,12495
1,20,6,2,2013,3,10571,1656,12227
1,20,6,2,2013,4,10211,1606,11817
1,20,6,2,2013,5,10179,1600,11779
1,20,6,2,2013,6,10739,1708,12447
1,20,6,2,2013,7,10841,1787,12628
1,20,6,2,2013,8,11313,1962,13275
1,20,6,2,2013,9,11360,2289,13649
1,20,6,2,2013,10,11606,2630,14236
1,20,6,2,2013,11,11532,2850,14382
1,20,6,2,2013,12,11319,2872,14191
1,20,6,2,2013,13,11182,2871,14053
1,20,6,2,2013,14,10992,2772,13764
1,20,6,2,2013,15,11143,2798,13941
1,20,6,2,2013,16,11302,2804,14106
1,20,6,2,2013,17,11140,2765,13905
1,20,6,2,2013,18,10618,2714,13332
1,20,6,2,2013,19,10775,2623,13398
1,20,6,2,2013,20,11748,2611,14359
1,20,6,2,2013,21,11958,2589,14547
1,20,6,2,2013,22,11601,2456,14057
1,20,6,2,2013,23,11560,2307,13867
1,20,6,2,2013,24,11203,2168,13371
1,21,6,2,2013,1,10874,1943,12817
1,21,6,2,2013,2,10832,1758,12590
1,21,6,2,2013,3,10836,1664,12500
1,21,6,2,2013,4,10766,1621,12387
1,21,6,2,2013,5,10899,1600,12499
1,21,6,2,2013,6,11258,1735,12993
1,21,6,2,2013,7,11478,1849,13327
1,21,6,2,2013,8,11542,2008,13550
1,21,6,2,2013,9,11624,2234,13858
1,21,6,2,2013,10,11450,2714,14164
1,21,6,2,2013,11,11329,2903,14232
1,21,6,2,2013,12,11122,2931,14053
1,21,6,2,2013,13,11019,2874,13893
1,21,6,2,2013,14,10635,2759,13394
1,21,6,2,2013,15,10581,2748,13329
1,21,6,2,2013,16,10795,2780,13575
1,21,6,2,2013,17,10397,2821,13218
1,21,6,2,2013,18,10300,2779,13079
1,21,6,2,2013,19,10643,2696,13339
1,21,6,2,2013,20,11598,2647,14245
1,21,6,2,2013,21,11561,2616,14177
1,21,6,2,2013,22,11515,2455,13970
1,21,6,2,2013,23,11341,2296,13637
1,21,6,2,2013,24,10981,2127,13108
2,22,6,2,2013,1,10700,1972,12672
2,22,6,2,2013,2,10633,1816,12449
2,22,6,2,2013,3,10496,1711,12207
2,22,6,2,2013,4,10387,1660,12047
2,22,6,2,2013,5,10766,1635,12401
2,22,6,2,2013,6,11072,1701,12773
2,22,6,2,2013,7,11320,1772,13092
2,22,6,2,2013,8,11144,1895,13039
2,22,6,2,2013,9,11396,2164,13560
2,22,6,2,2013,10,11784,2463,14247
2,22,6,2,2013,11,11738,2704,14442
2,22,6,2,2013,12,11708,2750,14458
2,22,6,2,2013,13,11455,2747,14202
2,22,6,2,2013,14,11123,2653,13776
2,22,6,2,2013,15,11202,2647,13849
2,22,6,2,2013,16,11235,2598,13833
2,22,6,2,2013,17,11140,2550,13690
2,22,6,2,2013,18,10903,2463,13366
2,22,6,2,2013,19,11056,2431,13487
2,22,6,2,2013,20,11909,2507,14416
2,22,6,2,2013,21,11915,2490,14405
2,22,6,2,2013,22,11625,2389,14014
2,22,6,2,2013,23,11425,2281,13706
2,22,6,2,2013,24,11227,2158,13385
2,23,6,2,2013,1,10848,2000,12848
2,23,6,2,2013,2,10744,1816,12560
2,23,6,2,2013,3,10654,1717,12371
2,23,6,2,2013,4,10529,1658,12187
2,23,6,2,2013,5,10818,1643,12461
2,23,6,2,2013,6,11225,1700,12925
2,23,6,2,2013,7,11151,1693,12844
2,23,6,2,2013,8,11333,1759,13092
2,23,6,2,2013,9,11560,1844,13404
2,23,6,2,2013,10,11753,2004,13757
2,23,6,2,2013,11,11736,2140,13876
2,23,6,2,2013,12,11706,2164,13870
2,23,6,2,2013,13,11351,2118,13469
2,23,6,2,2013,14,11263,2031,13294
2,23,6,2,2013,15,11212,2001,13213
2,23,6,2,2013,16,11273,1976,13249
2,23,6,2,2013,17,11008,1963,12971
2,23,6,2,2013,18,10665,1942,12607
2,23,6,2,2013,19,10786,1995,12781
2,23,6,2,2013,20,11608,2134,13742
2,23,6,2,2013,21,11688,2230,13918
2,23,6,2,2013,22,11506,2218,13724
2,23,6,2,2013,23,11283,2227,13510
2,23,6,2,2013,24,11169,2077,13246
1,24,6,2,2013,1,10949,1933,12882
1,24,6,2,2013,2,10684,1762,12446
1,24,6,2,2013,3,10463,1663,12126
1,24,6,2,2013,4,10645,1593,12238
1,24,6,2,2013,5,10559,1592,12151
1,24,6,2,2013,6,10802,1693,12495
1,24,6,2,2013,7,11066,1845,12911
1,24,6,2,2013,8,11327,2002,13329
1,24,6,2,2013,9,11597,2292,13889
1,24,6,2,2013,10,12272,2623,14895
1,24,6,2,2013,11,12336,2867,15203
1,24,6,2,2013,12,12138,2917,15055
1,24,6,2,2013,13,11745,2875,14620
1,24,6,2,2013,14,11404,2800,14204
1,24,6,2,2013,15,11403,2731,14134
1,24,6,2,2013,16,11534,2685,14219
1,24,6,2,2013,17,11126,2684,13810
1,24,6,2,2013,18,10838,2577,13415
1,24,6,2,2013,19,11271,2559,13830
1,24,6,2,2013,20,11680,2576,14256
1,24,6,2,2013,21,11778,2453,14231
1,24,6,2,2013,22,11031,2320,13351
1,24,6,2,2013,23,10769,2220,12989
1,24,6,2,2013,24,10302,2073,12375
1,25,6,2,2013,1,10219,1904,12123
1,25,6,2,2013,2,9935,1760,11695
1,25,6,2,2013,3,9672,1676,11348
1,25,6,2,2013,4,9616,1638,11254
1,25,6,2,2013,5,9635,1637,11272
1,25,6,2,2013,6,10175,1729,11904
1,25,6,2,2013,7,10246,1844,12090
1,25,6,2,2013,8,10531,2004,12535
1,25,6,2,2013,9,10881,2297,13178
1,25,6,2,2013,10,10856,2626,13482
1,25,6,2,2013,11,10861,2842,13703
1,25,6,2,2013,12,10600,2851,13451
1,25,6,2,2013,13,10347,2828,13175
1,25,6,2,2013,14,10055,2699,12754
1,25,6,2,2013,15,10245,2733,12978
1,25,6,2,2013,16,10318,2688,13006
1,25,6,2,2013,17,10349,2649,12998
1,25,6,2,2013,18,10299,2606,12905
1,25,6,2,2013,19,10696,2530,13226
1,25,6,2,2013,20,11132,2550,13682
1,25,6,2,2013,21,11298,2428,13726
1,25,6,2,2013,22,10735,2357,13092
1,25,6,2,2013,23,10415,2203,12618
1,25,6,2,2013,24,10188,1986,12174
1,26,6,2,2013,1,9861,1837,11698
1,26,6,2,2013,2,9538,1670,11208
1,26,6,2,2013,3,9427,1590,11017
1,26,6,2,2013,4,9471,1550,11021
1,26,6,2,2013,5,9605,1552,11157
1,26,6,2,2013,6,10189,1660,11849
1,26,6,2,2013,7,10491,1789,12280
1,26,6,2,2013,8,10936,1953,12889
1,26,6,2,2013,9,10776,2273,13049
1,26,6,2,2013,10,11025,2636,13661
1,26,6,2,2013,11,11048,2881,13929
1,26,6,2,2013,12,10669,2914,13583
1,26,6,2,2013,13,10581,2895,13476
1,26,6,2,2013,14,10162,2778,12940
1,26,6,2,2013,15,10362,2793,13155
1,26,6,2,2013,16,10562,2773,13335
1,26,6,2,2013,17,10427,2768,13195
1,26,6,2,2013,18,10426,2742,13168
1,26,6,2,2013,19,10847,2645,13492
1,26,6,2,2013,20,11498,2637,14135
1,26,6,2,2013,21,11567,2555,14122
1,26,6,2,2013,22,11254,2435,13689
1,26,6,2,2013,23,10822,2290,13112
1,26,6,2,2013,24,10405,2145,12550
1,27,6,2,2013,1,10114,1909,12023
1,27,6,2,2013,2,9948,1737,11685
1,27,6,2,2013,3,9864,1652,11516
1,27,6,2,2013,4,9812,1598,11410
1,27,6,2,2013,5,10008,1588,11596
1,27,6,2,2013,6,10590,1694,12284
1,27,6,2,2013,7,10779,1827,12606
1,27,6,2,2013,8,11186,2002,13188
1,27,6,2,2013,9,10949,2317,13266
1,27,6,2,2013,10,11081,2675,13756
1,27,6,2,2013,11,11229,2896,14125
1,27,6,2,2013,12,10798,2932,13730
1,27,6,2,2013,13,10341,2906,13247
1,27,6,2,2013,14,10268,2794,13062
1,27,6,2,2013,15,10241,2822,13063
1,27,6,2,2013,16,10301,2840,13141
1,27,6,2,2013,17,10259,2841,13100
1,27,6,2,2013,18,10011,2754,12765
1,27,6,2,2013,19,10434,2672,13106
1,27,6,2,2013,20,11299,2633,13932
1,27,6,2,2013,21,11643,2562,14205
1,27,6,2,2013,22,11371,2436,13807
1,27,6,2,2013,23,10925,2271,13196
1,27,6,2,2013,24,10575,2072,12647
1,28,6,2,2013,1,10290,1917,12207
1,28,6,2,2013,2,10305,1760,12065
1,28,6,2,2013,3,10096,1684,11780
1,28,6,2,2013,4,9875,1627,11502
1,28,6,2,2013,5,10003,1625,11628
1,28,6,2,2013,6,10402,1716,12118
1,28,6,2,2013,7,11080,1859,12939
1,28,6,2,2013,8,11143,2024,13167
1,28,6,2,2013,9,11077,2334,13411
1,28,6,2,2013,10,11058,2669,13727
1,28,6,2,2013,11,10982,2901,13883
1,28,6,2,2013,12,10331,2971,13302
1,28,6,2,2013,13,10434,2938,13372
1,28,6,2,2013,14,10370,2811,13181
1,28,6,2,2013,15,10095,2816,12911
1,28,6,2,2013,16,10096,2816,12912
1,28,6,2,2013,17,10168,2819,12987
1,28,6,2,2013,18,9718,2776,12494
1,28,6,2,2013,19,10088,2671,12759
1,28,6,2,2013,20,11314,2668,13982
1,28,6,2,2013,21,11208,2624,13832
1,28,6,2,2013,22,11103,2464,13567
1,28,6,2,2013,23,10991,2326,13317
1,28,6,2,2013,24,10680,2067,12747
2,29,6,2,2013,1,10077,1930,12007
2,29,6,2,2013,2,10009,1780,11789
2,29,6,2,2013,3,9767,1698,11465
2,29,6,2,2013,4,9805,1634,11439
2,29,6,2,2013,5,10005,1621,11626
2,29,6,2,2013,6,10275,1706,11981
2,29,6,2,2013,7,10769,1769,12538
2,29,6,2,2013,8,10918,1896,12814
2,29,6,2,2013,9,11220,2177,13397
2,29,6,2,2013,10,11229,2529,13758
2,29,6,2,2013,11,11080,2757,13837
2,29,6,2,2013,12,11148,2819,13967
2,29,6,2,2013,13,10713,2804,13517
2,29,6,2,2013,14,10872,2673,13545
2,29,6,2,2013,15,10770,2675,13445
2,29,6,2,2013,16,10890,2650,13540
2,29,6,2,2013,17,10790,2593,13383
2,29,6,2,2013,18,10458,2560,13018
2,29,6,2,2013,19,10749,2511,13260
2,29,6,2,2013,20,11369,2545,13914
2,29,6,2,2013,21,11589,2456,14045
2,29,6,2,2013,22,11193,2361,13554
2,29,6,2,2013,23,11211,2246,13457
2,29,6,2,2013,24,10911,2114,13025
2,30,6,2,2013,1,10498,1952,12450
2,30,6,2,2013,2,10552,1780,12332
2,30,6,2,2013,3,10251,1691,11942
2,30,6,2,2013,4,10421,1630,12051
2,30,6,2,2013,5,10483,1628,12111
2,30,6,2,2013,6,10910,1678,12588
2,30,6,2,2013,7,11114,1680,12794
2,30,6,2,2013,8,11335,1719,13054
2,30,6,2,2013,9,11376,1818,13194
2,30,6,2,2013,10,11259,1970,13229
2,30,6,2,2013,11,11360,2110,13470
2,30,6,2,2013,12,11328,2150,13478
2,30,6,2,2013,13,10981,2148,13129
2,30,6,2,2013,14,10596,2090,12686
2,30,6,2,2013,15,10843,2039,12882
2,30,6,2,2013,16,10977,2000,12977
2,30,6,2,2013,17,10737,1984,12721
2,30,6,2,2013,18,10289,1995,12284
2,30,6,2,2013,19,10559,2047,12606
2,30,6,2,2013,20,11299,2162,13461
2,30,6,2,2013,21,11556,2250,13806
2,30,6,2,2013,22,11401,2245,13646
2,30,6,2,2013,23,11107,2239,13346
2,30,6,2,2013,24,10764,2234,12998
1,1,7,3,2013,1,10542,1904,12446
1,1,7,3,2013,2,10629,1738,12367
1,1,7,3,2013,3,10366,1653,12019
1,1,7,3,2013,4,10323,1599,11922
1,1,7,3,2013,5,10422,1583,12005
1,1,7,3,2013,6,10946,1683,12629
1,1,7,3,2013,7,11380,1828,13208
1,1,7,3,2013,8,11134,2005,13139
1,1,7,3,2013,9,11697,2330,14027
1,1,7,3,2013,10,11821,2658,14479
1,1,7,3,2013,11,11951,2847,14798
1,1,7,3,2013,12,11796,2906,14702
1,1,7,3,2013,13,11487,2883,14370
1,1,7,3,2013,14,10942,2772,13714
1,1,7,3,2013,15,11212,2806,14018
1,1,7,3,2013,16,11259,2806,14065
1,1,7,3,2013,17,11093,2791,13884
1,1,7,3,2013,18,10692,2703,13395
1,1,7,3,2013,19,10987,2623,13610
1,1,7,3,2013,20,11814,2636,14450
1,1,7,3,2013,21,11857,2551,14408
1,1,7,3,2013,22,11827,2424,14251
1,1,7,3,2013,23,11361,2310,13671
1,1,7,3,2013,24,10690,2149,12839
1,2,7,3,2013,1,11445,1909,13354
1,2,7,3,2013,2,10509,1761,12270
1,2,7,3,2013,3,10263,1670,11933
1,2,7,3,2013,4,10371,1620,11991
1,2,7,3,2013,5,10500,1619,12119
1,2,7,3,2013,6,11187,1722,12909
1,2,7,3,2013,7,11339,1846,13185
1,2,7,3,2013,8,11563,2023,13586
1,2,7,3,2013,9,12147,2346,14493
1,2,7,3,2013,10,12115,2678,14793
1,2,7,3,2013,11,12057,2915,14972
1,2,7,3,2013,12,11827,3000,14827
1,2,7,3,2013,13,11487,2962,14449
1,2,7,3,2013,14,11364,2838,14202
1,2,7,3,2013,15,11431,2845,14276
1,2,7,3,2013,16,11441,2860,14301
1,2,7,3,2013,17,11212,2837,14049
1,2,7,3,2013,18,10800,2790,13590
1,2,7,3,2013,19,11079,2724,13803
1,2,7,3,2013,20,11808,2717,14525
1,2,7,3,2013,21,12111,2656,14767
1,2,7,3,2013,22,11603,2495,14098
1,2,7,3,2013,23,11093,2315,13408
1,2,7,3,2013,24,10796,2191,12987
1,3,7,3,2013,1,10556,2005,12561
1,3,7,3,2013,2,10444,1825,12269
1,3,7,3,2013,3,10395,1729,12124
1,3,7,3,2013,4,10207,1676,11883
1,3,7,3,2013,5,10127,1672,11799
1,3,7,3,2013,6,10748,1768,12516
1,3,7,3,2013,7,11029,1903,12932
1,3,7,3,2013,8,10980,2086,13066
1,3,7,3,2013,9,11745,2385,14130
1,3,7,3,2013,10,11525,2732,14257
1,3,7,3,2013,11,11326,2961,14287
1,3,7,3,2013,12,11198,2991,14189
1,3,7,3,2013,13,11012,2988,14000
1,3,7,3,2013,14,10650,2876,13526
1,3,7,3,2013,15,10715,2913,13628
1,3,7,3,2013,16,10997,2902,13899
1,3,7,3,2013,17,10810,2847,13657
1,3,7,3,2013,18,10538,2832,13370
1,3,7,3,2013,19,11109,2740,13849
1,3,7,3,2013,20,11715,2723,14438
1,3,7,3,2013,21,11706,2640,14346
1,3,7,3,2013,22,11340,2526,13866
1,3,7,3,2013,23,11086,2363,13449
1,3,7,3,2013,24,10710,2179,12889
1,4,7,3,2013,1,10259,2025,12284
1,4,7,3,2013,2,9971,1848,11819
1,4,7,3,2013,3,9908,1764,11672
1,4,7,3,2013,4,9850,1699,11549
1,4,7,3,2013,5,9732,1689,11421
1,4,7,3,2013,6,10403,1779,12182
1,4,7,3,2013,7,10990,1911,12901
1,4,7,3,2013,8,11103,2075,13178
1,4,7,3,2013,9,11094,2394,13488
1,4,7,3,2013,10,10982,2723,13705
1,4,7,3,2013,11,11225,2966,14191
1,4,7,3,2013,12,10598,3018,13616
1,4,7,3,2013,13,10448,2983,13431
1,4,7,3,2013,14,10323,2873,13196
1,4,7,3,2013,15,10399,2912,13311
1,4,7,3,2013,16,10451,2909,13360
1,4,7,3,2013,17,10223,2888,13111
1,4,7,3,2013,18,10013,2834,12847
1,4,7,3,2013,19,10432,2714,13146
1,4,7,3,2013,20,11469,2707,14176
1,4,7,3,2013,21,11534,2612,14146
1,4,7,3,2013,22,11468,2502,13970
1,4,7,3,2013,23,10986,2378,13364
1,4,7,3,2013,24,10770,2243,13013
2,6,7,3,2013,1,10493,2064,12557
2,6,7,3,2013,2,10561,1881,12442
2,6,7,3,2013,3,10309,1766,12075
2,6,7,3,2013,4,10350,1695,12045
2,6,7,3,2013,5,10560,1679,12239
2,6,7,3,2013,6,11280,1763,13043
2,6,7,3,2013,7,11251,1835,13086
2,6,7,3,2013,8,11075,1948,13023
2,6,7,3,2013,9,11334,2216,13550
2,6,7,3,2013,10,11925,2563,14488
2,6,7,3,2013,11,11879,2749,14628
2,6,7,3,2013,12,11700,2783,14483
2,6,7,3,2013,13,11740,2754,14494
2,6,7,3,2013,14,11336,2605,13941
2,6,7,3,2013,15,11269,2595,13864
2,6,7,3,2013,16,11156,2602,13758
2,6,7,3,2013,17,10995,2566,13561
2,6,7,3,2013,18,10598,2529,13127
2,6,7,3,2013,19,10810,2514,13324
2,6,7,3,2013,20,11793,2550,14343
2,6,7,3,2013,21,11689,2514,14203
2,6,7,3,2013,22,11552,2393,13945
2,6,7,3,2013,23,11311,2297,13608
2,6,7,3,2013,24,11109,2154,13263
2,7,7,3,2013,1,10682,1963,12645
2,7,7,3,2013,2,10415,1824,12239
2,7,7,3,2013,3,10425,1732,12157
2,7,7,3,2013,4,10512,1665,12177
2,7,7,3,2013,5,10703,1648,12351
2,7,7,3,2013,6,10765,1703,12468
2,7,7,3,2013,7,10905,1721,12626
2,7,7,3,2013,8,11195,1782,12977
2,7,7,3,2013,9,11447,1892,13339
2,7,7,3,2013,10,12143,2022,14165
2,7,7,3,2013,11,11929,2132,14061
2,7,7,3,2013,12,11795,2126,13921
2,7,7,3,2013,13,11631,2126,13757
2,7,7,3,2013,14,11179,2078,13257
2,7,7,3,2013,15,11291,2014,13305
2,7,7,3,2013,16,11103,1980,13083
2,7,7,3,2013,17,10905,1940,12845
2,7,7,3,2013,18,10385,1948,12333
2,7,7,3,2013,19,10666,1991,12657
2,7,7,3,2013,20,11670,2109,13779
2,7,7,3,2013,21,11411,2181,13592
2,7,7,3,2013,22,11091,2195,13286
2,7,7,3,2013,23,10935,2164,13099
2,7,7,3,2013,24,10776,2000,12776
1,8,7,3,2013,1,10574,1840,12414
1,8,7,3,2013,2,10403,1700,12103
1,8,7,3,2013,3,10192,1611,11803
1,8,7,3,2013,4,10316,1564,11880
1,8,7,3,2013,5,10470,1573,12043
1,8,7,3,2013,6,11091,1676,12767
1,8,7,3,2013,7,11318,1798,13116
1,8,7,3,2013,8,11412,1957,13369
1,8,7,3,2013,9,11784,2275,14059
1,8,7,3,2013,10,11866,2631,14497
1,8,7,3,2013,11,11692,2825,14517
1,8,7,3,2013,12,11607,2857,14464
1,8,7,3,2013,13,11651,2850,14501
1,8,7,3,2013,14,11466,2742,14208
1,8,7,3,2013,15,11446,2775,14221
1,8,7,3,2013,16,11531,2772,14303
1,8,7,3,2013,17,11168,2731,13899
1,8,7,3,2013,18,10759,2678,13437
1,8,7,3,2013,19,10899,2592,13491
1,8,7,3,2013,20,11863,2616,14479
1,8,7,3,2013,21,12122,2511,14633
1,8,7,3,2013,22,11393,2423,13816
1,8,7,3,2013,23,11152,2269,13421
1,8,7,3,2013,24,10897,2058,12955
1,9,7,3,2013,1,10664,1885,12549
1,9,7,3,2013,2,10226,1729,11955
1,9,7,3,2013,3,10038,1648,11686
1,9,7,3,2013,4,10231,1607,11838
1,9,7,3,2013,5,10382,1601,11983
1,9,7,3,2013,6,10748,1686,12434
1,9,7,3,2013,7,10895,1834,12729
1,9,7,3,2013,8,11269,1993,13262
1,9,7,3,2013,9,11590,2308,13898
1,9,7,3,2013,10,11559,2668,14227
1,9,7,3,2013,11,11681,2884,14565
1,9,7,3,2013,12,11536,2940,14476
1,9,7,3,2013,13,11246,2907,14153
1,9,7,3,2013,14,10908,2791,13699
1,9,7,3,2013,15,11103,2821,13924
1,9,7,3,2013,16,11188,2830,14018
1,9,7,3,2013,17,11115,2823,13938
1,9,7,3,2013,18,10759,2750,13509
1,9,7,3,2013,19,10945,2652,13597
1,9,7,3,2013,20,11667,2643,14310
1,9,7,3,2013,21,11703,2574,14277
1,9,7,3,2013,22,11290,2427,13717
1,9,7,3,2013,23,11113,2267,13380
1,9,7,3,2013,24,10892,2087,12979
1,10,7,3,2013,1,10556,1866,12422
1,10,7,3,2013,2,10580,1723,12303
1,10,7,3,2013,3,10283,1640,11923
1,10,7,3,2013,4,10018,1592,11610
1,10,7,3,2013,5,10367,1583,11950
1,10,7,3,2013,6,10969,1688,12657
1,10,7,3,2013,7,11189,1832,13021
1,10,7,3,2013,8,11707,1996,13703
1,10,7,3,2013,9,11635,2282,13917
1,10,7,3,2013,10,11644,2606,14250
1,10,7,3,2013,11,11391,2814,14205
1,10,7,3,2013,12,11271,2842,14113
1,10,7,3,2013,13,10856,2822,13678
1,10,7,3,2013,14,10815,2677,13492
1,10,7,3,2013,15,10713,2645,13358
1,10,7,3,2013,16,10824,2624,13448
1,10,7,3,2013,17,10610,2639,13249
1,10,7,3,2013,18,10380,2642,13022
1,10,7,3,2013,19,11032,2586,13618
1,10,7,3,2013,20,11590,2597,14187
1,10,7,3,2013,21,11891,2471,14362
1,10,7,3,2013,22,11252,2387,13639
1,10,7,3,2013,23,10875,2171,13046
1,10,7,3,2013,24,10350,2035,12385
1,11,7,3,2013,1,10135,1844,11979
1,11,7,3,2013,2,10134,1674,11808
1,11,7,3,2013,3,10120,1594,11714
1,11,7,3,2013,4,10550,1559,12109
1,11,7,3,2013,5,10658,1585,12243
1,11,7,3,2013,6,11010,1678,12688
1,11,7,3,2013,7,11212,1791,13003
1,11,7,3,2013,8,11349,1977,13326
1,11,7,3,2013,9,11556,2299,13855
1,11,7,3,2013,10,11354,2622,13976
1,11,7,3,2013,11,11123,2821,13944
1,11,7,3,2013,12,10862,2845,13707
1,11,7,3,2013,13,10498,2800,13298
1,11,7,3,2013,14,10258,2666,12924
1,11,7,3,2013,15,10488,2679,13167
1,11,7,3,2013,16,10638,2674,13312
1,11,7,3,2013,17,10556,2665,13221
1,11,7,3,2013,18,10225,2651,12876
1,11,7,3,2013,19,10788,2593,13381
1,11,7,3,2013,20,11418,2546,13964
1,11,7,3,2013,21,11133,2481,13614
1,11,7,3,2013,22,11092,2281,13373
1,11,7,3,2013,23,10689,2142,12831
1,11,7,3,2013,24,10385,2049,12434
1,12,7,3,2013,1,10168,1815,11983
1,12,7,3,2013,2,9996,1685,11681
1,12,7,3,2013,3,9968,1621,11589
1,12,7,3,2013,4,9807,1594,11401
1,12,7,3,2013,5,10046,1583,11629
1,12,7,3,2013,6,10713,1662,12375
1,12,7,3,2013,7,11224,1796,13020
1,12,7,3,2013,8,11178,1948,13126
1,12,7,3,2013,9,11344,2247,13591
1,12,7,3,2013,10,10992,2581,13573
1,12,7,3,2013,11,10747,2746,13493
1,12,7,3,2013,12,10308,2782,13090
1,12,7,3,2013,13,9929,2712,12641
1,12,7,3,2013,14,9172,2550,11722
1,12,7,3,2013,15,9310,2533,11843
1,12,7,3,2013,16,9355,2520,11875
1,12,7,3,2013,17,9407,2505,11912
1,12,7,3,2013,18,9703,2490,12193
1,12,7,3,2013,19,10163,2431,12594
1,12,7,3,2013,20,10831,2430,13261
1,12,7,3,2013,21,10929,2389,13318
1,12,7,3,2013,22,10350,2257,12607
1,12,7,3,2013,23,10140,2114,12254
1,12,7,3,2013,24,9706,1963,11669
2,13,7,3,2013,1,9567,1785,11352
2,13,7,3,2013,2,9334,1656,10990
2,13,7,3,2013,3,9350,1580,10930
2,13,7,3,2013,4,9391,1545,10936
2,13,7,3,2013,5,9511,1549,11060
2,13,7,3,2013,6,10077,1617,11694
2,13,7,3,2013,7,10170,1698,11868
2,13,7,3,2013,8,10474,1816,12290
2,13,7,3,2013,9,10553,2059,12612
2,13,7,3,2013,10,10774,2400,13174
2,13,7,3,2013,11,10649,2625,13274
2,13,7,3,2013,12,10341,2649,12990
2,13,7,3,2013,13,10359,2637,12996
2,13,7,3,2013,14,10355,2497,12852
2,13,7,3,2013,15,10293,2482,12775
2,13,7,3,2013,16,10147,2468,12615
2,13,7,3,2013,17,10156,2420,12576
2,13,7,3,2013,18,10256,2404,12660
2,13,7,3,2013,19,10498,2380,12878
2,13,7,3,2013,20,11164,2409,13573
2,13,7,3,2013,21,11473,2319,13792
2,13,7,3,2013,22,10853,2266,13119
2,13,7,3,2013,23,10676,2143,12819
2,13,7,3,2013,24,10256,2036,12292
2,14,7,3,2013,1,9754,1850,11604
2,14,7,3,2013,2,9845,1695,11540
2,14,7,3,2013,3,9783,1616,11399
2,14,7,3,2013,4,9812,1572,11384
2,14,7,3,2013,5,9754,1575,11329
2,14,7,3,2013,6,10267,1624,11891
2,14,7,3,2013,7,10362,1630,11992
2,14,7,3,2013,8,10601,1677,12278
2,14,7,3,2013,9,10987,1787,12774
2,14,7,3,2013,10,10931,1938,12869
2,14,7,3,2013,11,11067,2050,13117
2,14,7,3,2013,12,10730,2103,12833
2,14,7,3,2013,13,10352,2084,12436
2,14,7,3,2013,14,9997,2004,12001
2,14,7,3,2013,15,10184,1965,12149
2,14,7,3,2013,16,10149,1926,12075
2,14,7,3,2013,17,9963,1919,11882
2,14,7,3,2013,18,9859,1914,11773
2,14,7,3,2013,19,9871,1950,11821
2,14,7,3,2013,20,10815,2151,12966
2,14,7,3,2013,21,11296,2182,13478
2,14,7,3,2013,22,10881,2184,13065
2,14,7,3,2013,23,10567,2150,12717
2,14,7,3,2013,24,10286,2092,12378
1,15,7,3,2013,1,9977,1813,11790
1,15,7,3,2013,2,10031,1680,11711
1,15,7,3,2013,3,9894,1616,11510
1,15,7,3,2013,4,9883,1589,11472
1,15,7,3,2013,5,9902,1588,11490
1,15,7,3,2013,6,10455,1657,12112
1,15,7,3,2013,7,10777,1791,12568
1,15,7,3,2013,8,11021,2001,13022
1,15,7,3,2013,9,11054,2339,13393
1,15,7,3,2013,10,11005,2641,13646
1,15,7,3,2013,11,11060,2859,13919
1,15,7,3,2013,12,10709,2943,13652
1,15,7,3,2013,13,10339,2897,13236
1,15,7,3,2013,14,10172,2794,12966
1,15,7,3,2013,15,9999,2807,12806
1,15,7,3,2013,16,10173,2756,12929
1,15,7,3,2013,17,9989,2726,12715
1,15,7,3,2013,18,9996,2692,12688
1,15,7,3,2013,19,10278,2614,12892
1,15,7,3,2013,20,11060,2545,13605
1,15,7,3,2013,21,11115,2551,13666
1,15,7,3,2013,22,10990,2417,13407
1,15,7,3,2013,23,10504,2293,12797
1,15,7,3,2013,24,9910,2154,12064
1,16,7,3,2013,1,10086,1916,12002
1,16,7,3,2013,2,9947,1757,11704
1,16,7,3,2013,3,9897,1668,11565
1,16,7,3,2013,4,9845,1637,11482
1,16,7,3,2013,5,9991,1670,11661
1,16,7,3,2013,6,10331,1735,12066
1,16,7,3,2013,7,10980,1856,12836
1,16,7,3,2013,8,10677,2019,12696
1,16,7,3,2013,9,11068,2337,13405
1,16,7,3,2013,10,11145,2655,13800
1,16,7,3,2013,11,11088,2829,13917
1,16,7,3,2013,12,10780,2905,13685
1,16,7,3,2013,13,10291,2890,13181
1,16,7,3,2013,14,10108,2759,12867
1,16,7,3,2013,15,9932,2759,12691
1,16,7,3,2013,16,10148,2738,12886
1,16,7,3,2013,17,10324,2738,13062
1,16,7,3,2013,18,10363,2686,13049
1,16,7,3,2013,19,10476,2615,13091
1,16,7,3,2013,20,11370,2598,13968
1,16,7,3,2013,21,11161,2516,13677
1,16,7,3,2013,22,10600,2399,12999
1,16,7,3,2013,23,10346,2309,12655
1,16,7,3,2013,24,9881,2110,11991
1,17,7,3,2013,1,9679,1882,11561
1,17,7,3,2013,2,10070,1760,11830
1,17,7,3,2013,3,9685,1669,11354
1,17,7,3,2013,4,9863,1622,11485
1,17,7,3,2013,5,9852,1651,11503
1,17,7,3,2013,6,10358,1734,12092
1,17,7,3,2013,7,10778,1859,12637
1,17,7,3,2013,8,10944,2011,12955
1,17,7,3,2013,9,11169,2322,13491
1,17,7,3,2013,10,10941,2642,13583
1,17,7,3,2013,11,11130,2844,13974
1,17,7,3,2013,12,10786,2868,13654
1,17,7,3,2013,13,10418,2849,13267
1,17,7,3,2013,14,10228,2716,12944
1,17,7,3,2013,15,10480,2709,13189
1,17,7,3,2013,16,10454,2691,13145
1,17,7,3,2013,17,10813,2677,13490
1,17,7,3,2013,18,10752,2641,13393
1,17,7,3,2013,19,11149,2565,13714
1,17,7,3,2013,20,11374,2516,13890
1,17,7,3,2013,21,11055,2495,13550
1,17,7,3,2013,22,10619,2364,12983
1,17,7,3,2013,23,10487,2235,12722
1,17,7,3,2013,24,10061,2048,12109
1,18,7,3,2013,1,9835,1876,11711
1,18,7,3,2013,2,9799,1719,11518
1,18,7,3,2013,3,9532,1635,11167
1,18,7,3,2013,4,9612,1602,11214
1,18,7,3,2013,5,9699,1612,11311
1,18,7,3,2013,6,10116,1689,11805
1,18,7,3,2013,7,10807,1818,12625
1,18,7,3,2013,8,10787,1996,12783
1,18,7,3,2013,9,10646,2304,12950
1,18,7,3,2013,10,10884,2624,13508
1,18,7,3,2013,11,10576,2835,13411
1,18,7,3,2013,12,10229,2867,13096
1,18,7,3,2013,13,10116,2828,12944
1,18,7,3,2013,14,9840,2684,12524
1,18,7,3,2013,15,9891,2679,12570
1,18,7,3,2013,16,10005,2672,12677
1,18,7,3,2013,17,10141,2680,12821
1,18,7,3,2013,18,10199,2633,12832
1,18,7,3,2013,19,10688,2566,13254
1,18,7,3,2013,20,11286,2522,13808
1,18,7,3,2013,21,11176,2454,13630
1,18,7,3,2013,22,10850,2348,13198
1,18,7,3,2013,23,10412,2214,12626
1,18,7,3,2013,24,9874,2070,11944
1,19,7,3,2013,1,9792,1845,11637
1,19,7,3,2013,2,9626,1685,11311
1,19,7,3,2013,3,9681,1611,11292
1,19,7,3,2013,4,9706,1583,11289
1,19,7,3,2013,5,9757,1600,11357
1,19,7,3,2013,6,10277,1706,11983
1,19,7,3,2013,7,10707,1827,12534
1,19,7,3,2013,8,10606,1998,12604
1,19,7,3,2013,9,10890,2289,13179
1,19,7,3,2013,10,10875,2609,13484
1,19,7,3,2013,11,10387,2826,13213
1,19,7,3,2013,12,10181,2860,13041
1,19,7,3,2013,13,9863,2822,12685
1,19,7,3,2013,14,9272,2693,11965
1,19,7,3,2013,15,9318,2709,12027
1,19,7,3,2013,16,9217,2694,11911
1,19,7,3,2013,17,9628,2679,12307
1,19,7,3,2013,18,9511,2629,12140
1,19,7,3,2013,19,10124,2581,12705
1,19,7,3,2013,20,10669,2536,13205
1,19,7,3,2013,21,10722,2481,13203
1,19,7,3,2013,22,10337,2323,12660
1,19,7,3,2013,23,9877,2214,12091
1,19,7,3,2013,24,9566,1947,11513
2,20,7,3,2013,1,8991,1789,10780
2,20,7,3,2013,2,8970,1660,10630
2,20,7,3,2013,3,8915,1579,10494
2,20,7,3,2013,4,9142,1535,10677
2,20,7,3,2013,5,9728,1549,11277
2,20,7,3,2013,6,10125,1614,11739
2,20,7,3,2013,7,10299,1697,11996
2,20,7,3,2013,8,10449,1848,12297
2,20,7,3,2013,9,10369,2114,12483
2,20,7,3,2013,10,10464,2387,12851
2,20,7,3,2013,11,10259,2574,12833
2,20,7,3,2013,12,9859,2660,12519
2,20,7,3,2013,13,9584,2622,12206
2,20,7,3,2013,14,9427,2488,11915
2,20,7,3,2013,15,9727,2450,12177
2,20,7,3,2013,16,9886,2417,12303
2,20,7,3,2013,17,9759,2393,12152
2,20,7,3,2013,18,9874,2385,12259
2,20,7,3,2013,19,10402,2365,12767
2,20,7,3,2013,20,11215,2378,13593
2,20,7,3,2013,21,11200,2354,13554
2,20,7,3,2013,22,10691,2222,12913
2,20,7,3,2013,23,10293,2079,12372
2,20,7,3,2013,24,9845,1948,11793
2,21,7,3,2013,1,9570,1762,11332
2,21,7,3,2013,2,9334,1642,10976
2,21,7,3,2013,3,9516,1565,11081
2,21,7,3,2013,4,9409,1518,10927
2,21,7,3,2013,5,9568,1536,11104
2,21,7,3,2013,6,10003,1579,11582
2,21,7,3,2013,7,10377,1598,11975
2,21,7,3,2013,8,10485,1652,12137
2,21,7,3,2013,9,10515,1787,12302
2,21,7,3,2013,10,10523,1934,12457
2,21,7,3,2013,11,10456,2059,12515
2,21,7,3,2013,12,10131,2106,12237
2,21,7,3,2013,13,10062,2089,12151
2,21,7,3,2013,14,9285,2012,11297
2,21,7,3,2013,15,9249,1960,11209
2,21,7,3,2013,16,9296,1905,11201
2,21,7,3,2013,17,9391,1878,11269
2,21,7,3,2013,18,9398,1895,11293
2,21,7,3,2013,19,9978,1962,11940
2,21,7,3,2013,20,10823,2103,12926
2,21,7,3,2013,21,11003,2152,13155
2,21,7,3,2013,22,10629,2108,12737
2,21,7,3,2013,23,10190,2051,12241
2,21,7,3,2013,24,9752,1932,11684
1,22,7,3,2013,1,9668,1750,11418
1,22,7,3,2013,2,9553,1605,11158
1,22,7,3,2013,3,9443,1528,10971
1,22,7,3,2013,4,9600,1499,11099
1,22,7,3,2013,5,9863,1511,11374
1,22,7,3,2013,6,10353,1616,11969
1,22,7,3,2013,7,10772,1767,12539
1,22,7,3,2013,8,10886,1930,12816
1,22,7,3,2013,9,10845,2238,13083
1,22,7,3,2013,10,10767,2559,13326
1,22,7,3,2013,11,10456,2786,13242
1,22,7,3,2013,12,10197,2834,13031
1,22,7,3,2013,13,10093,2795,12888
1,22,7,3,2013,14,9891,2688,12579
1,22,7,3,2013,15,9886,2719,12605
1,22,7,3,2013,16,9792,2709,12501
1,22,7,3,2013,17,10043,2691,12734
1,22,7,3,2013,18,9968,2630,12598
1,22,7,3,2013,19,10563,2547,13110
1,22,7,3,2013,20,11180,2532,13712
1,22,7,3,2013,21,11285,2468,13753
1,22,7,3,2013,22,10413,2368,12781
1,22,7,3,2013,23,10249,2206,12455
1,22,7,3,2013,24,9564,2019,11583
1,23,7,3,2013,1,9578,1807,11385
1,23,7,3,2013,2,9449,1670,11119
1,23,7,3,2013,3,9327,1587,10914
1,23,7,3,2013,4,9478,1555,11033
1,23,7,3,2013,5,9647,1568,11215
1,23,7,3,2013,6,10158,1665,11823
1,23,7,3,2013,7,10434,1777,12211
1,23,7,3,2013,8,10867,1952,12819
1,23,7,3,2013,9,11066,2252,13318
1,23,7,3,2013,10,10672,2557,13229
1,23,7,3,2013,11,10398,2786,13184
1,23,7,3,2013,12,10144,2818,12962
1,23,7,3,2013,13,9867,2747,12614
1,23,7,3,2013,14,9634,2615,12249
1,23,7,3,2013,15,9859,2587,12446
1,23,7,3,2013,16,9927,2571,12498
1,23,7,3,2013,17,10102,2545,12647
1,23,7,3,2013,18,10271,2498,12769
1,23,7,3,2013,19,10549,2438,12987
1,23,7,3,2013,20,11099,2415,13514
1,23,7,3,2013,21,10899,2355,13254
1,23,7,3,2013,22,10522,2241,12763
1,23,7,3,2013,23,10288,2083,12371
1,23,7,3,2013,24,9660,1901,11561
1,24,7,3,2013,1,9139,1729,10868
1,24,7,3,2013,2,8941,1603,10544
1,24,7,3,2013,3,8984,1539,10523
1,24,7,3,2013,4,9145,1503,10648
1,24,7,3,2013,5,9458,1514,10972
1,24,7,3,2013,6,9785,1610,11395
1,24,7,3,2013,7,10558,1731,12289
1,24,7,3,2013,8,10631,1903,12534
1,24,7,3,2013,9,10628,2181,12809
1,24,7,3,2013,10,10621,2458,13079
1,24,7,3,2013,11,10276,2677,12953
1,24,7,3,2013,12,9950,2756,12706
1,24,7,3,2013,13,9680,2717,12397
1,24,7,3,2013,14,9409,2588,11997
1,24,7,3,2013,15,9718,2570,12288
1,24,7,3,2013,16,9731,2567,12298
1,24,7,3,2013,17,9824,2546,12370
1,24,7,3,2013,18,10056,2516,12572
1,24,7,3,2013,19,10583,2473,13056
1,24,7,3,2013,20,11230,2457,13687
1,24,7,3,2013,21,11143,2398,13541
1,24,7,3,2013,22,10874,2275,13149
1,24,7,3,2013,23,10244,2134,12378
1,24,7,3,2013,24,9740,1933,11673
1,25,7,3,2013,1,9428,1745,11173
1,25,7,3,2013,2,9010,1602,10612
1,25,7,3,2013,3,9136,1523,10659
1,25,7,3,2013,4,9320,1497,10817
1,25,7,3,2013,5,9356,1524,10880
1,25,7,3,2013,6,9988,1628,11616
1,25,7,3,2013,7,10599,1779,12378
1,25,7,3,2013,8,10981,1971,12952
1,25,7,3,2013,9,10748,2270,13018
1,25,7,3,2013,10,10476,2585,13061
1,25,7,3,2013,11,10140,2792,12932
1,25,7,3,2013,12,9660,2830,12490
1,25,7,3,2013,13,9641,2779,12420
1,25,7,3,2013,14,9537,2690,12227
1,25,7,3,2013,15,9594,2697,12291
1,25,7,3,2013,16,9459,2641,12100
1,25,7,3,2013,17,9696,2595,12291
1,25,7,3,2013,18,9868,2591,12459
1,25,7,3,2013,19,10627,2551,13178
1,25,7,3,2013,20,11222,2499,13721
1,25,7,3,2013,21,10918,2429,13347
1,25,7,3,2013,22,10910,2285,13195
1,25,7,3,2013,23,10141,2148,12289
1,25,7,3,2013,24,9970,1956,11926
1,26,7,3,2013,1,9595,1755,11350
1,26,7,3,2013,2,9254,1630,10884
1,26,7,3,2013,3,9492,1551,11043
1,26,7,3,2013,4,9535,1523,11058
1,26,7,3,2013,5,9395,1543,10938
1,26,7,3,2013,6,10217,1647,11864
1,26,7,3,2013,7,11020,1791,12811
1,26,7,3,2013,8,10787,1970,12757
1,26,7,3,2013,9,10593,2285,12878
1,26,7,3,2013,10,10223,2613,12836
1,26,7,3,2013,11,9863,2804,12667
1,26,7,3,2013,12,9440,2871,12311
1,26,7,3,2013,13,9120,2823,11943
1,26,7,3,2013,14,9102,2684,11786
1,26,7,3,2013,15,9011,2698,11709
1,26,7,3,2013,16,8942,2686,11628
1,26,7,3,2013,17,9263,2672,11935
1,26,7,3,2013,18,9453,2628,12081
1,26,7,3,2013,19,9892,2587,12479
1,26,7,3,2013,20,11025,2579,13604
1,26,7,3,2013,21,11030,2504,13534
1,26,7,3,2013,22,10728,2343,13071
1,26,7,3,2013,23,10313,2193,12506
1,26,7,3,2013,24,9800,1993,11793
2,27,7,3,2013,1,9471,1811,11282
2,27,7,3,2013,2,9264,1668,10932
2,27,7,3,2013,3,9080,1577,10657
2,27,7,3,2013,4,9700,1539,11239
2,27,7,3,2013,5,9649,1565,11214
2,27,7,3,2013,6,10111,1637,11748
2,27,7,3,2013,7,10538,1712,12250
2,27,7,3,2013,8,10656,1844,12500
2,27,7,3,2013,9,10576,2095,12671
2,27,7,3,2013,10,10519,2406,12925
2,27,7,3,2013,11,10326,2612,12938
2,27,7,3,2013,12,10050,2665,12715
2,27,7,3,2013,13,9822,2653,12475
2,27,7,3,2013,14,9652,2511,12163
2,27,7,3,2013,15,9672,2425,12097
2,27,7,3,2013,16,9644,2387,12031
2,27,7,3,2013,17,9763,2353,12116
2,27,7,3,2013,18,9733,2344,12077
2,27,7,3,2013,19,10217,2341,12558
2,27,7,3,2013,20,11117,2366,13483
2,27,7,3,2013,21,11117,2352,13469
2,27,7,3,2013,22,10782,2248,13030
2,27,7,3,2013,23,10051,2148,12199
2,27,7,3,2013,24,9904,2025,11929
2,28,7,3,2013,1,9458,1793,11251
2,28,7,3,2013,2,9284,1650,10934
2,28,7,3,2013,3,9301,1574,10875
2,28,7,3,2013,4,9491,1535,11026
2,28,7,3,2013,5,9440,1553,10993
2,28,7,3,2013,6,9884,1594,11478
2,28,7,3,2013,7,10231,1609,11840
2,28,7,3,2013,8,10449,1664,12113
2,28,7,3,2013,9,10788,1775,12563
2,28,7,3,2013,10,10587,1933,12520
2,28,7,3,2013,11,10278,2054,12332
2,28,7,3,2013,12,10278,2082,12360
2,28,7,3,2013,13,9839,2067,11906
2,28,7,3,2013,14,9816,2004,11820
2,28,7,3,2013,15,9678,1945,11623
2,28,7,3,2013,16,9761,1896,11657
2,28,7,3,2013,17,9649,1860,11509
2,28,7,3,2013,18,9450,1887,11337
2,28,7,3,2013,19,10248,1928,12176
2,28,7,3,2013,20,10800,2058,12858
2,28,7,3,2013,21,10688,2080,12768
2,28,7,3,2013,22,10263,2053,12316
2,28,7,3,2013,23,9985,1999,11984
2,28,7,3,2013,24,9540,1880,11420
1,29,7,3,2013,1,9356,1689,11045
1,29,7,3,2013,2,9053,1561,10614
1,29,7,3,2013,3,9359,1490,10849
1,29,7,3,2013,4,9382,1471,10853
1,29,7,3,2013,5,9494,1494,10988
1,29,7,3,2013,6,10114,1594,11708
1,29,7,3,2013,7,10733,1745,12478
1,29,7,3,2013,8,11063,1921,12984
1,29,7,3,2013,9,10831,2246,13077
1,29,7,3,2013,10,10546,2566,13112
1,29,7,3,2013,11,10537,2776,13313
1,29,7,3,2013,12,10221,2820,13041
1,29,7,3,2013,13,10024,2793,12817
1,29,7,3,2013,14,9878,2686,12564
1,29,7,3,2013,15,10137,2699,12836
1,29,7,3,2013,16,10138,2683,12821
1,29,7,3,2013,17,10110,2661,12771
1,29,7,3,2013,18,9889,2632,12521
1,29,7,3,2013,19,10354,2564,12918
1,29,7,3,2013,20,11440,2536,13976
1,29,7,3,2013,21,11309,2497,13806
1,29,7,3,2013,22,10820,2345,13165
1,29,7,3,2013,23,10565,2187,12752
1,29,7,3,2013,24,9999,1951,11950
1,30,7,3,2013,1,9801,1784,11585
1,30,7,3,2013,2,9643,1652,11295
1,30,7,3,2013,3,9581,1579,11160
1,30,7,3,2013,4,9724,1550,11274
1,30,7,3,2013,5,9992,1567,11559
1,30,7,3,2013,6,10475,1661,12136
1,30,7,3,2013,7,11027,1798,12825
1,30,7,3,2013,8,11377,1965,13342
1,30,7,3,2013,9,11144,2265,13409
1,30,7,3,2013,10,10965,2503,13468
1,30,7,3,2013,11,10894,2720,13614
1,30,7,3,2013,12,10491,2796,13287
1,30,7,3,2013,13,10213,2747,12960
1,30,7,3,2013,14,9865,2624,12489
1,30,7,3,2013,15,9919,2632,12551
1,30,7,3,2013,16,10140,2631,12771
1,30,7,3,2013,17,10173,2625,12798
1,30,7,3,2013,18,9999,2598,12597
1,30,7,3,2013,19,10411,2537,12948
1,30,7,3,2013,20,10928,2531,13459
1,30,7,3,2013,21,11260,2457,13717
1,30,7,3,2013,22,10805,2330,13135
1,30,7,3,2013,23,10263,2152,12415
1,30,7,3,2013,24,9860,1963,11823
1,31,7,3,2013,1,9444,1765,11209
1,31,7,3,2013,2,9537,1625,11162
1,31,7,3,2013,3,9309,1564,10873
1,31,7,3,2013,4,9442,1516,10958
1,31,7,3,2013,5,9662,1535,11197
1,31,7,3,2013,6,10064,1653,11717
1,31,7,3,2013,7,10369,1781,12150
1,31,7,3,2013,8,10844,1969,12813
1,31,7,3,2013,9,11045,2262,13307
1,31,7,3,2013,10,10713,2584,13297
1,31,7,3,2013,11,10822,2785,13607
1,31,7,3,2013,12,10385,2828,13213
1,31,7,3,2013,13,10080,2805,12885
1,31,7,3,2013,14,9753,2655,12408
1,31,7,3,2013,15,9829,2666,12495
1,31,7,3,2013,16,9793,2646,12439
1,31,7,3,2013,17,10045,2642,12687
1,31,7,3,2013,18,10137,2634,12771
1,31,7,3,2013,19,10436,2568,13004
1,31,7,3,2013,20,10879,2545,13424
1,31,7,3,2013,21,10863,2508,13371
1,31,7,3,2013,22,10131,2367,12498
1,31,7,3,2013,23,9784,2205,11989
1,31,7,3,2013,24,9417,2017,11434
1,1,8,3,2013,1,9267,1773,11040
1,1,8,3,2013,2,9090,1634,10724
1,1,8,3,2013,3,8951,1560,10511
1,1,8,3,2013,4,9125,1522,10647
1,1,8,3,2013,5,9273,1543,10816
1,1,8,3,2013,6,9546,1645,11191
1,1,8,3,2013,7,9959,1777,11736
1,1,8,3,2013,8,10287,1955,12242
1,1,8,3,2013,9,10277,2242,12519
1,1,8,3,2013,10,10237,2527,12764
1,1,8,3,2013,11,9748,2720,12468
1,1,8,3,2013,12,9556,2769,12325
1,1,8,3,2013,13,9150,2759,11909
1,1,8,3,2013,14,8960,2629,11589
1,1,8,3,2013,15,8938,2636,11574
1,1,8,3,2013,16,9162,2626,11788
1,1,8,3,2013,17,9430,2610,12040
1,1,8,3,2013,18,9277,2588,11865
1,1,8,3,2013,19,10350,2560,12910
1,1,8,3,2013,20,10651,2528,13179
1,1,8,3,2013,21,10683,2494,13177
1,1,8,3,2013,22,10215,2271,12486
1,1,8,3,2013,23,9731,2077,11808
1,1,8,3,2013,24,9168,1876,11044
1,2,8,3,2013,1,8879,1699,10578
1,2,8,3,2013,2,8626,1560,10186
1,2,8,3,2013,3,8454,1500,9954
1,2,8,3,2013,4,8759,1473,10232
1,2,8,3,2013,5,8811,1495,10306
1,2,8,3,2013,6,9432,1606,11038
1,2,8,3,2013,7,9903,1758,11661
1,2,8,3,2013,8,10163,1943,12106
1,2,8,3,2013,9,10434,2260,12694
1,2,8,3,2013,10,9973,2576,12549
1,2,8,3,2013,11,9571,2777,12348
1,2,8,3,2013,12,9441,2829,12270
1,2,8,3,2013,13,8919,2810,11729
1,2,8,3,2013,14,8864,2652,11516
1,2,8,3,2013,15,8639,2658,11297
1,2,8,3,2013,16,8808,2630,11438
1,2,8,3,2013,17,8803,2613,11416
1,2,8,3,2013,18,8900,2611,11511
1,2,8,3,2013,19,9751,2578,12329
1,2,8,3,2013,20,10527,2526,13053
1,2,8,3,2013,21,10595,2444,13039
1,2,8,3,2013,22,10252,2300,12552
1,2,8,3,2013,23,9621,2164,11785
1,2,8,3,2013,24,9252,1976,11228
2,3,8,3,2013,1,9102,1773,10875
2,3,8,3,2013,2,8904,1631,10535
2,3,8,3,2013,3,8769,1561,10330
2,3,8,3,2013,4,9139,1519,10658
2,3,8,3,2013,5,9250,1529,10779
2,3,8,3,2013,6,9757,1616,11373
2,3,8,3,2013,7,10360,1708,12068
2,3,8,3,2013,8,10612,1865,12477
2,3,8,3,2013,9,10553,2130,12683
2,3,8,3,2013,10,10514,2434,12948
2,3,8,3,2013,11,10197,2708,12905
2,3,8,3,2013,12,9979,2682,12661
2,3,8,3,2013,13,9805,2675,12480
2,3,8,3,2013,14,9725,2544,12269
2,3,8,3,2013,15,9609,2538,12147
2,3,8,3,2013,16,9667,2516,12183
2,3,8,3,2013,17,9715,2468,12183
2,3,8,3,2013,18,9688,2441,12129
2,3,8,3,2013,19,10127,2387,12514
2,3,8,3,2013,20,11034,2423,13457
2,3,8,3,2013,21,11353,2381,13734
2,3,8,3,2013,22,11140,2272,13412
2,3,8,3,2013,23,10635,2131,12766
2,3,8,3,2013,24,10106,1970,12076
2,4,8,3,2013,1,9262,1780,11042
2,4,8,3,2013,2,9169,1642,10811
2,4,8,3,2013,3,9147,1556,10703
2,4,8,3,2013,4,9322,1526,10848
2,4,8,3,2013,5,9428,1539,10967
2,4,8,3,2013,6,10085,1596,11681
2,4,8,3,2013,7,10410,1603,12013
2,4,8,3,2013,8,10809,1657,12466
2,4,8,3,2013,9,10956,1766,12722
2,4,8,3,2013,10,10907,1935,12842
2,4,8,3,2013,11,10662,2069,12731
2,4,8,3,2013,12,10508,2103,12611
2,4,8,3,2013,13,10177,2071,12248
2,4,8,3,2013,14,9835,1999,11834
2,4,8,3,2013,15,9926,1962,11888
2,4,8,3,2013,16,9915,1909,11824
2,4,8,3,2013,17,9665,1894,11559
2,4,8,3,2013,18,9644,1902,11546
2,4,8,3,2013,19,9921,1933,11854
2,4,8,3,2013,20,10793,2102,12895
2,4,8,3,2013,21,10829,2158,12987
2,4,8,3,2013,22,10695,2146,12841
2,4,8,3,2013,23,10540,2096,12636
2,4,8,3,2013,24,9944,1985,11929
1,5,8,3,2013,1,10012,1786,11798
1,5,8,3,2013,2,9700,1635,11335
1,5,8,3,2013,3,9666,1563,11229
1,5,8,3,2013,4,9609,1535,11144
1,5,8,3,2013,5,9892,1570,11462
1,5,8,3,2013,6,10735,1639,12374
1,5,8,3,2013,7,11176,1785,12961
1,5,8,3,2013,8,11319,1964,13283
1,5,8,3,2013,9,11255,2263,13518
1,5,8,3,2013,10,11246,2579,13825
1,5,8,3,2013,11,11109,2790,13899
1,5,8,3,2013,12,10504,2858,13362
1,5,8,3,2013,13,10519,2845,13364
1,5,8,3,2013,14,10005,2756,12761
1,5,8,3,2013,15,10401,2771,13172
1,5,8,3,2013,16,10359,2767,13126
1,5,8,3,2013,17,10552,2740,13292
1,5,8,3,2013,18,10176,2691,12867
1,5,8,3,2013,19,10665,2576,13241
1,5,8,3,2013,20,11515,2583,14098
1,5,8,3,2013,21,11593,2554,14147
1,5,8,3,2013,22,10907,2438,13345
1,5,8,3,2013,23,10827,2264,13091
1,5,8,3,2013,24,10081,2027,12108
1,6,8,3,2013,1,9872,1877,11749
1,6,8,3,2013,2,9814,1729,11543
1,6,8,3,2013,3,9764,1631,11395
1,6,8,3,2013,4,10036,1596,11632
1,6,8,3,2013,5,10190,1607,11797
1,6,8,3,2013,6,10870,1702,12572
1,6,8,3,2013,7,11498,1848,13346
1,6,8,3,2013,8,11790,2028,13818
1,6,8,3,2013,9,11755,2298,14053
1,6,8,3,2013,10,11513,2624,14137
1,6,8,3,2013,11,11325,2830,14155
1,6,8,3,2013,12,11156,2868,14024
1,6,8,3,2013,13,10672,2851,13523
1,6,8,3,2013,14,10888,2752,13640
1,6,8,3,2013,15,10827,2786,13613
1,6,8,3,2013,16,10997,2773,13770
1,6,8,3,2013,17,10811,2764,13575
1,6,8,3,2013,18,10760,2692,13452
1,6,8,3,2013,19,11199,2623,13822
1,6,8,3,2013,20,11648,2619,14267
1,6,8,3,2013,21,11697,2577,14274
1,6,8,3,2013,22,11247,2459,13706
1,6,8,3,2013,23,10747,2290,13037
1,6,8,3,2013,24,10481,2116,12597
1,7,8,3,2013,1,10268,1902,12170
1,7,8,3,2013,2,10129,1743,11872
1,7,8,3,2013,3,10178,1653,11831
1,7,8,3,2013,4,10351,1615,11966
1,7,8,3,2013,5,10568,1621,12189
1,7,8,3,2013,6,10859,1704,12563
1,7,8,3,2013,7,11513,1854,13367
1,7,8,3,2013,8,12145,2014,14159
1,7,8,3,2013,9,11765,2294,14059
1,7,8,3,2013,10,11570,2633,14203
1,7,8,3,2013,11,11180,2843,14023
1,7,8,3,2013,12,10994,2874,13868
1,7,8,3,2013,13,10924,2830,13754
1,7,8,3,2013,14,10763,2706,13469
1,7,8,3,2013,15,10902,2710,13612
1,7,8,3,2013,16,10880,2721,13601
1,7,8,3,2013,17,10519,2712,13231
1,7,8,3,2013,18,10445,2689,13134
1,7,8,3,2013,19,10960,2616,13576
1,7,8,3,2013,20,11867,2621,14488
1,7,8,3,2013,21,12003,2525,14528
1,7,8,3,2013,22,11374,2384,13758
1,7,8,3,2013,23,11207,2242,13449
1,7,8,3,2013,24,10651,2081,12732
1,8,8,3,2013,1,10408,1891,12299
1,8,8,3,2013,2,10248,1725,11973
1,8,8,3,2013,3,10257,1647,11904
1,8,8,3,2013,4,10190,1606,11796
1,8,8,3,2013,5,10313,1614,11927
1,8,8,3,2013,6,10951,1715,12666
1,8,8,3,2013,7,11695,1854,13549
1,8,8,3,2013,8,11960,2019,13979
1,8,8,3,2013,9,11872,2298,14170
1,8,8,3,2013,10,11478,2589,14067
1,8,8,3,2013,11,11344,2764,14108
1,8,8,3,2013,12,11264,2780,14044
1,8,8,3,2013,13,10939,2766,13705
1,8,8,3,2013,14,10821,2674,13495
1,8,8,3,2013,15,10850,2701,13551
1,8,8,3,2013,16,11070,2704,13774
1,8,8,3,2013,17,10698,2703,13401
1,8,8,3,2013,18,10430,2642,13072
1,8,8,3,2013,19,10999,2557,13556
1,8,8,3,2013,20,11588,2568,14156
1,8,8,3,2013,21,11594,2492,14086
1,8,8,3,2013,22,11128,2353,13481
1,8,8,3,2013,23,10880,2223,13103
1,8,8,3,2013,24,10639,2071,12710
3,9,8,3,2013,1,10241,1899,12140
3,9,8,3,2013,2,10086,1740,11826
3,9,8,3,2013,3,9926,1655,11581
3,9,8,3,2013,4,10192,1605,11797
3,9,8,3,2013,5,10246,1624,11870
3,9,8,3,2013,6,11107,1725,12832
3,9,8,3,2013,7,11471,1812,13283
3,9,8,3,2013,8,11666,1931,13597
3,9,8,3,2013,9,11797,2112,13909
3,9,8,3,2013,10,11390,2350,13740
3,9,8,3,2013,11,11112,2500,13612
3,9,8,3,2013,12,10853,2520,13373
3,9,8,3,2013,13,10758,2495,13253
3,9,8,3,2013,14,10370,2360,12730
3,9,8,3,2013,15,10449,2343,12792
3,9,8,3,2013,16,10372,2334,12706
3,9,8,3,2013,17,10316,2326,12642
3,9,8,3,2013,18,9708,2325,12033
3,9,8,3,2013,19,10229,2288,12517
3,9,8,3,2013,20,10655,2368,13023
3,9,8,3,2013,21,10898,2324,13222
3,9,8,3,2013,22,10560,2215,12775
3,9,8,3,2013,23,10410,2096,12506
3,9,8,3,2013,24,10079,1960,12039
2,10,8,3,2013,1,9957,1800,11757
2,10,8,3,2013,2,9914,1652,11566
2,10,8,3,2013,3,9971,1583,11554
2,10,8,3,2013,4,10024,1532,11556
2,10,8,3,2013,5,9971,1520,11491
2,10,8,3,2013,6,10402,1598,12000
2,10,8,3,2013,7,10831,1681,12512
2,10,8,3,2013,8,11011,1826,12837
2,10,8,3,2013,9,11251,2081,13332
2,10,8,3,2013,10,11335,2378,13713
2,10,8,3,2013,11,11007,2574,13581
2,10,8,3,2013,12,10966,2581,13547
2,10,8,3,2013,13,10666,2570,13236
2,10,8,3,2013,14,10459,2445,12904
2,10,8,3,2013,15,10492,2418,12910
2,10,8,3,2013,16,10493,2384,12877
2,10,8,3,2013,17,10097,2342,12439
2,10,8,3,2013,18,9841,2306,12147
2,10,8,3,2013,19,10255,2295,12550
2,10,8,3,2013,20,11289,2418,13707
2,10,8,3,2013,21,11262,2343,13605
2,10,8,3,2013,22,10959,2243,13202
2,10,8,3,2013,23,10635,2189,12824
2,10,8,3,2013,24,10288,1900,12188
2,11,8,3,2013,1,9934,1828,11762
2,11,8,3,2013,2,9782,1699,11481
2,11,8,3,2013,3,9737,1616,11353
2,11,8,3,2013,4,9703,1558,11261
2,11,8,3,2013,5,10001,1557,11558
2,11,8,3,2013,6,10517,1615,12132
2,11,8,3,2013,7,11086,1654,12740
2,11,8,3,2013,8,11189,1710,12899
2,11,8,3,2013,9,11336,1836,13172
2,11,8,3,2013,10,11672,1978,13650
2,11,8,3,2013,11,11423,2082,13505
2,11,8,3,2013,12,11131,2094,13225
2,11,8,3,2013,13,10927,2081,13008
2,11,8,3,2013,14,10746,2019,12765
2,11,8,3,2013,15,10751,1935,12686
2,11,8,3,2013,16,10717,1881,12598
2,11,8,3,2013,17,10345,1878,12223
2,11,8,3,2013,18,9774,1871,11645
2,11,8,3,2013,19,10403,1927,12330
2,11,8,3,2013,20,11101,2100,13201
2,11,8,3,2013,21,11103,2133,13236
2,11,8,3,2013,22,10738,2134,12872
2,11,8,3,2013,23,10527,2071,12598
2,11,8,3,2013,24,10484,1947,12431
1,12,8,3,2013,1,10225,1776,12001
1,12,8,3,2013,2,10086,1628,11714
1,12,8,3,2013,3,9883,1554,11437
1,12,8,3,2013,4,9981,1510,11491
1,12,8,3,2013,5,10271,1517,11788
1,12,8,3,2013,6,10983,1609,12592
1,12,8,3,2013,7,11699,1792,13491
1,12,8,3,2013,8,11798,1996,13794
1,12,8,3,2013,9,11703,2283,13986
1,12,8,3,2013,10,11670,2612,14282
1,12,8,3,2013,11,11687,2839,14526
1,12,8,3,2013,12,11342,2874,14216
1,12,8,3,2013,13,11059,2866,13925
1,12,8,3,2013,14,11094,2728,13822
1,12,8,3,2013,15,11103,2747,13850
1,12,8,3,2013,16,11370,2740,14110
1,12,8,3,2013,17,10852,2720,13572
1,12,8,3,2013,18,10206,2654,12860
1,12,8,3,2013,19,10991,2596,13587
1,12,8,3,2013,20,11789,2578,14367
1,12,8,3,2013,21,11591,2497,14088
1,12,8,3,2013,22,11220,2330,13550
1,12,8,3,2013,23,10901,2193,13094
1,12,8,3,2013,24,10649,1998,12647
1,13,8,3,2013,1,10358,1814,12172
1,13,8,3,2013,2,10182,1659,11841
1,13,8,3,2013,3,10022,1591,11613
1,13,8,3,2013,4,9907,1549,11456
1,13,8,3,2013,5,9996,1550,11546
1,13,8,3,2013,6,10592,1655,12247
1,13,8,3,2013,7,11250,1832,13082
1,13,8,3,2013,8,11628,2002,13630
1,13,8,3,2013,9,11618,2297,13915
1,13,8,3,2013,10,11558,2612,14170
1,13,8,3,2013,11,11474,2822,14296
1,13,8,3,2013,12,11094,2863,13957
1,13,8,3,2013,13,10854,2818,13672
1,13,8,3,2013,14,10744,2658,13402
1,13,8,3,2013,15,10742,2646,13388
1,13,8,3,2013,16,10912,2652,13564
1,13,8,3,2013,17,10611,2643,13254
1,13,8,3,2013,18,10326,2640,12966
1,13,8,3,2013,19,10614,2616,13230
1,13,8,3,2013,20,11564,2610,14174
1,13,8,3,2013,21,11307,2569,13876
1,13,8,3,2013,22,11011,2398,13409
1,13,8,3,2013,23,10580,2183,12763
1,13,8,3,2013,24,10722,1938,12660
1,14,8,3,2013,1,10312,1803,12115
1,14,8,3,2013,2,10199,1645,11844
1,14,8,3,2013,3,10237,1571,11808
1,14,8,3,2013,4,10120,1526,11646
1,14,8,3,2013,5,10130,1521,11651
1,14,8,3,2013,6,10456,1643,12099
1,14,8,3,2013,7,11105,1816,12921
1,14,8,3,2013,8,11184,1983,13167
1,14,8,3,2013,9,11192,2283,13475
1,14,8,3,2013,10,11294,2577,13871
1,14,8,3,2013,11,11228,2823,14051
1,14,8,3,2013,12,11116,2861,13977
1,14,8,3,2013,13,10867,2820,13687
1,14,8,3,2013,14,10665,2690,13355
1,14,8,3,2013,15,10855,2722,13577
1,14,8,3,2013,16,10945,2728,13673
1,14,8,3,2013,17,10653,2724,13377
1,14,8,3,2013,18,10148,2694,12842
1,14,8,3,2013,19,10744,2617,13361
1,14,8,3,2013,20,11671,2620,14291
1,14,8,3,2013,21,11500,2526,14026
1,14,8,3,2013,22,11203,2354,13557
1,14,8,3,2013,23,11212,2172,13384
1,14,8,3,2013,24,10555,2004,12559
3,15,8,3,2013,1,10269,1839,12108
3,15,8,3,2013,2,10085,1682,11767
3,15,8,3,2013,3,10025,1598,11623
3,15,8,3,2013,4,10013,1543,11556
3,15,8,3,2013,5,10584,1544,12128
3,15,8,3,2013,6,11229,1608,12837
3,15,8,3,2013,7,11244,1687,12931
3,15,8,3,2013,8,10899,1745,12644
3,15,8,3,2013,9,10111,1863,11974
3,15,8,3,2013,10,10182,1985,12167
3,15,8,3,2013,11,9774,2067,11841
3,15,8,3,2013,12,9774,2077,11851
3,15,8,3,2013,13,9626,2060,11686
3,15,8,3,2013,14,9564,1985,11549
3,15,8,3,2013,15,9482,1944,11426
3,15,8,3,2013,16,9511,1919,11430
3,15,8,3,2013,17,8991,1893,10884
3,15,8,3,2013,18,8674,1897,10571
3,15,8,3,2013,19,9055,1934,10989
3,15,8,3,2013,20,10441,2148,12589
3,15,8,3,2013,21,10479,2164,12643
3,15,8,3,2013,22,9881,2172,12053
3,15,8,3,2013,23,9906,2048,11954
3,15,8,3,2013,24,9437,1926,11363
1,16,8,3,2013,1,9328,1751,11079
1,16,8,3,2013,2,9267,1613,10880
1,16,8,3,2013,3,9404,1543,10947
1,16,8,3,2013,4,9532,1502,11034
1,16,8,3,2013,5,9783,1493,11276
1,16,8,3,2013,6,9843,1611,11454
1,16,8,3,2013,7,10301,1780,12081
1,16,8,3,2013,8,10902,1954,12856
1,16,8,3,2013,9,10972,2267,13239
1,16,8,3,2013,10,11540,2624,14164
1,16,8,3,2013,11,10863,2837,13700
1,16,8,3,2013,12,11155,2876,14031
1,16,8,3,2013,13,10892,2877,13769
1,16,8,3,2013,14,10675,2708,13383
1,16,8,3,2013,15,10555,2686,13241
1,16,8,3,2013,16,10681,2690,13371
1,16,8,3,2013,17,10428,2689,13117
1,16,8,3,2013,18,9758,2668,12426
1,16,8,3,2013,19,10810,2590,13400
1,16,8,3,2013,20,11475,2616,14091
1,16,8,3,2013,21,11497,2500,13997
1,16,8,3,2013,22,10970,2354,13324
1,16,8,3,2013,23,10706,2192,12898
1,16,8,3,2013,24,10781,2035,12816
2,17,8,3,2013,1,10218,1836,12054
2,17,8,3,2013,2,10062,1679,11741
2,17,8,3,2013,3,10229,1603,11832
2,17,8,3,2013,4,10085,1550,11635
2,17,8,3,2013,5,10396,1548,11944
2,17,8,3,2013,6,10844,1641,12485
2,17,8,3,2013,7,11375,1741,13116
2,17,8,3,2013,8,11626,1876,13502
2,17,8,3,2013,9,11816,2129,13945
2,17,8,3,2013,10,11730,2443,14173
2,17,8,3,2013,11,11786,2679,14465
2,17,8,3,2013,12,11843,2710,14553
2,17,8,3,2013,13,11558,2742,14300
2,17,8,3,2013,14,11121,2598,13719
2,17,8,3,2013,15,11252,2597,13849
2,17,8,3,2013,16,11325,2563,13888
2,17,8,3,2013,17,11099,2512,13611
2,17,8,3,2013,18,10596,2487,13083
2,17,8,3,2013,19,11046,2437,13483
2,17,8,3,2013,20,12034,2491,14525
2,17,8,3,2013,21,11882,2422,14304
2,17,8,3,2013,22,11723,2300,14023
2,17,8,3,2013,23,11225,2125,13350
2,17,8,3,2013,24,10910,1965,12875
2,18,8,3,2013,1,10427,1825,12252
2,18,8,3,2013,2,10144,1673,11817
2,18,8,3,2013,3,10424,1617,12041
2,18,8,3,2013,4,10342,1547,11889
2,18,8,3,2013,5,10649,1552,12201
2,18,8,3,2013,6,10730,1619,12349
2,18,8,3,2013,7,11141,1649,12790
2,18,8,3,2013,8,11522,1718,13240
2,18,8,3,2013,9,11595,1842,13437
2,18,8,3,2013,10,11855,1994,13849
2,18,8,3,2013,11,11810,2124,13934
2,18,8,3,2013,12,11568,2136,13704
2,18,8,3,2013,13,11261,2103,13364
2,18,8,3,2013,14,11055,2011,13066
2,18,8,3,2013,15,10987,1961,12948
2,18,8,3,2013,16,11113,1921,13034
2,18,8,3,2013,17,10831,1901,12732
2,18,8,3,2013,18,10045,1902,11947
2,18,8,3,2013,19,10649,1946,12595
2,18,8,3,2013,20,11455,2141,13596
2,18,8,3,2013,21,11265,2185,13450
2,18,8,3,2013,22,10986,2164,13150
2,18,8,3,2013,23,11087,2077,13164
2,18,8,3,2013,24,10611,1945,12556
1,19,8,3,2013,1,10266,1786,12052
1,19,8,3,2013,2,10392,1648,12040
1,19,8,3,2013,3,10426,1569,11995
1,19,8,3,2013,4,10318,1540,11858
1,19,8,3,2013,5,10541,1531,12072
1,19,8,3,2013,6,10947,1641,12588
1,19,8,3,2013,7,11459,1810,13269
1,19,8,3,2013,8,11567,1991,13558
1,19,8,3,2013,9,11649,2301,13950
1,19,8,3,2013,10,11872,2634,14506
1,19,8,3,2013,11,11658,2876,14534
1,19,8,3,2013,12,11617,2923,14540
1,19,8,3,2013,13,11378,2920,14298
1,19,8,3,2013,14,11166,2766,13932
1,19,8,3,2013,15,11057,2787,13844
1,19,8,3,2013,16,11247,2802,14049
1,19,8,3,2013,17,10976,2763,13739
1,19,8,3,2013,18,10218,2692,12910
1,19,8,3,2013,19,10788,2602,13390
1,19,8,3,2013,20,11469,2644,14113
1,19,8,3,2013,21,11669,2520,14189
1,19,8,3,2013,22,11415,2365,13780
1,19,8,3,2013,23,11211,2202,13413
1,19,8,3,2013,24,10828,2087,12915
1,20,8,3,2013,1,10571,1919,12490
1,20,8,3,2013,2,10509,1726,12235
1,20,8,3,2013,3,10311,1626,11937
1,20,8,3,2013,4,10220,1582,11802
1,20,8,3,2013,5,10479,1590,12069
1,20,8,3,2013,6,10981,1668,12649
1,20,8,3,2013,7,11388,1779,13167
1,20,8,3,2013,8,12070,1947,14017
1,20,8,3,2013,9,12125,2242,14367
1,20,8,3,2013,10,12148,2536,14684
1,20,8,3,2013,11,11929,2732,14661
1,20,8,3,2013,12,11612,2747,14359
1,20,8,3,2013,13,11348,2725,14073
1,20,8,3,2013,14,10613,2586,13199
1,20,8,3,2013,15,10873,2560,13433
1,20,8,3,2013,16,11204,2537,13741
1,20,8,3,2013,17,10687,2498,13185
1,20,8,3,2013,18,10070,2431,12501
1,20,8,3,2013,19,10373,2354,12727
1,20,8,3,2013,20,11238,2430,13668
1,20,8,3,2013,21,11294,2362,13656
1,20,8,3,2013,22,11019,2278,13297
1,20,8,3,2013,23,10789,2191,12980
1,20,8,3,2013,24,10580,2056,12636
1,21,8,3,2013,1,10311,1889,12200
1,21,8,3,2013,2,10446,1735,12181
1,21,8,3,2013,3,10473,1655,12128
1,21,8,3,2013,4,10283,1601,11884
1,21,8,3,2013,5,10464,1599,12063
1,21,8,3,2013,6,10716,1703,12419
1,21,8,3,2013,7,12000,1863,13863
1,21,8,3,2013,8,12196,2021,14217
1,21,8,3,2013,9,11827,2322,14149
1,21,8,3,2013,10,12209,2660,14869
1,21,8,3,2013,11,11930,2878,14808
1,21,8,3,2013,12,11754,2923,14677
1,21,8,3,2013,13,11404,2918,14322
1,21,8,3,2013,14,11112,2794,13906
1,21,8,3,2013,15,11313,2821,14134
1,21,8,3,2013,16,11435,2802,14237
1,21,8,3,2013,17,11348,2748,14096
1,21,8,3,2013,18,10728,2738,13466
1,21,8,3,2013,19,11029,2667,13696
1,21,8,3,2013,20,11361,2698,14059
1,21,8,3,2013,21,11461,2508,13969
1,21,8,3,2013,22,11063,2470,13533
1,21,8,3,2013,23,11084,2300,13384
1,21,8,3,2013,24,10754,2131,12885
1,22,8,3,2013,1,10476,1934,12410
1,22,8,3,2013,2,10418,1755,12173
1,22,8,3,2013,3,10489,1676,12165
1,22,8,3,2013,4,10345,1621,11966
1,22,8,3,2013,5,10371,1624,11995
1,22,8,3,2013,6,11069,1719,12788
1,22,8,3,2013,7,11825,1874,13699
1,22,8,3,2013,8,12185,2037,14222
1,22,8,3,2013,9,12301,2342,14643
1,22,8,3,2013,10,12269,2679,14948
1,22,8,3,2013,11,12154,2903,15057
1,22,8,3,2013,12,11623,2936,14559
1,22,8,3,2013,13,11631,2902,14533
1,22,8,3,2013,14,11360,2770,14130
1,22,8,3,2013,15,11375,2828,14203
1,22,8,3,2013,16,11722,2797,14519
1,22,8,3,2013,17,10958,2809,13767
1,22,8,3,2013,18,10485,2799,13284
1,22,8,3,2013,19,10910,2673,13583
1,22,8,3,2013,20,11542,2673,14215
1,22,8,3,2013,21,11597,2564,14161
1,22,8,3,2013,22,11196,2462,13658
1,22,8,3,2013,23,10960,2278,13238
1,22,8,3,2013,24,10941,2171,13112
1,23,8,3,2013,1,10658,1973,12631
1,23,8,3,2013,2,10679,1792,12471
1,23,8,3,2013,3,10462,1702,12164
1,23,8,3,2013,4,10440,1647,12087
1,23,8,3,2013,5,10670,1644,12314
1,23,8,3,2013,6,11203,1749,12952
1,23,8,3,2013,7,11952,1893,13845
1,23,8,3,2013,8,12143,2054,14197
1,23,8,3,2013,9,12033,2365,14398
1,23,8,3,2013,10,12167,2689,14856
1,23,8,3,2013,11,11825,2922,14747
1,23,8,3,2013,12,11620,2960,14580
1,23,8,3,2013,13,11090,2950,14040
1,23,8,3,2013,14,10874,2805,13679
1,23,8,3,2013,15,10849,2834,13683
1,23,8,3,2013,16,10981,2828,13809
1,23,8,3,2013,17,10763,2797,13560
1,23,8,3,2013,18,9955,2765,12720
1,23,8,3,2013,19,10509,2681,13190
1,23,8,3,2013,20,11206,2708,13914
1,23,8,3,2013,21,11220,2583,13803
1,23,8,3,2013,22,10809,2425,13234
1,23,8,3,2013,23,10713,2280,12993
1,23,8,3,2013,24,10549,2123,12672
2,24,8,3,2013,1,10430,1929,12359
2,24,8,3,2013,2,10115,1756,11871
2,24,8,3,2013,3,9969,1678,11647
2,24,8,3,2013,4,10120,1610,11730
2,24,8,3,2013,5,10506,1608,12114
2,24,8,3,2013,6,10795,1693,12488
2,24,8,3,2013,7,11081,1796,12877
2,24,8,3,2013,8,11729,1896,13625
2,24,8,3,2013,9,12100,2165,14265
2,24,8,3,2013,10,11748,2483,14231
2,24,8,3,2013,11,11832,2717,14549
2,24,8,3,2013,12,11899,2761,14660
2,24,8,3,2013,13,11527,2748,14275
2,24,8,3,2013,14,11288,2518,13806
2,24,8,3,2013,15,11219,2568,13787
2,24,8,3,2013,16,11410,2543,13953
2,24,8,3,2013,17,11174,2513,13687
2,24,8,3,2013,18,10628,2494,13122
2,24,8,3,2013,19,10768,2513,13281
2,24,8,3,2013,20,11137,2566,13703
2,24,8,3,2013,21,11197,2507,13704
2,24,8,3,2013,22,11056,2388,13444
2,24,8,3,2013,23,10761,2248,13009
2,24,8,3,2013,24,10978,2102,13080
2,25,8,3,2013,1,10506,1930,12436
2,25,8,3,2013,2,10621,1750,12371
2,25,8,3,2013,3,10474,1670,12144
2,25,8,3,2013,4,10408,1611,12019
2,25,8,3,2013,5,10399,1615,12014
2,25,8,3,2013,6,10803,1671,12474
2,25,8,3,2013,7,11044,1694,12738
2,25,8,3,2013,8,11855,1740,13595
2,25,8,3,2013,9,12159,1864,14023
2,25,8,3,2013,10,12038,2016,14054
2,25,8,3,2013,11,11771,2134,13905
2,25,8,3,2013,12,12022,2168,14190
2,25,8,3,2013,13,11503,2119,13622
2,25,8,3,2013,14,11168,2021,13189
2,25,8,3,2013,15,10711,1961,12672
2,25,8,3,2013,16,11138,1906,13044
2,25,8,3,2013,17,10314,1885,12199
2,25,8,3,2013,18,10228,1888,12116
2,25,8,3,2013,19,10711,1977,12688
2,25,8,3,2013,20,10994,2135,13129
2,25,8,3,2013,21,11100,2152,13252
2,25,8,3,2013,22,10773,2123,12896
2,25,8,3,2013,23,10398,2050,12448
2,25,8,3,2013,24,10244,1938,12182
1,26,8,3,2013,1,10044,1790,11834
1,26,8,3,2013,2,9894,1641,11535
1,26,8,3,2013,3,9711,1569,11280
1,26,8,3,2013,4,9949,1528,11477
1,26,8,3,2013,5,10073,1527,11600
1,26,8,3,2013,6,10570,1649,12219
1,26,8,3,2013,7,11530,1806,13336
1,26,8,3,2013,8,11760,1993,13753
1,26,8,3,2013,9,11799,2300,14099
1,26,8,3,2013,10,12080,2629,14709
1,26,8,3,2013,11,11956,2851,14807
1,26,8,3,2013,12,11710,2861,14571
1,26,8,3,2013,13,11487,2831,14318
1,26,8,3,2013,14,11376,2707,14083
1,26,8,3,2013,15,11412,2697,14109
1,26,8,3,2013,16,11574,2701,14275
1,26,8,3,2013,17,11329,2696,14025
1,26,8,3,2013,18,10267,2674,12941
1,26,8,3,2013,19,10816,2611,13427
1,26,8,3,2013,20,11397,2616,14013
1,26,8,3,2013,21,11466,2494,13960
1,26,8,3,2013,22,11309,2421,13730
1,26,8,3,2013,23,11118,2299,13417
1,26,8,3,2013,24,10779,2030,12809
1,27,8,3,2013,1,10532,1856,12388
1,27,8,3,2013,2,10451,1707,12158
1,27,8,3,2013,3,10329,1624,11953
1,27,8,3,2013,4,10072,1580,11652
1,27,8,3,2013,5,10369,1559,11928
1,27,8,3,2013,6,10949,1671,12620
1,27,8,3,2013,7,11620,1861,13481
1,27,8,3,2013,8,12342,2036,14378
1,27,8,3,2013,9,12655,2338,14993
1,27,8,3,2013,10,12646,2684,15330
1,27,8,3,2013,11,12616,2908,15524
1,27,8,3,2013,12,12367,2941,15308
1,27,8,3,2013,13,11970,2918,14888
1,27,8,3,2013,14,11814,2798,14612
1,27,8,3,2013,15,11834,2829,14663
1,27,8,3,2013,16,12057,2823,14880
1,27,8,3,2013,17,11632,2810,14442
1,27,8,3,2013,18,10735,2752,13487
1,27,8,3,2013,19,11063,2676,13739
1,27,8,3,2013,20,11900,2713,14613
1,27,8,3,2013,21,11928,2578,14506
1,27,8,3,2013,22,11511,2488,13999
1,27,8,3,2013,23,11542,2310,13852
1,27,8,3,2013,24,11295,2121,13416
1,28,8,3,2013,1,10929,1917,12846
1,28,8,3,2013,2,10549,1756,12305
1,28,8,3,2013,3,10745,1678,12423
1,28,8,3,2013,4,10663,1610,12273
1,28,8,3,2013,5,10867,1613,12480
1,28,8,3,2013,6,11292,1709,13001
1,28,8,3,2013,7,11937,1870,13807
1,28,8,3,2013,8,12464,2039,14503
1,28,8,3,2013,9,12698,2352,15050
1,28,8,3,2013,10,13079,2675,15754
1,28,8,3,2013,11,12952,2895,15847
1,28,8,3,2013,12,13266,2927,16193
1,28,8,3,2013,13,12561,2903,15464
1,28,8,3,2013,14,12290,2804,15094
1,28,8,3,2013,15,12346,2783,15129
1,28,8,3,2013,16,12252,2803,15055
1,28,8,3,2013,17,11989,2773,14762
1,28,8,3,2013,18,10755,2707,13462
1,28,8,3,2013,19,11008,2634,13642
1,28,8,3,2013,20,11800,2694,14494
1,28,8,3,2013,21,11975,2594,14569
1,28,8,3,2013,22,11821,2444,14265
1,28,8,3,2013,23,11664,2298,13962
1,28,8,3,2013,24,11308,2134,13442
1,29,8,3,2013,1,11367,1937,13304
1,29,8,3,2013,2,11123,1781,12904
1,29,8,3,2013,3,10922,1679,12601
1,29,8,3,2013,4,10896,1622,12518
1,29,8,3,2013,5,11077,1624,12701
1,29,8,3,2013,6,11736,1680,13416
1,29,8,3,2013,7,12199,1748,13947
1,29,8,3,2013,8,12935,1912,14847
1,29,8,3,2013,9,12936,2204,15140
1,29,8,3,2013,10,12825,2510,15335
1,29,8,3,2013,11,12794,2709,15503
1,29,8,3,2013,12,12716,2721,15437
1,29,8,3,2013,13,12344,2708,15052
1,29,8,3,2013,14,11980,2570,14550
1,29,8,3,2013,15,12258,2551,14809
1,29,8,3,2013,16,12143,2518,14661
1,29,8,3,2013,17,11739,2461,14200
1,29,8,3,2013,18,10701,2373,13074
1,29,8,3,2013,19,11127,2318,13445
1,29,8,3,2013,20,12063,2394,14457
1,29,8,3,2013,21,11786,2451,14237
1,29,8,3,2013,22,11649,2315,13964
1,29,8,3,2013,23,11553,2176,13729
1,29,8,3,2013,24,11390,2033,13423
1,30,8,3,2013,1,11178,1903,13081
1,30,8,3,2013,2,11044,1716,12760
1,30,8,3,2013,3,11069,1627,12696
1,30,8,3,2013,4,11139,1590,12729
1,30,8,3,2013,5,11426,1588,13014
1,30,8,3,2013,6,11815,1697,13512
1,30,8,3,2013,7,12337,1838,14175
1,30,8,3,2013,8,12699,2017,14716
1,30,8,3,2013,9,12873,2324,15197
1,30,8,3,2013,10,12757,2677,15434
1,30,8,3,2013,11,12687,2915,15602
1,30,8,3,2013,12,12690,2985,15675
1,30,8,3,2013,13,12270,2969,15239
1,30,8,3,2013,14,12240,2841,15081
1,30,8,3,2013,15,12114,2872,14986
1,30,8,3,2013,16,12373,2868,15241
1,30,8,3,2013,17,11840,2881,14721
1,30,8,3,2013,18,10791,2799,13590
1,30,8,3,2013,19,11104,2715,13819
1,30,8,3,2013,20,12023,2740,14763
1,30,8,3,2013,21,12076,2612,14688
1,30,8,3,2013,22,11772,2478,14250
1,30,8,3,2013,23,11708,2316,14024
1,30,8,3,2013,24,11602,2142,13744
2,31,8,3,2013,1,11454,1972,13426
2,31,8,3,2013,2,11342,1787,13129
2,31,8,3,2013,3,11357,1700,13057
2,31,8,3,2013,4,11382,1647,13029
2,31,8,3,2013,5,11619,1631,13250
2,31,8,3,2013,6,11933,1721,13654
2,31,8,3,2013,7,12438,1808,14246
2,31,8,3,2013,8,12755,1917,14672
2,31,8,3,2013,9,13160,2169,15329
2,31,8,3,2013,10,13371,2498,15869
2,31,8,3,2013,11,13379,2713,16092
2,31,8,3,2013,12,13345,2751,16096
2,31,8,3,2013,13,13239,2729,15968
2,31,8,3,2013,14,12964,2630,15594
2,31,8,3,2013,15,12840,2623,15463
2,31,8,3,2013,16,13025,2616,15641
2,31,8,3,2013,17,12621,2589,15210
2,31,8,3,2013,18,11219,2537,13756
2,31,8,3,2013,19,11475,2510,13985
2,31,8,3,2013,20,12380,2588,14968
2,31,8,3,2013,21,12189,2547,14736
2,31,8,3,2013,22,12071,2416,14487
2,31,8,3,2013,23,11903,2287,14190
2,31,8,3,2013,24,11765,2166,13931
2,1,9,3,2013,1,11862,1923,13785
2,1,9,3,2013,2,11627,1765,13392
2,1,9,3,2013,3,11680,1677,13357
2,1,9,3,2013,4,11659,1616,13275
2,1,9,3,2013,5,11601,1608,13209
2,1,9,3,2013,6,12035,1675,13710
2,1,9,3,2013,7,12088,1685,13773
2,1,9,3,2013,8,12590,1729,14319
2,1,9,3,2013,9,12909,1846,14755
2,1,9,3,2013,10,13407,2012,15419
2,1,9,3,2013,11,13649,2145,15794
2,1,9,3,2013,12,13382,2185,15567
2,1,9,3,2013,13,13210,2178,15388
2,1,9,3,2013,14,12880,2081,14961
2,1,9,3,2013,15,12972,2067,15039
2,1,9,3,2013,16,13136,2036,15172
2,1,9,3,2013,17,12485,2012,14497
2,1,9,3,2013,18,11385,2005,13390
2,1,9,3,2013,19,11308,2037,13345
2,1,9,3,2013,20,11966,2208,14174
2,1,9,3,2013,21,12352,2277,14629
2,1,9,3,2013,22,12167,2243,14410
2,1,9,3,2013,23,12494,2186,14680
2,1,9,3,2013,24,12368,2033,14401
1,2,9,3,2013,1,11752,1930,13682
1,2,9,3,2013,2,11734,1750,13484
1,2,9,3,2013,3,11741,1663,13404
1,2,9,3,2013,4,11528,1608,13136
1,2,9,3,2013,5,11682,1607,13289
1,2,9,3,2013,6,12308,1713,14021
1,2,9,3,2013,7,12586,1868,14454
1,2,9,3,2013,8,12973,2032,15005
1,2,9,3,2013,9,12984,2344,15328
1,2,9,3,2013,10,13154,2676,15830
1,2,9,3,2013,11,13344,2887,16231
1,2,9,3,2013,12,13943,2956,16899
1,2,9,3,2013,13,14172,2960,17132
1,2,9,3,2013,14,13701,2829,16530
1,2,9,3,2013,15,13906,2856,16762
1,2,9,3,2013,16,13753,2882,16635
1,2,9,3,2013,17,13004,2861,15865
1,2,9,3,2013,18,11935,2803,14738
1,2,9,3,2013,19,11809,2653,14462
1,2,9,3,2013,20,12770,2697,15467
1,2,9,3,2013,21,12710,2573,15283
1,2,9,3,2013,22,12487,2480,14967
1,2,9,3,2013,23,12601,2361,14962
1,2,9,3,2013,24,12509,2196,14705
1,3,9,3,2013,1,12429,1972,14401
1,3,9,3,2013,2,12285,1828,14113
1,3,9,3,2013,3,11935,1744,13679
1,3,9,3,2013,4,12065,1668,13733
1,3,9,3,2013,5,12385,1667,14052
1,3,9,3,2013,6,12853,1767,14620
1,3,9,3,2013,7,13315,1921,15236
1,3,9,3,2013,8,13669,2106,15775
1,3,9,3,2013,9,13716,2383,16099
1,3,9,3,2013,10,13855,2714,16569
1,3,9,3,2013,11,14002,2897,16899
1,3,9,3,2013,12,13827,2964,16791
1,3,9,3,2013,13,13926,2957,16883
1,3,9,3,2013,14,13751,2832,16583
1,3,9,3,2013,15,13793,2866,16659
1,3,9,3,2013,16,13741,2875,16616
1,3,9,3,2013,17,13328,2874,16202
1,3,9,3,2013,18,11942,2802,14744
1,3,9,3,2013,19,12026,2711,14737
1,3,9,3,2013,20,12776,2744,15520
1,3,9,3,2013,21,12867,2670,15537
1,3,9,3,2013,22,12393,2512,14905
1,3,9,3,2013,23,12674,2387,15061
1,3,9,3,2013,24,12373,2269,14642
1,4,9,3,2013,1,12461,1994,14455
1,4,9,3,2013,2,12493,1841,14334
1,4,9,3,2013,3,12343,1744,14087
1,4,9,3,2013,4,12086,1695,13781
1,4,9,3,2013,5,12423,1687,14110
1,4,9,3,2013,6,13053,1767,14820
1,4,9,3,2013,7,13353,1912,15265
1,4,9,3,2013,8,13968,2062,16030
1,4,9,3,2013,9,14215,2369,16584
1,4,9,3,2013,10,14457,2707,17164
1,4,9,3,2013,11,14461,2928,17389
1,4,9,3,2013,12,14479,2957,17436
1,4,9,3,2013,13,14210,2942,17152
1,4,9,3,2013,14,14174,2872,17046
1,4,9,3,2013,15,14006,2903,16909
1,4,9,3,2013,16,13926,2925,16851
1,4,9,3,2013,17,13277,2887,16164
1,4,9,3,2013,18,12579,2809,15388
1,4,9,3,2013,19,12184,2717,14901
1,4,9,3,2013,20,13098,2750,15848
1,4,9,3,2013,21,12999,2656,15655
1,4,9,3,2013,22,12860,2448,15308
1,4,9,3,2013,23,12850,2306,15156
1,4,9,3,2013,24,12606,2174,14780
1,6,9,3,2013,1,12134,1994,14128
1,6,9,3,2013,2,12054,1822,13876
1,6,9,3,2013,3,12078,1734,13812
1,6,9,3,2013,4,11930,1679,13609
1,6,9,3,2013,5,12293,1680,13973
1,6,9,3,2013,6,12865,1772,14637
1,6,9,3,2013,7,13074,1907,14981
1,6,9,3,2013,8,13597,2077,15674
1,6,9,3,2013,9,13649,2385,16034
1,6,9,3,2013,10,13799,2704,16503
1,6,9,3,2013,11,13790,2949,16739
1,6,9,3,2013,12,13847,2978,16825
1,6,9,3,2013,13,13485,2993,16478
1,6,9,3,2013,14,13261,2839,16100
1,6,9,3,2013,15,13461,2890,16351
1,6,9,3,2013,16,13501,2907,16408
1,6,9,3,2013,17,12877,2892,15769
1,6,9,3,2013,18,11838,2828,14666
1,6,9,3,2013,19,11692,2724,14416
1,6,9,3,2013,20,12407,2743,15150
1,6,9,3,2013,21,12632,2625,15257
1,6,9,3,2013,22,12281,2504,14785
1,6,9,3,2013,23,12174,2380,14554
1,6,9,3,2013,24,12197,2232,14429
2,7,9,3,2013,1,12414,2050,14464
2,7,9,3,2013,2,12458,1859,14317
2,7,9,3,2013,3,12313,1757,14070
2,7,9,3,2013,4,12164,1715,13879
2,7,9,3,2013,5,12388,1682,14070
2,7,9,3,2013,6,13007,1743,14750
2,7,9,3,2013,7,13566,1797,15363
2,7,9,3,2013,8,13762,1946,15708
2,7,9,3,2013,9,13997,2228,16225
2,7,9,3,2013,10,14171,2531,16702
2,7,9,3,2013,11,14373,2725,17098
2,7,9,3,2013,12,14419,2803,17222
2,7,9,3,2013,13,14182,2795,16977
2,7,9,3,2013,14,14206,2660,16866
2,7,9,3,2013,15,14209,2659,16868
2,7,9,3,2013,16,14510,2637,17147
2,7,9,3,2013,17,13900,2608,16508
2,7,9,3,2013,18,12449,2531,14980
2,7,9,3,2013,19,12384,2484,14868
2,7,9,3,2013,20,12865,2586,15451
2,7,9,3,2013,21,13041,2526,15567
2,7,9,3,2013,22,12731,2431,15162
2,7,9,3,2013,23,12697,2313,15010
2,7,9,3,2013,24,12813,2150,14963
2,8,9,3,2013,1,12932,2025,14957
2,8,9,3,2013,2,12714,1830,14544
2,8,9,3,2013,3,12764,1738,14502
2,8,9,3,2013,4,12918,1677,14595
2,8,9,3,2013,5,12904,1664,14568
2,8,9,3,2013,6,13439,1718,15157
2,8,9,3,2013,7,13370,1737,15107
2,8,9,3,2013,8,13845,1767,15612
2,8,9,3,2013,9,14122,1885,16007
2,8,9,3,2013,10,14572,2039,16611
2,8,9,3,2013,11,14716,2147,16863
2,8,9,3,2013,12,14773,2135,16908
2,8,9,3,2013,13,14652,2116,16768
2,8,9,3,2013,14,14258,2051,16309
2,8,9,3,2013,15,14184,2002,16186
2,8,9,3,2013,16,14090,1967,16057
2,8,9,3,2013,17,13565,1973,15538
2,8,9,3,2013,18,12246,1981,14227
2,8,9,3,2013,19,12256,1977,14233
2,8,9,3,2013,20,12335,2295,14630
2,8,9,3,2013,21,12263,2337,14600
2,8,9,3,2013,22,12215,2269,14484
2,8,9,3,2013,23,12103,2150,14253
2,8,9,3,2013,24,12126,2053,14179
3,9,9,3,2013,1,12192,2000,14192
3,9,9,3,2013,2,11958,1847,13805
3,9,9,3,2013,3,11790,1751,13541
3,9,9,3,2013,4,11798,1683,13481
3,9,9,3,2013,5,11844,1676,13520
3,9,9,3,2013,6,12195,1747,13942
3,9,9,3,2013,7,12538,1785,14323
3,9,9,3,2013,8,12566,1831,14397
3,9,9,3,2013,9,12792,1916,14708
3,9,9,3,2013,10,12224,2015,14239
3,9,9,3,2013,11,12267,2082,14349
3,9,9,3,2013,12,12336,2079,14415
3,9,9,3,2013,13,12220,2085,14305
3,9,9,3,2013,14,12062,2028,14090
3,9,9,3,2013,15,11875,2010,13885
3,9,9,3,2013,16,11900,1994,13894
3,9,9,3,2013,17,11305,1969,13274
3,9,9,3,2013,18,10694,1947,12641
3,9,9,3,2013,19,11350,2083,13433
3,9,9,3,2013,20,12095,2321,14416
3,9,9,3,2013,21,11831,2338,14169
3,9,9,3,2013,22,11452,2270,13722
3,9,9,3,2013,23,11387,2183,13570
3,9,9,3,2013,24,11070,2060,13130
1,10,9,3,2013,1,11081,1869,12950
1,10,9,3,2013,2,10851,1721,12572
1,10,9,3,2013,3,10524,1652,12176
1,10,9,3,2013,4,10732,1612,12344
1,10,9,3,2013,5,10932,1634,12566
1,10,9,3,2013,6,11683,1739,13422
1,10,9,3,2013,7,12239,1864,14103
1,10,9,3,2013,8,12876,2011,14887
1,10,9,3,2013,9,13071,2268,15339
1,10,9,3,2013,10,13244,2583,15827
1,10,9,3,2013,11,13333,2918,16251
1,10,9,3,2013,12,13483,2935,16418
1,10,9,3,2013,13,13103,2925,16028
1,10,9,3,2013,14,13000,2824,15824
1,10,9,3,2013,15,12612,2860,15472
1,10,9,3,2013,16,12516,2858,15374
1,10,9,3,2013,17,12023,2819,14842
1,10,9,3,2013,18,11776,2808,14584
1,10,9,3,2013,19,12192,2819,15011
1,10,9,3,2013,20,12736,2775,15511
1,10,9,3,2013,21,12163,2631,14794
1,10,9,3,2013,22,11675,2473,14148
1,10,9,3,2013,23,11517,2334,13851
1,10,9,3,2013,24,10967,2247,13214
1,11,9,3,2013,1,10797,2011,12808
1,11,9,3,2013,2,10558,1838,12396
1,11,9,3,2013,3,10514,1767,12281
1,11,9,3,2013,4,10758,1698,12456
1,11,9,3,2013,5,10941,1697,12638
1,11,9,3,2013,6,11543,1767,13310
1,11,9,3,2013,7,12063,1851,13914
1,11,9,3,2013,8,12604,2010,14614
1,11,9,3,2013,9,12723,2316,15039
1,11,9,3,2013,10,12754,2635,15389
1,11,9,3,2013,11,12792,2854,15646
1,11,9,3,2013,12,12823,2934,15757
1,11,9,3,2013,13,12692,2958,15650
1,11,9,3,2013,14,12596,2881,15477
1,11,9,3,2013,15,12494,2880,15374
1,11,9,3,2013,16,12468,2924,15392
1,11,9,3,2013,17,12140,2897,15037
1,11,9,3,2013,18,11963,2892,14855
1,11,9,3,2013,19,12338,2848,15186
1,11,9,3,2013,20,13033,2727,15760
1,11,9,3,2013,21,12815,2632,15447
1,11,9,3,2013,22,12398,2463,14861
1,11,9,3,2013,23,12066,2325,14391
1,11,9,3,2013,24,11612,2184,13796
1,12,9,3,2013,1,11386,1996,13382
1,12,9,3,2013,2,11029,1869,12898
1,12,9,3,2013,3,11003,1745,12748
1,12,9,3,2013,4,10965,1668,12633
1,12,9,3,2013,5,11254,1668,12922
1,12,9,3,2013,6,11942,1752,13694
1,12,9,3,2013,7,12401,1842,14243
1,12,9,3,2013,8,12938,1966,14904
1,12,9,3,2013,9,13086,2268,15354
1,12,9,3,2013,10,12930,2659,15589
1,12,9,3,2013,11,12813,2961,15774
1,12,9,3,2013,12,13150,2983,16133
1,12,9,3,2013,13,12737,2979,15716
1,12,9,3,2013,14,12701,2880,15581
1,12,9,3,2013,15,12543,2904,15447
1,12,9,3,2013,16,12487,2912,15399
1,12,9,3,2013,17,11921,2885,14806
1,12,9,3,2013,18,11743,2893,14636
1,12,9,3,2013,19,12160,2837,14997
1,12,9,3,2013,20,12651,2827,15478
1,12,9,3,2013,21,12456,2633,15089
1,12,9,3,2013,22,12157,2474,14631
1,12,9,3,2013,23,11879,2331,14210
1,12,9,3,2013,24,11554,2262,13816
1,13,9,3,2013,1,11355,2028,13383
1,13,9,3,2013,2,11246,1846,13092
1,13,9,3,2013,3,11098,1752,12850
1,13,9,3,2013,4,11196,1692,12888
1,13,9,3,2013,5,11267,1692,12959
1,13,9,3,2013,6,11740,1801,13541
1,13,9,3,2013,7,12374,1897,14271
1,13,9,3,2013,8,12573,2039,14612
1,13,9,3,2013,9,12524,2335,14859
1,13,9,3,2013,10,12611,2718,15329
1,13,9,3,2013,11,12501,2962,15463
1,13,9,3,2013,12,12301,3001,15302
1,13,9,3,2013,13,12272,2999,15271
1,13,9,3,2013,14,12047,2898,14945
1,13,9,3,2013,15,11944,2961,14905
1,13,9,3,2013,16,11792,2978,14770
1,13,9,3,2013,17,11392,2934,14326
1,13,9,3,2013,18,11155,2948,14103
1,13,9,3,2013,19,11990,2814,14804
1,13,9,3,2013,20,12482,2811,15293
1,13,9,3,2013,21,12518,2709,15227
1,13,9,3,2013,22,12097,2561,14658
1,13,9,3,2013,23,11610,2454,14064
1,13,9,3,2013,24,11128,2310,13438
2,14,9,3,2013,1,10962,2132,13094
2,14,9,3,2013,2,10893,1939,12832
2,14,9,3,2013,3,10755,1827,12582
2,14,9,3,2013,4,10870,1753,12623
2,14,9,3,2013,5,10905,1737,12642
2,14,9,3,2013,6,11324,1813,13137
2,14,9,3,2013,7,11680,1868,13548
2,14,9,3,2013,8,12336,1948,14284
2,14,9,3,2013,9,12351,2171,14522
2,14,9,3,2013,10,12407,2509,14916
2,14,9,3,2013,11,12259,2829,15088
2,14,9,3,2013,12,12481,2909,15390
2,14,9,3,2013,13,12551,2866,15417
2,14,9,3,2013,14,12079,2767,14846
2,14,9,3,2013,15,12122,2778,14900
2,14,9,3,2013,16,12047,2776,14823
2,14,9,3,2013,17,11595,2725,14320
2,14,9,3,2013,18,11142,2661,13803
2,14,9,3,2013,19,11927,2650,14577
2,14,9,3,2013,20,12682,2819,15501
2,14,9,3,2013,21,12100,2680,14780
2,14,9,3,2013,22,11681,2533,14214
2,14,9,3,2013,23,11442,2387,13829
2,14,9,3,2013,24,11020,2249,13269
2,15,9,3,2013,1,10993,2108,13101
2,15,9,3,2013,2,10745,1887,12632
2,15,9,3,2013,3,10946,1812,12758
2,15,9,3,2013,4,10998,1769,12767
2,15,9,3,2013,5,11038,1746,12784
2,15,9,3,2013,6,11451,1807,13258
2,15,9,3,2013,7,11965,1814,13779
2,15,9,3,2013,8,11953,1819,13772
2,15,9,3,2013,9,11974,1912,13886
2,15,9,3,2013,10,12012,2067,14079
2,15,9,3,2013,11,12244,2200,14444
2,15,9,3,2013,12,12099,2238,14337
2,15,9,3,2013,13,12078,2234,14312
2,15,9,3,2013,14,12088,2173,14261
2,15,9,3,2013,15,11787,2155,13942
2,15,9,3,2013,16,11711,2134,13845
2,15,9,3,2013,17,11372,2086,13458
2,15,9,3,2013,18,11306,2073,13379
2,15,9,3,2013,19,11487,2223,13710
2,15,9,3,2013,20,11893,2352,14245
2,15,9,3,2013,21,11298,2321,13619
2,15,9,3,2013,22,11063,2223,13286
2,15,9,3,2013,23,10995,2168,13163
2,15,9,3,2013,24,10559,2075,12634
1,16,9,3,2013,1,10468,1911,12379
1,16,9,3,2013,2,9935,1749,11684
1,16,9,3,2013,3,9848,1665,11513
1,16,9,3,2013,4,9822,1603,11425
1,16,9,3,2013,5,10022,1607,11629
1,16,9,3,2013,6,10730,1721,12451
1,16,9,3,2013,7,11051,1848,12899
1,16,9,3,2013,8,11489,2002,13491
1,16,9,3,2013,9,11477,2271,13748
1,16,9,3,2013,10,11479,2644,14123
1,16,9,3,2013,11,11300,2911,14211
1,16,9,3,2013,12,11527,2943,14470
1,16,9,3,2013,13,11092,2940,14032
1,16,9,3,2013,14,10927,2834,13761
1,16,9,3,2013,15,11206,2862,14068
1,16,9,3,2013,16,11028,2879,13907
1,16,9,3,2013,17,10966,2851,13817
1,16,9,3,2013,18,10988,2784,13772
1,16,9,3,2013,19,11968,2741,14709
1,16,9,3,2013,20,12541,2805,15346
1,16,9,3,2013,21,12173,2713,14886
1,16,9,3,2013,22,11860,2520,14380
1,16,9,3,2013,23,11590,2402,13992
1,16,9,3,2013,24,11051,2288,13339
1,17,9,3,2013,1,10755,2069,12824
1,17,9,3,2013,2,10513,1897,12410
1,17,9,3,2013,3,10336,1793,12129
1,17,9,3,2013,4,9927,1736,11663
1,17,9,3,2013,5,10422,1719,12141
1,17,9,3,2013,6,10944,1827,12771
1,17,9,3,2013,7,11136,1942,13078
1,17,9,3,2013,8,11256,2078,13334
1,17,9,3,2013,9,11145,2319,13464
1,17,9,3,2013,10,11283,2606,13889
1,17,9,3,2013,11,11072,2818,13890
1,17,9,3,2013,12,11054,2839,13893
1,17,9,3,2013,13,10875,2812,13687
1,17,9,3,2013,14,10825,2754,13579
1,17,9,3,2013,15,10807,2786,13593
1,17,9,3,2013,16,10966,2778,13744
1,17,9,3,2013,17,10942,2756,13698
1,17,9,3,2013,18,10747,2722,13469
1,17,9,3,2013,19,11687,2732,14419
1,17,9,3,2013,20,12526,2796,15322
1,17,9,3,2013,21,12123,2674,14797
1,17,9,3,2013,22,11817,2498,14315
1,17,9,3,2013,23,11438,2347,13785
1,17,9,3,2013,24,10897,2175,13072
1,18,9,3,2013,1,10461,2069,12530
1,18,9,3,2013,2,10264,1906,12170
1,18,9,3,2013,3,10125,1803,11928
1,18,9,3,2013,4,10158,1726,11884
1,18,9,3,2013,5,10084,1706,11790
1,18,9,3,2013,6,10601,1772,12373
1,18,9,3,2013,7,11031,1853,12884
1,18,9,3,2013,8,10735,1973,12708
1,18,9,3,2013,9,11072,2255,13327
1,18,9,3,2013,10,11319,2574,13893
1,18,9,3,2013,11,11055,2759,13814
1,18,9,3,2013,12,10783,2794,13577
1,18,9,3,2013,13,10283,2777,13060
1,18,9,3,2013,14,10439,2638,13077
1,18,9,3,2013,15,10218,2566,12784
1,18,9,3,2013,16,10162,2430,12592
1,18,9,3,2013,17,10106,2297,12403
1,18,9,3,2013,18,9827,2173,12000
1,18,9,3,2013,19,10772,2175,12947
1,18,9,3,2013,20,11326,2271,13597
1,18,9,3,2013,21,10854,2338,13192
1,18,9,3,2013,22,10347,2250,12597
1,18,9,3,2013,23,10045,2209,12254
1,18,9,3,2013,24,9772,2114,11886
1,19,9,3,2013,1,9273,1968,11241
1,19,9,3,2013,2,9026,1793,10819
1,19,9,3,2013,3,9002,1732,10734
1,19,9,3,2013,4,9024,1721,10745
1,19,9,3,2013,5,9319,1684,11003
1,19,9,3,2013,6,9652,1798,11450
1,19,9,3,2013,7,10444,1810,12254
1,19,9,3,2013,8,10734,1927,12661
1,19,9,3,2013,9,10739,2165,12904
1,19,9,3,2013,10,11061,2454,13515
1,19,9,3,2013,11,10948,2715,13663
1,19,9,3,2013,12,10686,2838,13524
1,19,9,3,2013,13,10519,2826,13345
1,19,9,3,2013,14,10155,2684,12839
1,19,9,3,2013,15,10353,2699,13052
1,19,9,3,2013,16,10356,2695,13051
1,19,9,3,2013,17,10423,2707,13130
1,19,9,3,2013,18,10515,2725,13240
1,19,9,3,2013,19,11525,2732,14257
1,19,9,3,2013,20,11825,2708,14533
1,19,9,3,2013,21,11633,2552,14185
1,19,9,3,2013,22,11233,2395,13628
1,19,9,3,2013,23,10866,2253,13119
1,19,9,3,2013,24,10217,2087,12304
1,20,9,3,2013,1,10151,1858,12009
1,20,9,3,2013,2,9843,1704,11547
1,20,9,3,2013,3,9566,1634,11200
1,20,9,3,2013,4,9762,1589,11351
1,20,9,3,2013,5,10065,1581,11646
1,20,9,3,2013,6,10551,1706,12257
1,20,9,3,2013,7,10804,1830,12634
1,20,9,3,2013,8,10642,2003,12645
1,20,9,3,2013,9,10733,2290,13023
1,20,9,3,2013,10,10924,2621,13545
1,20,9,3,2013,11,10511,2849,13360
1,20,9,3,2013,12,10289,2952,13241
1,20,9,3,2013,13,9826,2945,12771
1,20,9,3,2013,14,9845,2855,12700
1,20,9,3,2013,15,9744,2902,12646
1,20,9,3,2013,16,9728,2913,12641
1,20,9,3,2013,17,9944,2898,12842
1,20,9,3,2013,18,10071,2818,12889
1,20,9,3,2013,19,10901,2754,13655
1,20,9,3,2013,20,11578,2721,14299
1,20,9,3,2013,21,11543,2636,14179
1,20,9,3,2013,22,11062,2484,13546
1,20,9,3,2013,23,10578,2345,12923
1,20,9,3,2013,24,10159,2213,12372
2,21,9,3,2013,1,9767,2011,11778
2,21,9,3,2013,2,9645,1793,11438
2,21,9,3,2013,3,9622,1701,11323
2,21,9,3,2013,4,9418,1637,11055
2,21,9,3,2013,5,9339,1627,10966
2,21,9,3,2013,6,9800,1723,11523
2,21,9,3,2013,7,10377,1842,12219
2,21,9,3,2013,8,10742,1948,12690
2,21,9,3,2013,9,10727,2218,12945
2,21,9,3,2013,10,10509,2536,13045
2,21,9,3,2013,11,10440,2787,13227
2,21,9,3,2013,12,10270,2848,13118
2,21,9,3,2013,13,9896,2840,12736
2,21,9,3,2013,14,9655,2664,12319
2,21,9,3,2013,15,9690,2683,12373
2,21,9,3,2013,16,10210,2699,12909
2,21,9,3,2013,17,9769,2655,12424
2,21,9,3,2013,18,10047,2598,12645
2,21,9,3,2013,19,11021,2622,13643
2,21,9,3,2013,20,11617,2679,14296
2,21,9,3,2013,21,11501,2560,14061
2,21,9,3,2013,22,10921,2440,13361
2,21,9,3,2013,23,10794,2232,13026
2,21,9,3,2013,24,10136,2142,12278
2,22,9,3,2013,1,9852,2013,11865
2,22,9,3,2013,2,9621,1846,11467
2,22,9,3,2013,3,9702,1738,11440
2,22,9,3,2013,4,9497,1667,11164
2,22,9,3,2013,5,9609,1659,11268
2,22,9,3,2013,6,10129,1703,11832
2,22,9,3,2013,7,10204,1719,11923
2,22,9,3,2013,8,10563,1757,12320
2,22,9,3,2013,9,10907,1876,12783
2,22,9,3,2013,10,10628,2028,12656
2,22,9,3,2013,11,10240,2174,12414
2,22,9,3,2013,12,10265,2223,12488
2,22,9,3,2013,13,9844,2208,12052
2,22,9,3,2013,14,9628,2130,11758
2,22,9,3,2013,15,9488,2106,11594
2,22,9,3,2013,16,9857,2060,11917
2,22,9,3,2013,17,10105,2030,12135
2,22,9,3,2013,18,9978,2022,12000
2,22,9,3,2013,19,10883,2123,13006
2,22,9,3,2013,20,11329,2256,13585
2,22,9,3,2013,21,11154,2258,13412
2,22,9,3,2013,22,10672,2246,12918
2,22,9,3,2013,23,10590,2214,12804
2,22,9,3,2013,24,10061,2157,12218
1,23,9,3,2013,1,9739,1903,11642
1,23,9,3,2013,2,9409,1766,11175
1,23,9,3,2013,3,9343,1702,11045
1,23,9,3,2013,4,9504,1659,11163
1,23,9,3,2013,5,9649,1621,11270
1,23,9,3,2013,6,10221,1745,11966
1,23,9,3,2013,7,10532,1966,12498
1,23,9,3,2013,8,10806,2042,12848
1,23,9,3,2013,9,10921,2327,13248
1,23,9,3,2013,10,10729,2656,13385
1,23,9,3,2013,11,10708,2963,13671
1,23,9,3,2013,12,10347,2985,13332
1,23,9,3,2013,13,9976,2965,12941
1,23,9,3,2013,14,9753,2849,12602
1,23,9,3,2013,15,9668,2852,12520
1,23,9,3,2013,16,10001,2851,12852
1,23,9,3,2013,17,9848,2816,12664
1,23,9,3,2013,18,10071,2780,12851
1,23,9,3,2013,19,11345,2770,14115
1,23,9,3,2013,20,11650,2750,14400
1,23,9,3,2013,21,11637,2637,14274
1,23,9,3,2013,22,11227,2447,13674
1,23,9,3,2013,23,10907,2318,13225
1,23,9,3,2013,24,10611,2164,12775
1,24,9,3,2013,1,10392,1993,12385
1,24,9,3,2013,2,10152,1806,11958
1,24,9,3,2013,3,10175,1718,11893
1,24,9,3,2013,4,10040,1644,11684
1,24,9,3,2013,5,10139,1660,11799
1,24,9,3,2013,6,10682,1758,12440
1,24,9,3,2013,7,11137,1908,13045
1,24,9,3,2013,8,11489,2026,13515
1,24,9,3,2013,9,11473,2320,13793
1,24,9,3,2013,10,11451,2641,14092
1,24,9,3,2013,11,11220,2867,14087
1,24,9,3,2013,12,11043,2899,13942
1,24,9,3,2013,13,10629,2862,13491
1,24,9,3,2013,14,10379,2723,13102
1,24,9,3,2013,15,10452,2741,13193
1,24,9,3,2013,16,10611,2753,13364
1,24,9,3,2013,17,10626,2737,13363
1,24,9,3,2013,18,11183,2718,13901
1,24,9,3,2013,19,11862,2749,14611
1,24,9,3,2013,20,12052,2764,14816
1,24,9,3,2013,21,11923,2577,14500
1,24,9,3,2013,22,11462,2428,13890
1,24,9,3,2013,23,11215,2258,13473
1,24,9,3,2013,24,10744,2084,12828
1,25,9,3,2013,1,10644,1881,12525
1,25,9,3,2013,2,10558,1719,12277
1,25,9,3,2013,3,10266,1652,11918
1,25,9,3,2013,4,10001,1594,11595
1,25,9,3,2013,5,10080,1604,11684
1,25,9,3,2013,6,10340,1704,12044
1,25,9,3,2013,7,11209,1854,13063
1,25,9,3,2013,8,11423,2008,13431
1,25,9,3,2013,9,11434,2304,13738
1,25,9,3,2013,10,11547,2615,14162
1,25,9,3,2013,11,11332,2834,14166
1,25,9,3,2013,12,11122,2919,14041
1,25,9,3,2013,13,11001,2913,13914
1,25,9,3,2013,14,10764,2822,13586
1,25,9,3,2013,15,10747,2852,13599
1,25,9,3,2013,16,10962,2844,13806
1,25,9,3,2013,17,10796,2817,13613
1,25,9,3,2013,18,10877,2768,13645
1,25,9,3,2013,19,12044,2771,14815
1,25,9,3,2013,20,12202,2765,14967
1,25,9,3,2013,21,11838,2615,14453
1,25,9,3,2013,22,11721,2432,14153
1,25,9,3,2013,23,11346,2280,13626
1,25,9,3,2013,24,10821,2114,12935
1,26,9,3,2013,1,10601,1945,12546
1,26,9,3,2013,2,10328,1793,12121
1,26,9,3,2013,3,10277,1682,11959
1,26,9,3,2013,4,10084,1641,11725
1,26,9,3,2013,5,10295,1641,11936
1,26,9,3,2013,6,10952,1771,12723
1,26,9,3,2013,7,11417,1897,13314
1,26,9,3,2013,8,11618,2054,13672
1,26,9,3,2013,9,11551,2297,13848
1,26,9,3,2013,10,11721,2623,14344
1,26,9,3,2013,11,11486,2883,14369
1,26,9,3,2013,12,11204,2958,14162
1,26,9,3,2013,13,11153,2951,14104
1,26,9,3,2013,14,10839,2837,13676
1,26,9,3,2013,15,10856,2870,13726
1,26,9,3,2013,16,11028,2870,13898
1,26,9,3,2013,17,10755,2852,13607
1,26,9,3,2013,18,10927,2810,13737
1,26,9,3,2013,19,11931,2807,14738
1,26,9,3,2013,20,12357,2809,15166
1,26,9,3,2013,21,12031,2643,14674
1,26,9,3,2013,22,11755,2471,14226
1,26,9,3,2013,23,11249,2302,13551
1,26,9,3,2013,24,11097,2070,13167
1,27,9,3,2013,1,10747,1921,12668
1,27,9,3,2013,2,10406,1748,12154
1,27,9,3,2013,3,10289,1657,11946
1,27,9,3,2013,4,10446,1606,12052
1,27,9,3,2013,5,10799,1603,12402
1,27,9,3,2013,6,11221,1705,12926
1,27,9,3,2013,7,11426,1864,13290
1,27,9,3,2013,8,11462,2030,13492
1,27,9,3,2013,9,11572,2325,13897
1,27,9,3,2013,10,11436,2650,14086
1,27,9,3,2013,11,11366,2877,14243
1,27,9,3,2013,12,11199,2951,14150
1,27,9,3,2013,13,11045,2944,13989
1,27,9,3,2013,14,10759,2827,13586
1,27,9,3,2013,15,10833,2837,13670
1,27,9,3,2013,16,10956,2770,13726
1,27,9,3,2013,17,10765,2750,13515
1,27,9,3,2013,18,10612,2747,13359
1,27,9,3,2013,19,11584,2739,14323
1,27,9,3,2013,20,11926,2747,14673
1,27,9,3,2013,21,11817,2604,14421
1,27,9,3,2013,22,11355,2431,13786
1,27,9,3,2013,23,11184,2233,13417
1,27,9,3,2013,24,10795,2049,12844
2,28,9,3,2013,1,10458,1885,12343
2,28,9,3,2013,2,10356,1724,12080
2,28,9,3,2013,3,10254,1642,11896
2,28,9,3,2013,4,10213,1591,11804
2,28,9,3,2013,5,10699,1589,12288
2,28,9,3,2013,6,11537,1683,13220
2,28,9,3,2013,7,11921,1786,13707
2,28,9,3,2013,8,11815,1910,13725
2,28,9,3,2013,9,11638,2153,13791
2,28,9,3,2013,10,11867,2449,14316
2,28,9,3,2013,11,11881,2694,14575
2,28,9,3,2013,12,11697,2762,14459
2,28,9,3,2013,13,11917,2729,14646
2,28,9,3,2013,14,11472,2635,14107
2,28,9,3,2013,15,11414,2592,14006
2,28,9,3,2013,16,11769,2597,14366
2,28,9,3,2013,17,11353,2580,13933
2,28,9,3,2013,18,10952,2542,13494
2,28,9,3,2013,19,11759,2569,14328
2,28,9,3,2013,20,11926,2640,14566
2,28,9,3,2013,21,11795,2559,14354
2,28,9,3,2013,22,11623,2395,14018
2,28,9,3,2013,23,11221,2245,13466
2,28,9,3,2013,24,10997,2121,13118
2,29,9,3,2013,1,11062,1926,12988
2,29,9,3,2013,2,10750,1760,12510
2,29,9,3,2013,3,10638,1666,12304
2,29,9,3,2013,4,10356,1612,11968
2,29,9,3,2013,5,10361,1602,11963
2,29,9,3,2013,6,11064,1662,12726
2,29,9,3,2013,7,11511,1702,13213
2,29,9,3,2013,8,11939,1751,13690
2,29,9,3,2013,9,11785,1884,13669
2,29,9,3,2013,10,11948,2033,13981
2,29,9,3,2013,11,11884,2157,14041
2,29,9,3,2013,12,12039,2196,14235
2,29,9,3,2013,13,11813,2193,14006
2,29,9,3,2013,14,11591,2137,13728
2,29,9,3,2013,15,11578,2096,13674
2,29,9,3,2013,16,11164,2057,13221
2,29,9,3,2013,17,11046,2024,13070
2,29,9,3,2013,18,10303,2020,12323
2,29,9,3,2013,19,11437,2128,13565
2,29,9,3,2013,20,12241,2289,14530
2,29,9,3,2013,21,11750,2271,14021
2,29,9,3,2013,22,11622,2240,13862
2,29,9,3,2013,23,11109,2182,13291
2,29,9,3,2013,24,10834,2110,12944
1,30,9,3,2013,1,10598,1951,12549
1,30,9,3,2013,2,10708,1778,12486
1,30,9,3,2013,3,10635,1676,12311
1,30,9,3,2013,4,10600,1624,12224
1,30,9,3,2013,5,11006,1624,12630
1,30,9,3,2013,6,11767,1724,13491
1,30,9,3,2013,7,12241,1883,14124
1,30,9,3,2013,8,12505,2049,14554
1,30,9,3,2013,9,12237,2343,14580
1,30,9,3,2013,10,12043,2668,14711
1,30,9,3,2013,11,12238,2894,15132
1,30,9,3,2013,12,12351,2988,15339
1,30,9,3,2013,13,12172,2994,15166
1,30,9,3,2013,14,12002,2891,14893
1,30,9,3,2013,15,11725,2930,14655
1,30,9,3,2013,16,12003,2911,14914
1,30,9,3,2013,17,12237,2893,15130
1,30,9,3,2013,18,11053,2821,13874
1,30,9,3,2013,19,11904,2820,14724
1,30,9,3,2013,20,12196,2811,15007
1,30,9,3,2013,21,12190,2676,14866
1,30,9,3,2013,22,12020,2524,14544
1,30,9,3,2013,23,11727,2392,14119
1,30,9,3,2013,24,11185,2264,13449
1,1,10,1,2013,1,10782,2040,12822
1,1,10,1,2013,2,10909,1842,12751
1,1,10,1,2013,3,10939,1737,12676
1,1,10,1,2013,4,10975,1684,12659
1,1,10,1,2013,5,11075,1677,12752
1,1,10,1,2013,6,11405,1769,13174
1,1,10,1,2013,7,11683,1924,13607
1,1,10,1,2013,8,11944,2069,14013
1,1,10,1,2013,9,12197,2369,14566
1,1,10,1,2013,10,12307,2719,15026
1,1,10,1,2013,11,12496,2964,15460
1,1,10,1,2013,12,12479,3025,15504
1,1,10,1,2013,13,12254,3005,15259
1,1,10,1,2013,14,12002,2909,14911
1,1,10,1,2013,15,12258,2955,15213
1,1,10,1,2013,16,12302,2955,15257
1,1,10,1,2013,17,12180,2929,15109
1,1,10,1,2013,18,11383,2881,14264
1,1,10,1,2013,19,12402,2862,15264
1,1,10,1,2013,20,12368,2860,15228
1,1,10,1,2013,21,12226,2699,14925
1,1,10,1,2013,22,11775,2524,14299
1,1,10,1,2013,23,11657,2370,14027
1,1,10,1,2013,24,11420,2254,13674
3,2,10,1,2013,1,11205,2055,13260
3,2,10,1,2013,2,11273,1870,13143
3,2,10,1,2013,3,11290,1771,13061
3,2,10,1,2013,4,11197,1698,12895
3,2,10,1,2013,5,11225,1692,12917
3,2,10,1,2013,6,11580,1767,13347
3,2,10,1,2013,7,11876,1802,13678
3,2,10,1,2013,8,12197,1886,14083
3,2,10,1,2013,9,12617,2034,14651
3,2,10,1,2013,10,12623,2293,14916
3,2,10,1,2013,11,12868,2490,15358
3,2,10,1,2013,12,12281,2547,14828
3,2,10,1,2013,13,12287,2545,14832
3,2,10,1,2013,14,12037,2453,14490
3,2,10,1,2013,15,12026,2451,14477
3,2,10,1,2013,16,12019,2446,14465
3,2,10,1,2013,17,11824,2414,14238
3,2,10,1,2013,18,11522,2421,13943
3,2,10,1,2013,19,12028,2512,14540
3,2,10,1,2013,20,12583,2598,15181
3,2,10,1,2013,21,12242,2562,14804
3,2,10,1,2013,22,11878,2477,14355
3,2,10,1,2013,23,11602,2337,13939
3,2,10,1,2013,24,11226,2194,13420
1,3,10,1,2013,1,10999,2107,13106
1,3,10,1,2013,2,10958,1881,12839
1,3,10,1,2013,3,10724,1767,12491
1,3,10,1,2013,4,10811,1710,12521
1,3,10,1,2013,5,10944,1720,12664
1,3,10,1,2013,6,11386,1793,13179
1,3,10,1,2013,7,12072,1917,13989
1,3,10,1,2013,8,11931,2083,14014
1,3,10,1,2013,9,12204,2338,14542
1,3,10,1,2013,10,12489,2722,15211
1,3,10,1,2013,11,12517,2963,15480
1,3,10,1,2013,12,12253,3084,15337
1,3,10,1,2013,13,11932,3081,15013
1,3,10,1,2013,14,11878,2982,14860
1,3,10,1,2013,15,11907,3044,14951
1,3,10,1,2013,16,11965,3052,15017
1,3,10,1,2013,17,11538,3014,14552
1,3,10,1,2013,18,11215,2949,14164
1,3,10,1,2013,19,12103,2900,15003
1,3,10,1,2013,20,12270,2921,15191
1,3,10,1,2013,21,11721,2762,14483
1,3,10,1,2013,22,11624,2581,14205
1,3,10,1,2013,23,11300,2444,13744
1,3,10,1,2013,24,10995,2297,13292
1,4,10,1,2013,1,10721,2116,12837
1,4,10,1,2013,2,10710,1914,12624
1,4,10,1,2013,3,10693,1819,12512
1,4,10,1,2013,4,10576,1754,12330
1,4,10,1,2013,5,10658,1742,12400
1,4,10,1,2013,6,11173,1843,13016
1,4,10,1,2013,7,11510,1991,13501
1,4,10,1,2013,8,11888,2144,14032
1,4,10,1,2013,9,11761,2422,14183
1,4,10,1,2013,10,11920,2755,14675
1,4,10,1,2013,11,11610,3009,14619
1,4,10,1,2013,12,11516,3084,14600
1,4,10,1,2013,13,10909,3073,13982
1,4,10,1,2013,14,10793,2922,13715
1,4,10,1,2013,15,10655,2969,13624
1,4,10,1,2013,16,10707,2965,13672
1,4,10,1,2013,17,10519,2951,13470
1,4,10,1,2013,18,10372,2895,13267
1,4,10,1,2013,19,11583,2918,14501
1,4,10,1,2013,20,11805,2904,14709
1,4,10,1,2013,21,11636,2738,14374
1,4,10,1,2013,22,11334,2580,13914
1,4,10,1,2013,23,11216,2441,13657
1,4,10,1,2013,24,10803,2286,13089
2,5,10,1,2013,1,10813,2169,12982
2,5,10,1,2013,2,10648,1963,12611
2,5,10,1,2013,3,10498,1851,12349
2,5,10,1,2013,4,10468,1771,12239
2,5,10,1,2013,5,10713,1759,12472
2,5,10,1,2013,6,11254,1842,13096
2,5,10,1,2013,7,11725,1933,13658
2,5,10,1,2013,8,11858,2024,13882
2,5,10,1,2013,9,11882,2262,14144
2,5,10,1,2013,10,12113,2575,14688
2,5,10,1,2013,11,12273,2823,15096
2,5,10,1,2013,12,12207,2902,15109
2,5,10,1,2013,13,11821,2894,14715
2,5,10,1,2013,14,11448,2715,14163
2,5,10,1,2013,15,11580,2742,14322
2,5,10,1,2013,16,11603,2722,14325
2,5,10,1,2013,17,11180,2693,13873
2,5,10,1,2013,18,11088,2625,13713
2,5,10,1,2013,19,12131,2711,14842
2,5,10,1,2013,20,12672,2777,15449
2,5,10,1,2013,21,12402,2692,15094
2,5,10,1,2013,22,12013,2538,14551
2,5,10,1,2013,23,11714,2410,14124
2,5,10,1,2013,24,11611,2253,13864
2,6,10,1,2013,1,11136,2106,13242
2,6,10,1,2013,2,11144,1906,13050
2,6,10,1,2013,3,10927,1787,12714
2,6,10,1,2013,4,11059,1723,12782
2,6,10,1,2013,5,11309,1709,13018
2,6,10,1,2013,6,11568,1770,13338
2,6,10,1,2013,7,12002,1790,13792
2,6,10,1,2013,8,12359,1809,14168
2,6,10,1,2013,9,12241,1918,14159
2,6,10,1,2013,10,12223,2055,14278
2,6,10,1,2013,11,12171,2181,14352
2,6,10,1,2013,12,12186,2192,14378
2,6,10,1,2013,13,11985,2216,14201
2,6,10,1,2013,14,11574,2174,13748
2,6,10,1,2013,15,11563,2142,13705
2,6,10,1,2013,16,11714,2106,13820
2,6,10,1,2013,17,11114,2089,13203
2,6,10,1,2013,18,10818,2076,12894
2,6,10,1,2013,19,12345,2237,14582
2,6,10,1,2013,20,12716,2382,15098
2,6,10,1,2013,21,12299,2425,14724
2,6,10,1,2013,22,11912,2384,14296
2,6,10,1,2013,23,11739,2318,14057
2,6,10,1,2013,24,11473,2310,13783
1,7,10,1,2013,1,11224,2065,13289
1,7,10,1,2013,2,10894,1868,12762
1,7,10,1,2013,3,10977,1762,12739
1,7,10,1,2013,4,10883,1696,12579
1,7,10,1,2013,5,11204,1696,12900
1,7,10,1,2013,6,11998,1802,13800
1,7,10,1,2013,7,12533,1975,14508
1,7,10,1,2013,8,12866,2115,14981
1,7,10,1,2013,9,12622,2395,15017
1,7,10,1,2013,10,12653,2718,15371
1,7,10,1,2013,11,12473,2957,15430
1,7,10,1,2013,12,12464,3009,15473
1,7,10,1,2013,13,12314,3001,15315
1,7,10,1,2013,14,12161,2891,15052
1,7,10,1,2013,15,12405,2957,15362
1,7,10,1,2013,16,12404,2946,15350
1,7,10,1,2013,17,11936,2932,14868
1,7,10,1,2013,18,11548,2863,14411
1,7,10,1,2013,19,12751,2892,15643
1,7,10,1,2013,20,13285,2917,16202
1,7,10,1,2013,21,12709,2775,15484
1,7,10,1,2013,22,12274,2538,14812
1,7,10,1,2013,23,12183,2419,14602
1,7,10,1,2013,24,12208,2298,14506
1,8,10,1,2013,1,11399,2120,13519
1,8,10,1,2013,2,11423,1914,13337
1,8,10,1,2013,3,11416,1799,13215
1,8,10,1,2013,4,11600,1727,13327
1,8,10,1,2013,5,11969,1719,13688
1,8,10,1,2013,6,12361,1813,14174
1,8,10,1,2013,7,13141,1966,15107
1,8,10,1,2013,8,12983,2115,15098
1,8,10,1,2013,9,12993,2416,15409
1,8,10,1,2013,10,13342,2758,16100
1,8,10,1,2013,11,13026,2985,16011
1,8,10,1,2013,12,12786,3040,15826
1,8,10,1,2013,13,12639,3021,15660
1,8,10,1,2013,14,12444,2918,15362
1,8,10,1,2013,15,12342,2958,15300
1,8,10,1,2013,16,12305,2971,15276
1,8,10,1,2013,17,11854,2951,14805
1,8,10,1,2013,18,11402,2891,14293
1,8,10,1,2013,19,12707,2932,15639
1,8,10,1,2013,20,12436,2917,15353
1,8,10,1,2013,21,12395,2730,15125
1,8,10,1,2013,22,11859,2557,14416
1,8,10,1,2013,23,11745,2444,14189
1,8,10,1,2013,24,11464,2328,13792
1,9,10,1,2013,1,11342,1993,13335
1,9,10,1,2013,2,11012,1946,12958
1,9,10,1,2013,3,11198,1817,13015
1,9,10,1,2013,4,11273,1789,13062
1,9,10,1,2013,5,11511,1759,13270
1,9,10,1,2013,6,12336,1812,14148
1,9,10,1,2013,7,12669,1951,14620
1,9,10,1,2013,8,12772,2167,14939
1,9,10,1,2013,9,12897,2388,15285
1,9,10,1,2013,10,12827,2751,15578
1,9,10,1,2013,11,12595,2965,15560
1,9,10,1,2013,12,12713,3019,15732
1,9,10,1,2013,13,12347,3016,15363
1,9,10,1,2013,14,12288,2898,15186
1,9,10,1,2013,15,12353,2941,15294
1,9,10,1,2013,16,12088,2924,15012
1,9,10,1,2013,17,11801,2918,14719
1,9,10,1,2013,18,11513,2856,14369
1,9,10,1,2013,19,12664,2928,15592
1,9,10,1,2013,20,12927,2938,15865
1,9,10,1,2013,21,12711,2760,15471
1,9,10,1,2013,22,11934,2570,14504
1,9,10,1,2013,23,11900,2439,14339
1,9,10,1,2013,24,11630,2320,13950
1,10,10,1,2013,1,11232,2103,13335
1,10,10,1,2013,2,11366,1904,13270
1,10,10,1,2013,3,11122,1791,12913
1,10,10,1,2013,4,11120,1730,12850
1,10,10,1,2013,5,11160,1730,12890
1,10,10,1,2013,6,11731,1813,13544
1,10,10,1,2013,7,12564,1949,14513
1,10,10,1,2013,8,12890,2086,14976
1,10,10,1,2013,9,12657,2371,15028
1,10,10,1,2013,10,12738,2699,15437
1,10,10,1,2013,11,12603,2927,15530
1,10,10,1,2013,12,12477,2983,15460
1,10,10,1,2013,13,12236,2982,15218
1,10,10,1,2013,14,12113,2883,14996
1,10,10,1,2013,15,12212,2935,15147
1,10,10,1,2013,16,12033,2931,14964
1,10,10,1,2013,17,11582,2909,14491
1,10,10,1,2013,18,11201,2846,14047
1,10,10,1,2013,19,12412,2888,15300
1,10,10,1,2013,20,12638,2931,15569
1,10,10,1,2013,21,12239,2731,14970
1,10,10,1,2013,22,11616,2557,14173
1,10,10,1,2013,23,11701,2402,14103
1,10,10,1,2013,24,11424,2249,13673
1,11,10,1,2013,1,11027,2095,13122
1,11,10,1,2013,2,11019,1883,12902
1,11,10,1,2013,3,10822,1783,12605
1,11,10,1,2013,4,11061,1716,12777
1,11,10,1,2013,5,11283,1707,12990
1,11,10,1,2013,6,11723,1795,13518
1,11,10,1,2013,7,12403,1929,14332
1,11,10,1,2013,8,12458,2067,14525
1,11,10,1,2013,9,12532,2358,14890
1,11,10,1,2013,10,12265,2690,14955
1,11,10,1,2013,11,12404,2920,15324
1,11,10,1,2013,12,12157,2998,15155
1,11,10,1,2013,13,11640,2966,14606
1,11,10,1,2013,14,11552,2796,14348
1,11,10,1,2013,15,11606,2795,14401
1,11,10,1,2013,16,11491,2783,14274
1,11,10,1,2013,17,11139,2796,13935
1,11,10,1,2013,18,11097,2775,13872
1,11,10,1,2013,19,12384,2866,15250
1,11,10,1,2013,20,12393,2876,15269
1,11,10,1,2013,21,12131,2717,14848
1,11,10,1,2013,22,11580,2536,14116
1,11,10,1,2013,23,11672,2360,14032
1,11,10,1,2013,24,11376,2209,13585
2,12,10,1,2013,1,10925,2028,12953
2,12,10,1,2013,2,10610,1845,12455
2,12,10,1,2013,3,10496,1742,12238
2,12,10,1,2013,4,10485,1679,12164
2,12,10,1,2013,5,10652,1669,12321
2,12,10,1,2013,6,11268,1749,13017
2,12,10,1,2013,7,11898,1824,13722
2,12,10,1,2013,8,12186,1924,14110
2,12,10,1,2013,9,12213,2137,14350
2,12,10,1,2013,10,12296,2438,14734
2,12,10,1,2013,11,12502,2673,15175
2,12,10,1,2013,12,12111,2713,14824
2,12,10,1,2013,13,12016,2697,14713
2,12,10,1,2013,14,11855,2560,14415
2,12,10,1,2013,15,11952,2551,14503
2,12,10,1,2013,16,11461,2525,13986
2,12,10,1,2013,17,11087,2489,13576
2,12,10,1,2013,18,10888,2450,13338
2,12,10,1,2013,19,12149,2569,14718
2,12,10,1,2013,20,12566,2634,15200
2,12,10,1,2013,21,12062,2551,14613
2,12,10,1,2013,22,11696,2407,14103
2,12,10,1,2013,23,11493,2264,13757
2,12,10,1,2013,24,11082,2125,13207
3,14,10,1,2013,1,9787,2069,11856
3,14,10,1,2013,2,9648,1928,11576
3,14,10,1,2013,3,9518,1852,11370
3,14,10,1,2013,4,9725,1799,11524
3,14,10,1,2013,5,10042,1795,11837
3,14,10,1,2013,6,10661,1776,12437
3,14,10,1,2013,7,11302,1819,13121
3,14,10,1,2013,8,11586,1968,13554
3,14,10,1,2013,9,11975,2295,14270
3,14,10,1,2013,10,12366,2602,14968
3,14,10,1,2013,11,12524,2874,15398
3,14,10,1,2013,12,12496,2945,15441
3,14,10,1,2013,13,12207,2912,15119
3,14,10,1,2013,14,12093,2847,14940
3,14,10,1,2013,15,12189,2862,15051
3,14,10,1,2013,16,12089,2882,14971
3,14,10,1,2013,17,11704,2891,14595
3,14,10,1,2013,18,11039,2813,13852
3,14,10,1,2013,19,12206,2824,15030
3,14,10,1,2013,20,12448,2807,15255
3,14,10,1,2013,21,12275,2713,14988
3,14,10,1,2013,22,11908,2526,14434
3,14,10,1,2013,23,11895,2403,14298
3,14,10,1,2013,24,11452,2337,13789
3,15,10,1,2013,1,11207,2114,13321
3,15,10,1,2013,2,11142,1916,13058
3,15,10,1,2013,3,11060,1799,12859
3,15,10,1,2013,4,11122,1731,12853
3,15,10,1,2013,5,11310,1720,13030
3,15,10,1,2013,6,11742,1813,13555
3,15,10,1,2013,7,12068,1946,14014
3,15,10,1,2013,8,12248,2113,14361
3,15,10,1,2013,9,12487,2415,14902
3,15,10,1,2013,10,13043,2776,15819
3,15,10,1,2013,11,12970,3013,15983
3,15,10,1,2013,12,12927,3045,15972
3,15,10,1,2013,13,12471,3002,15473
3,15,10,1,2013,14,12440,2873,15313
3,15,10,1,2013,15,12417,2891,15308
3,15,10,1,2013,16,12483,2880,15363
3,15,10,1,2013,17,11924,2901,14825
3,15,10,1,2013,18,11488,2882,14370
3,15,10,1,2013,19,12745,2909,15654
3,15,10,1,2013,20,12485,2868,15353
3,15,10,1,2013,21,12294,2701,14995
3,15,10,1,2013,22,12093,2499,14592
3,15,10,1,2013,23,11920,2400,14320
3,15,10,1,2013,24,11725,2221,13946
1,16,10,1,2013,1,11392,2064,13456
1,16,10,1,2013,2,11225,1887,13112
1,16,10,1,2013,3,11076,1784,12860
1,16,10,1,2013,4,11138,1718,12856
1,16,10,1,2013,5,11498,1712,13210
1,16,10,1,2013,6,11727,1804,13531
1,16,10,1,2013,7,12093,1907,14000
1,16,10,1,2013,8,12381,2013,14394
1,16,10,1,2013,9,12481,2231,14712
1,16,10,1,2013,10,12643,2502,15145
1,16,10,1,2013,11,12603,2705,15308
1,16,10,1,2013,12,12457,2769,15226
1,16,10,1,2013,13,12458,2750,15208
1,16,10,1,2013,14,12233,2701,14934
1,16,10,1,2013,15,12486,2732,15218
1,16,10,1,2013,16,12262,2743,15005
1,16,10,1,2013,17,12094,2728,14822
1,16,10,1,2013,18,11718,2673,14391
1,16,10,1,2013,19,12709,2758,15467
1,16,10,1,2013,20,12868,2744,15612
1,16,10,1,2013,21,12602,2599,15201
1,16,10,1,2013,22,12128,2492,14620
1,16,10,1,2013,23,11914,2366,14280
1,16,10,1,2013,24,11685,2261,13946
1,17,10,1,2013,1,11320,2069,13389
1,17,10,1,2013,2,11374,1882,13256
1,17,10,1,2013,3,11140,1780,12920
1,17,10,1,2013,4,11284,1716,13000
1,17,10,1,2013,5,11483,1698,13181
1,17,10,1,2013,6,11936,1783,13719
1,17,10,1,2013,7,12426,1921,14347
1,17,10,1,2013,8,12519,2073,14592
1,17,10,1,2013,9,12334,2370,14704
1,17,10,1,2013,10,12602,2699,15301
1,17,10,1,2013,11,12350,2932,15282
1,17,10,1,2013,12,12103,2997,15100
1,17,10,1,2013,13,11920,2992,14912
1,17,10,1,2013,14,11983,2914,14897
1,17,10,1,2013,15,12165,2961,15126
1,17,10,1,2013,16,12109,2959,15068
1,17,10,1,2013,17,11741,2947,14688
1,17,10,1,2013,18,11420,2880,14300
1,17,10,1,2013,19,12528,2897,15425
1,17,10,1,2013,20,12696,2866,15562
1,17,10,1,2013,21,12528,2701,15229
1,17,10,1,2013,22,12178,2576,14754
1,17,10,1,2013,23,11752,2472,14224
1,17,10,1,2013,24,11431,2361,13792
1,18,10,1,2013,1,10828,2129,12957
1,18,10,1,2013,2,11012,1937,12949
1,18,10,1,2013,3,10975,1830,12805
1,18,10,1,2013,4,11030,1759,12789
1,18,10,1,2013,5,11260,1763,13023
1,18,10,1,2013,6,11905,1834,13739
1,18,10,1,2013,7,12211,1967,14178
1,18,10,1,2013,8,11996,2116,14112
1,18,10,1,2013,9,11361,2430,13791
1,18,10,1,2013,10,12039,2789,14828
1,18,10,1,2013,11,11922,3047,14969
1,18,10,1,2013,12,11841,3106,14947
1,18,10,1,2013,13,11607,3097,14704
1,18,10,1,2013,14,11529,2974,14503
1,18,10,1,2013,15,11656,3023,14679
1,18,10,1,2013,16,11795,3031,14826
1,18,10,1,2013,17,11411,3022,14433
1,18,10,1,2013,18,10982,2960,13942
1,18,10,1,2013,19,12300,2957,15257
1,18,10,1,2013,20,12791,2925,15716
1,18,10,1,2013,21,12238,2762,15000
1,18,10,1,2013,22,11924,2580,14504
1,18,10,1,2013,23,11669,2483,14152
1,18,10,1,2013,24,11605,2418,14023
2,19,10,1,2013,1,11391,2210,13601
2,19,10,1,2013,2,11148,1999,13147
2,19,10,1,2013,3,11088,1883,12971
2,19,10,1,2013,4,10976,1815,12791
2,19,10,1,2013,5,11264,1798,13062
2,19,10,1,2013,6,11966,1852,13818
2,19,10,1,2013,7,12311,1904,14215
2,19,10,1,2013,8,12526,2006,14532
2,19,10,1,2013,9,12709,2253,14962
2,19,10,1,2013,10,13128,2577,15705
2,19,10,1,2013,11,12669,2829,15498
2,19,10,1,2013,12,12920,2898,15818
2,19,10,1,2013,13,12498,2920,15418
2,19,10,1,2013,14,12436,2807,15243
2,19,10,1,2013,15,12619,2826,15445
2,19,10,1,2013,16,12800,2841,15641
2,19,10,1,2013,17,12318,2831,15149
2,19,10,1,2013,18,11664,2765,14429
2,19,10,1,2013,19,12751,2841,15592
2,19,10,1,2013,20,13084,2891,15975
2,19,10,1,2013,21,12628,2781,15409
2,19,10,1,2013,22,12527,2600,15127
2,19,10,1,2013,23,12086,2538,14624
2,19,10,1,2013,24,12046,2473,14519
2,20,10,1,2013,1,11951,2330,14281
2,20,10,1,2013,2,11855,2126,13981
2,20,10,1,2013,3,11873,1995,13868
2,20,10,1,2013,4,12007,1906,13913
2,20,10,1,2013,5,12060,1856,13916
2,20,10,1,2013,6,12596,1889,14485
2,20,10,1,2013,7,12906,1883,14789
2,20,10,1,2013,8,13109,1912,15021
2,20,10,1,2013,9,12921,1993,14914
2,20,10,1,2013,10,13110,2132,15242
2,20,10,1,2013,11,13385,2268,15653
2,20,10,1,2013,12,13545,2328,15873
2,20,10,1,2013,13,13434,2332,15766
2,20,10,1,2013,14,13159,2287,15446
2,20,10,1,2013,15,13253,2297,15550
2,20,10,1,2013,16,13368,2279,15647
2,20,10,1,2013,17,12737,2255,14992
2,20,10,1,2013,18,11818,2231,14049
2,20,10,1,2013,19,12897,2377,15274
2,20,10,1,2013,20,12804,2479,15283
2,20,10,1,2013,21,12513,2476,14989
2,20,10,1,2013,22,12096,2453,14549
2,20,10,1,2013,23,12279,2454,14733
2,20,10,1,2013,24,12092,2375,14467
1,21,10,1,2013,1,11872,2243,14115
1,21,10,1,2013,2,11714,2012,13726
1,21,10,1,2013,3,11496,1899,13395
1,21,10,1,2013,4,11444,1827,13271
1,21,10,1,2013,5,11727,1804,13531
1,21,10,1,2013,6,12113,1872,13985
1,21,10,1,2013,7,12566,1957,14523
1,21,10,1,2013,8,13114,2080,15194
1,21,10,1,2013,9,13406,2375,15781
1,21,10,1,2013,10,13398,2740,16138
1,21,10,1,2013,11,13725,3013,16738
1,21,10,1,2013,12,13871,3109,16980
1,21,10,1,2013,13,13589,3099,16688
1,21,10,1,2013,14,13623,2996,16619
1,21,10,1,2013,15,13458,3062,16520
1,21,10,1,2013,16,13616,3068,16684
1,21,10,1,2013,17,13159,3028,16187
1,21,10,1,2013,18,12060,2942,15002
1,21,10,1,2013,19,13204,2947,16151
1,21,10,1,2013,20,13005,2918,15923
1,21,10,1,2013,21,12784,2796,15580
1,21,10,1,2013,22,12439,2635,15074
1,21,10,1,2013,23,12342,2505,14847
1,21,10,1,2013,24,12266,2387,14653
1,22,10,1,2013,1,11825,2222,14047
1,22,10,1,2013,2,11858,2005,13863
1,22,10,1,2013,3,11914,1879,13793
1,22,10,1,2013,4,11813,1784,13597
1,22,10,1,2013,5,11958,1763,13721
1,22,10,1,2013,6,12575,1832,14407
1,22,10,1,2013,7,13021,1939,14960
1,22,10,1,2013,8,13529,2058,15587
1,22,10,1,2013,9,13455,2334,15789
1,22,10,1,2013,10,13547,2692,16239
1,22,10,1,2013,11,13513,2940,16453
1,22,10,1,2013,12,13543,2990,16533
1,22,10,1,2013,13,13458,2985,16443
1,22,10,1,2013,14,13419,2895,16314
1,22,10,1,2013,15,13516,2964,16480
1,22,10,1,2013,16,13828,2988,16816
1,22,10,1,2013,17,13326,2985,16311
1,22,10,1,2013,18,12177,2945,15122
1,22,10,1,2013,19,13002,2956,15958
1,22,10,1,2013,20,13107,2912,16019
1,22,10,1,2013,21,12721,2773,15494
1,22,10,1,2013,22,12343,2597,14940
1,22,10,1,2013,23,12176,2518,14694
1,22,10,1,2013,24,12151,2324,14475
1,23,10,1,2013,1,11859,2178,14037
1,23,10,1,2013,2,11728,1981,13709
1,23,10,1,2013,3,11829,1859,13688
1,23,10,1,2013,4,11734,1776,13510
1,23,10,1,2013,5,11905,1754,13659
1,23,10,1,2013,6,12425,1830,14255
1,23,10,1,2013,7,12876,1936,14812
1,23,10,1,2013,8,13370,2040,15410
1,23,10,1,2013,9,13489,2324,15813
1,23,10,1,2013,10,13688,2682,16370
1,23,10,1,2013,11,13932,2936,16868
1,23,10,1,2013,12,13617,3005,16622
1,23,10,1,2013,13,13664,3008,16672
1,23,10,1,2013,14,13596,2931,16527
1,23,10,1,2013,15,13775,2990,16765
1,23,10,1,2013,16,13907,3005,16912
1,23,10,1,2013,17,13598,3009,16607
1,23,10,1,2013,18,12275,2964,15239
1,23,10,1,2013,19,13172,2995,16167
1,23,10,1,2013,20,13264,2953,16217
1,23,10,1,2013,21,12918,2800,15718
1,23,10,1,2013,22,12436,2629,15065
1,23,10,1,2013,23,12203,2523,14726
1,23,10,1,2013,24,12040,2443,14483
1,24,10,1,2013,1,11886,2203,14089
1,24,10,1,2013,2,11707,1995,13702
1,24,10,1,2013,3,11762,1883,13645
1,24,10,1,2013,4,11959,1807,13766
1,24,10,1,2013,5,12012,1772,13784
1,24,10,1,2013,6,12511,1832,14343
1,24,10,1,2013,7,13058,1936,14994
1,24,10,1,2013,8,13412,2041,15453
1,24,10,1,2013,9,13409,2310,15719
1,24,10,1,2013,10,13645,2675,16320
1,24,10,1,2013,11,13776,2924,16700
1,24,10,1,2013,12,13705,3000,16705
1,24,10,1,2013,13,13633,2999,16632
1,24,10,1,2013,14,13379,2944,16323
1,24,10,1,2013,15,13604,2986,16590
1,24,10,1,2013,16,13601,2993,16594
1,24,10,1,2013,17,13200,3000,16200
1,24,10,1,2013,18,12107,2916,15023
1,24,10,1,2013,19,12826,2905,15731
1,24,10,1,2013,20,12795,2871,15666
1,24,10,1,2013,21,12614,2762,15376
1,24,10,1,2013,22,12176,2618,14794
1,24,10,1,2013,23,12254,2520,14774
1,24,10,1,2013,24,11880,2418,14298
1,25,10,1,2013,1,11889,2201,14090
1,25,10,1,2013,2,11804,1988,13792
1,25,10,1,2013,3,11651,1877,13528
1,25,10,1,2013,4,11657,1799,13456
1,25,10,1,2013,5,11653,1770,13423
1,25,10,1,2013,6,12262,1852,14114
1,25,10,1,2013,7,12403,1928,14331
1,25,10,1,2013,8,12810,2052,14862
1,25,10,1,2013,9,12893,2357,15250
1,25,10,1,2013,10,13042,2736,15778
1,25,10,1,2013,11,13093,2999,16092
1,25,10,1,2013,12,13140,3082,16222
1,25,10,1,2013,13,12867,3082,15949
1,25,10,1,2013,14,12699,3000,15699
1,25,10,1,2013,15,12522,3052,15574
1,25,10,1,2013,16,12693,3060,15753
1,25,10,1,2013,17,12143,3045,15188
1,25,10,1,2013,18,11842,2987,14829
1,25,10,1,2013,19,12484,2961,15445
1,25,10,1,2013,20,12610,2943,15553
1,25,10,1,2013,21,12295,2811,15106
1,25,10,1,2013,22,11966,2675,14641
1,25,10,1,2013,23,11845,2527,14372
1,25,10,1,2013,24,11711,2431,14142
2,26,10,1,2013,1,11465,2258,13723
2,26,10,1,2013,2,11410,2047,13457
2,26,10,1,2013,3,11235,1912,13147
2,26,10,1,2013,4,11234,1849,13083
2,26,10,1,2013,5,11298,1819,13117
2,26,10,1,2013,6,11986,1875,13861
2,26,10,1,2013,7,12349,1920,14269
2,26,10,1,2013,8,12561,2011,14572
2,26,10,1,2013,9,12845,2241,15086
2,26,10,1,2013,10,12877,2563,15440
2,26,10,1,2013,11,12977,2831,15808
2,26,10,1,2013,12,13223,2925,16148
2,26,10,1,2013,13,12994,2920,15914
2,26,10,1,2013,14,12847,2854,15701
2,26,10,1,2013,15,13060,2867,15927
2,26,10,1,2013,16,12977,2844,15821
2,26,10,1,2013,17,12744,2809,15553
2,26,10,1,2013,18,12010,2753,14763
2,26,10,1,2013,19,13015,2853,15868
2,26,10,1,2013,20,12776,2888,15664
2,26,10,1,2013,21,12457,2770,15227
2,26,10,1,2013,22,12175,2648,14823
2,26,10,1,2013,23,12124,2530,14654
2,26,10,1,2013,24,12050,2415,14465
2,27,10,1,2013,1,11768,2300,14068
2,27,10,1,2013,2,11677,2113,13790
2,27,10,1,2013,3,11580,1984,13564
2,27,10,1,2013,4,11393,1899,13292
2,27,10,1,2013,5,11652,1880,13532
2,27,10,1,2013,6,12183,1901,14084
2,27,10,1,2013,7,12215,1898,14113
2,27,10,1,2013,8,12595,1899,14494
2,27,10,1,2013,9,12723,1990,14713
2,27,10,1,2013,10,13163,2136,15299
2,27,10,1,2013,11,13210,2296,15506
2,27,10,1,2013,12,13222,2370,15592
2,27,10,1,2013,13,13044,2378,15422
2,27,10,1,2013,14,13009,2343,15352
2,27,10,1,2013,15,13149,2330,15479
2,27,10,1,2013,16,13249,2306,15555
2,27,10,1,2013,17,12716,2238,14954
2,27,10,1,2013,18,12108,2231,14339
2,27,10,1,2013,19,12717,2401,15118
2,27,10,1,2013,20,12774,2458,15232
2,27,10,1,2013,21,12303,2476,14779
2,27,10,1,2013,22,12137,2469,14606
2,27,10,1,2013,23,12028,2444,14472
2,27,10,1,2013,24,11949,2391,14340
1,28,10,1,2013,1,11759,2235,13994
1,28,10,1,2013,2,11797,2040,13837
1,28,10,1,2013,3,11698,1908,13606
1,28,10,1,2013,4,11798,1839,13637
1,28,10,1,2013,5,11852,1824,13676
1,28,10,1,2013,6,12402,1881,14283
1,28,10,1,2013,7,12693,1968,14661
1,28,10,1,2013,8,13017,2104,15121
1,28,10,1,2013,9,13150,2423,15573
1,28,10,1,2013,10,13614,2802,16416
1,28,10,1,2013,11,13855,3072,16927
1,28,10,1,2013,12,13968,3129,17097
1,28,10,1,2013,13,13901,3127,17028
1,28,10,1,2013,14,13556,3053,16609
1,28,10,1,2013,15,13687,3092,16779
1,28,10,1,2013,16,13850,3104,16954
1,28,10,1,2013,17,13701,3069,16770
1,28,10,1,2013,18,12738,3004,15742
1,28,10,1,2013,19,13203,3007,16210
1,28,10,1,2013,20,13103,2953,16056
1,28,10,1,2013,21,12768,2816,15584
1,28,10,1,2013,22,12375,2680,15055
1,28,10,1,2013,23,12277,2553,14830
1,28,10,1,2013,24,12074,2424,14498
1,29,10,1,2013,1,11941,2235,14176
1,29,10,1,2013,2,11950,2016,13966
1,29,10,1,2013,3,11798,1897,13695
1,29,10,1,2013,4,11768,1834,13602
1,29,10,1,2013,5,12005,1808,13813
1,29,10,1,2013,6,12520,1871,14391
1,29,10,1,2013,7,12985,1957,14942
1,29,10,1,2013,8,13430,2089,15519
1,29,10,1,2013,9,13589,2398,15987
1,29,10,1,2013,10,13692,2781,16473
1,29,10,1,2013,11,13959,3042,17001
1,29,10,1,2013,12,14039,3114,17153
1,29,10,1,2013,13,14078,3085,17163
1,29,10,1,2013,14,13819,3013,16832
1,29,10,1,2013,15,14069,3039,17108
1,29,10,1,2013,16,14155,3027,17182
1,29,10,1,2013,17,13777,3018,16795
1,29,10,1,2013,18,12837,2952,15789
1,29,10,1,2013,19,13206,2959,16165
1,29,10,1,2013,20,13094,2885,15979
1,29,10,1,2013,21,12878,2722,15600
1,29,10,1,2013,22,12530,2579,15109
1,29,10,1,2013,23,12270,2432,14702
1,29,10,1,2013,24,12135,2305,14440
1,30,10,1,2013,1,11939,2115,14054
1,30,10,1,2013,2,11849,1939,13788
1,30,10,1,2013,3,11718,1832,13550
1,30,10,1,2013,4,11740,1763,13503
1,30,10,1,2013,5,12086,1731,13817
1,30,10,1,2013,6,12643,1794,14437
1,30,10,1,2013,7,13017,1868,14885
1,30,10,1,2013,8,13392,1988,15380
1,30,10,1,2013,9,13334,2283,15617
1,30,10,1,2013,10,13668,2661,16329
1,30,10,1,2013,11,14031,2929,16960
1,30,10,1,2013,12,14314,3012,17326
1,30,10,1,2013,13,14200,2999,17199
1,30,10,1,2013,14,13963,2947,16910
1,30,10,1,2013,15,14045,2987,17032
1,30,10,1,2013,16,14020,2998,17018
1,30,10,1,2013,17,13732,2995,16727
1,30,10,1,2013,18,12494,2954,15448
1,30,10,1,2013,19,13270,3006,16276
1,30,10,1,2013,20,13142,2920,16062
1,30,10,1,2013,21,12886,2784,15670
1,30,10,1,2013,22,12456,2658,15114
1,30,10,1,2013,23,12264,2500,14764
1,30,10,1,2013,24,12224,2328,14552
1,31,10,1,2013,1,11978,2111,14089
1,31,10,1,2013,2,11970,1926,13896
1,31,10,1,2013,3,11563,1876,13439
1,31,10,1,2013,4,11676,1817,13493
1,31,10,1,2013,5,12008,1741,13749
1,31,10,1,2013,6,12897,1792,14689
1,31,10,1,2013,7,13383,1884,15267
1,31,10,1,2013,8,13833,1949,15782
1,31,10,1,2013,9,13917,2326,16243
1,31,10,1,2013,10,14007,2664,16671
1,31,10,1,2013,11,13952,2934,16886
1,31,10,1,2013,12,13999,3015,17014
1,31,10,1,2013,13,13933,3003,16936
1,31,10,1,2013,14,13504,2899,16403
1,31,10,1,2013,15,13835,2931,16766
1,31,10,1,2013,16,13769,2942,16711
1,31,10,1,2013,17,13510,2917,16427
1,31,10,1,2013,18,12640,2869,15509
1,31,10,1,2013,19,13594,2895,16489
1,31,10,1,2013,20,13673,2847,16520
1,31,10,1,2013,21,13070,2771,15841
1,31,10,1,2013,22,12493,2623,15116
1,31,10,1,2013,23,11911,2502,14413
1,31,10,1,2013,24,11911,2378,14289
1,1,11,1,2013,1,11942,2140,14082
1,1,11,1,2013,2,11733,1929,13662
1,1,11,1,2013,3,11865,1817,13682
1,1,11,1,2013,4,11887,1748,13635
1,1,11,1,2013,5,12085,1716,13801
1,1,11,1,2013,6,12841,1768,14609
1,1,11,1,2013,7,13586,1810,15396
1,1,11,1,2013,8,14008,1939,15947
1,1,11,1,2013,9,13853,2239,16092
1,1,11,1,2013,10,13650,2608,16258
1,1,11,1,2013,11,13664,2872,16536
1,1,11,1,2013,12,13714,2934,16648
1,1,11,1,2013,13,13702,2930,16632
1,1,11,1,2013,14,13604,2822,16426
1,1,11,1,2013,15,13401,2856,16257
1,1,11,1,2013,16,13512,2853,16365
1,1,11,1,2013,17,12960,2829,15789
1,1,11,1,2013,18,12042,2779,14821
1,1,11,1,2013,19,12887,2839,15726
1,1,11,1,2013,20,13039,2815,15854
1,1,11,1,2013,21,12562,2725,15287
1,1,11,1,2013,22,12041,2579,14620
1,1,11,1,2013,23,11853,2458,14311
1,1,11,1,2013,24,11717,2320,14037
2,2,11,1,2013,1,11779,2119,13898
2,2,11,1,2013,2,11667,1916,13583
2,2,11,1,2013,3,11603,1802,13405
2,2,11,1,2013,4,11790,1733,13523
2,2,11,1,2013,5,12133,1704,13837
2,2,11,1,2013,6,12887,1794,14681
2,2,11,1,2013,7,13623,1841,15464
2,2,11,1,2013,8,13637,1903,15540
2,2,11,1,2013,9,13321,2040,15361
2,2,11,1,2013,10,12996,2281,15277
2,2,11,1,2013,11,13317,2493,15810
2,2,11,1,2013,12,13419,2553,15972
2,2,11,1,2013,13,13559,2574,16133
2,2,11,1,2013,14,13320,2517,15837
2,2,11,1,2013,15,13466,2505,15971
2,2,11,1,2013,16,13382,2471,15853
2,2,11,1,2013,17,13011,2407,15418
2,2,11,1,2013,18,12050,2363,14413
2,2,11,1,2013,19,12682,2538,15220
2,2,11,1,2013,20,12942,2585,15527
2,2,11,1,2013,21,12345,2537,14882
2,2,11,1,2013,22,12138,2454,14592
2,2,11,1,2013,23,11558,2321,13879
2,2,11,1,2013,24,11198,2218,13416
3,3,11,1,2013,1,11304,2031,13335
3,3,11,1,2013,2,11106,1847,12953
3,3,11,1,2013,3,11224,1743,12967
3,3,11,1,2013,4,11361,1675,13036
3,3,11,1,2013,5,11461,1642,13103
3,3,11,1,2013,6,12202,1704,13906
3,3,11,1,2013,7,12466,1739,14205
3,3,11,1,2013,8,13003,1730,14733
3,3,11,1,2013,9,12767,1801,14568
3,3,11,1,2013,10,12277,1900,14177
3,3,11,1,2013,11,12338,2000,14338
3,3,11,1,2013,12,12675,2036,14711
3,3,11,1,2013,13,12696,2054,14750
3,3,11,1,2013,14,12584,2040,14624
3,3,11,1,2013,15,12473,2024,14497
3,3,11,1,2013,16,12319,2005,14324
3,3,11,1,2013,17,11792,1987,13779
3,3,11,1,2013,18,10629,2037,12666
3,3,11,1,2013,19,11625,2356,13981
3,3,11,1,2013,20,11918,2475,14393
3,3,11,1,2013,21,11508,2416,13924
3,3,11,1,2013,22,11249,2381,13630
3,3,11,1,2013,23,10737,2333,13070
3,3,11,1,2013,24,10598,2271,12869
1,4,11,1,2013,1,10477,2144,12621
1,4,11,1,2013,2,10451,1939,12390
1,4,11,1,2013,3,10455,1835,12290
1,4,11,1,2013,4,10409,1735,12144
1,4,11,1,2013,5,10684,1715,12399
1,4,11,1,2013,6,11192,1782,12974
1,4,11,1,2013,7,11707,1809,13516
1,4,11,1,2013,8,12247,1805,14052
1,4,11,1,2013,9,12061,1876,13937
1,4,11,1,2013,10,12149,2000,14149
1,4,11,1,2013,11,12084,2135,14219
1,4,11,1,2013,12,12398,2175,14573
1,4,11,1,2013,13,12409,2171,14580
1,4,11,1,2013,14,12196,2136,14332
1,4,11,1,2013,15,12279,2132,14411
1,4,11,1,2013,16,12290,2124,14414
1,4,11,1,2013,17,11795,2085,13880
1,4,11,1,2013,18,11174,2067,13241
1,4,11,1,2013,19,11835,2280,14115
1,4,11,1,2013,20,11834,2387,14221
1,4,11,1,2013,21,11599,2378,13977
1,4,11,1,2013,22,10988,2360,13348
1,4,11,1,2013,23,10547,2283,12830
1,4,11,1,2013,24,10742,2181,12923
1,5,11,1,2013,1,10667,2079,12746
1,5,11,1,2013,2,10514,1907,12421
1,5,11,1,2013,3,10564,1811,12375
1,5,11,1,2013,4,10562,1741,12303
1,5,11,1,2013,5,11013,1711,12724
1,5,11,1,2013,6,11751,1769,13520
1,5,11,1,2013,7,11848,2095,13943
1,5,11,1,2013,8,12394,1837,14231
1,5,11,1,2013,9,12513,1995,14508
1,5,11,1,2013,10,12624,2182,14806
1,5,11,1,2013,11,12497,2313,14810
1,5,11,1,2013,12,12585,2339,14924
1,5,11,1,2013,13,12456,2352,14808
1,5,11,1,2013,14,12596,2289,14885
1,5,11,1,2013,15,12577,2295,14872
1,5,11,1,2013,16,12647,2288,14935
1,5,11,1,2013,17,11887,2252,14139
1,5,11,1,2013,18,11031,2234,13265
1,5,11,1,2013,19,11752,2425,14177
1,5,11,1,2013,20,11807,2476,14283
1,5,11,1,2013,21,11345,2483,13828
1,5,11,1,2013,22,10799,2382,13181
1,5,11,1,2013,23,10745,2259,13004
1,5,11,1,2013,24,10825,2156,12981
1,6,11,1,2013,1,10794,2045,12839
1,6,11,1,2013,2,10769,1881,12650
1,6,11,1,2013,3,10722,1775,12497
1,6,11,1,2013,4,10717,1712,12429
1,6,11,1,2013,5,10876,1681,12557
1,6,11,1,2013,6,11639,1748,13387
1,6,11,1,2013,7,12143,1779,13922
1,6,11,1,2013,8,12741,1884,14625
1,6,11,1,2013,9,12916,2167,15083
1,6,11,1,2013,10,13181,2516,15697
1,6,11,1,2013,11,13419,2733,16152
1,6,11,1,2013,12,13622,2794,16416
1,6,11,1,2013,13,13364,2786,16150
1,6,11,1,2013,14,13352,2719,16071
1,6,11,1,2013,15,13293,2729,16022
1,6,11,1,2013,16,13601,2729,16330
1,6,11,1,2013,17,12889,2703,15592
1,6,11,1,2013,18,11608,2656,14264
1,6,11,1,2013,19,12462,2752,15214
1,6,11,1,2013,20,12545,2706,15251
1,6,11,1,2013,21,12392,2642,15034
1,6,11,1,2013,22,11782,2439,14221
1,6,11,1,2013,23,11619,2293,13912
1,6,11,1,2013,24,11831,2156,13987
1,7,11,1,2013,1,11424,2051,13475
1,7,11,1,2013,2,11274,1861,13135
1,7,11,1,2013,3,11179,1765,12944
1,7,11,1,2013,4,11095,1697,12792
1,7,11,1,2013,5,11307,1677,12984
1,7,11,1,2013,6,11935,1749,13684
1,7,11,1,2013,7,12646,1781,14427
1,7,11,1,2013,8,13155,1904,15059
1,7,11,1,2013,9,13253,2195,15448
1,7,11,1,2013,10,13656,2550,16206
1,7,11,1,2013,11,14082,2789,16871
1,7,11,1,2013,12,14343,2824,17167
1,7,11,1,2013,13,14304,2820,17124
1,7,11,1,2013,14,14156,2740,16896
1,7,11,1,2013,15,14071,2772,16843
1,7,11,1,2013,16,14132,2770,16902
1,7,11,1,2013,17,13612,2755,16367
1,7,11,1,2013,18,12107,2715,14822
1,7,11,1,2013,19,12854,2795,15649
1,7,11,1,2013,20,12541,2731,15272
1,7,11,1,2013,21,12253,2644,14897
1,7,11,1,2013,22,11777,2398,14175
1,7,11,1,2013,23,11444,2330,13774
1,7,11,1,2013,24,11405,2174,13579
1,8,11,1,2013,1,11563,2005,13568
1,8,11,1,2013,2,11441,1841,13282
1,8,11,1,2013,3,11481,1742,13223
1,8,11,1,2013,4,11391,1678,13069
1,8,11,1,2013,5,11611,1654,13265
1,8,11,1,2013,6,12291,1723,14014
1,8,11,1,2013,7,12831,1786,14617
1,8,11,1,2013,8,13310,1915,15225
1,8,11,1,2013,9,13695,2205,15900
1,8,11,1,2013,10,14054,2563,16617
1,8,11,1,2013,11,14581,2793,17374
1,8,11,1,2013,12,14330,2861,17191
1,8,11,1,2013,13,14405,2855,17260
1,8,11,1,2013,14,14186,2738,16924
1,8,11,1,2013,15,13986,2789,16775
1,8,11,1,2013,16,13980,2798,16778
1,8,11,1,2013,17,13500,2787,16287
1,8,11,1,2013,18,12113,2720,14833
1,8,11,1,2013,19,12625,2789,15414
1,8,11,1,2013,20,12393,2745,15138
1,8,11,1,2013,21,12047,2564,14611
1,8,11,1,2013,22,11257,2433,13690
1,8,11,1,2013,23,11208,2329,13537
1,8,11,1,2013,24,11814,2063,13877
2,9,11,1,2013,1,11716,2000,13716
2,9,11,1,2013,2,11371,1837,13208
2,9,11,1,2013,3,11172,1733,12905
2,9,11,1,2013,4,11526,1669,13195
2,9,11,1,2013,5,11766,1656,13422
2,9,11,1,2013,6,12472,1709,14181
2,9,11,1,2013,7,13237,1730,14967
2,9,11,1,2013,8,13677,1798,15475
2,9,11,1,2013,9,13736,2006,15742
2,9,11,1,2013,10,14028,2309,16337
2,9,11,1,2013,11,14433,2501,16934
2,9,11,1,2013,12,14192,2580,16772
2,9,11,1,2013,13,14573,2575,17148
2,9,11,1,2013,14,14346,2537,16883
2,9,11,1,2013,15,14391,2545,16936
2,9,11,1,2013,16,14184,2524,16708
2,9,11,1,2013,17,13764,2471,16235
2,9,11,1,2013,18,12444,2429,14873
2,9,11,1,2013,19,12459,2556,15015
2,9,11,1,2013,20,12286,2565,14851
2,9,11,1,2013,21,11964,2405,14369
2,9,11,1,2013,22,11594,2396,13990
2,9,11,1,2013,23,11540,2263,13803
2,9,11,1,2013,24,11469,2177,13646
2,10,11,1,2013,1,11539,2004,13543
2,10,11,1,2013,2,11448,1848,13296
2,10,11,1,2013,3,11480,1738,13218
2,10,11,1,2013,4,11412,1701,13113
2,10,11,1,2013,5,11667,1654,13321
2,10,11,1,2013,6,12196,1687,13883
2,10,11,1,2013,7,12383,1671,14054
2,10,11,1,2013,8,13199,1661,14860
2,10,11,1,2013,9,13644,1765,15409
2,10,11,1,2013,10,14024,1884,15908
2,10,11,1,2013,11,14368,1981,16349
2,10,11,1,2013,12,14467,2016,16483
2,10,11,1,2013,13,14312,2067,16379
2,10,11,1,2013,14,14169,2033,16202
2,10,11,1,2013,15,14100,2019,16119
2,10,11,1,2013,16,14048,1994,16042
2,10,11,1,2013,17,13555,1927,15482
2,10,11,1,2013,18,12314,1921,14235
2,10,11,1,2013,19,12747,2089,14836
2,10,11,1,2013,20,12291,2166,14457
2,10,11,1,2013,21,12312,2174,14486
2,10,11,1,2013,22,11907,2164,14071
2,10,11,1,2013,23,11693,2140,13833
2,10,11,1,2013,24,11788,2087,13875
1,11,11,1,2013,1,12174,1986,14160
1,11,11,1,2013,2,11992,1800,13792
1,11,11,1,2013,3,11850,1697,13547
1,11,11,1,2013,4,11874,1636,13510
1,11,11,1,2013,5,11858,1613,13471
1,11,11,1,2013,6,12564,1682,14246
1,11,11,1,2013,7,13123,1744,14867
1,11,11,1,2013,8,13774,1873,15647
1,11,11,1,2013,9,14065,2164,16229
1,11,11,1,2013,10,14699,2522,17221
1,11,11,1,2013,11,14997,2753,17750
1,11,11,1,2013,12,14878,2802,17680
1,11,11,1,2013,13,14878,2799,17677
1,11,11,1,2013,14,14860,2678,17538
1,11,11,1,2013,15,14763,2707,17470
1,11,11,1,2013,16,14793,2692,17485
1,11,11,1,2013,17,14646,2694,17340
1,11,11,1,2013,18,12612,2640,15252
1,11,11,1,2013,19,13126,2690,15816
1,11,11,1,2013,20,12717,2626,15343
1,11,11,1,2013,21,12676,2462,15138
1,11,11,1,2013,22,12263,2304,14567
1,11,11,1,2013,23,11940,2170,14110
1,11,11,1,2013,24,11959,2059,14018
1,12,11,1,2013,1,12263,1889,14152
1,12,11,1,2013,2,12086,1746,13832
1,12,11,1,2013,3,11929,1652,13581
1,12,11,1,2013,4,11916,1588,13504
1,12,11,1,2013,5,12183,1593,13776
1,12,11,1,2013,6,12814,1672,14486
1,12,11,1,2013,7,13338,1770,15108
1,12,11,1,2013,8,14118,1897,16015
1,12,11,1,2013,9,14271,2177,16448
1,12,11,1,2013,10,14463,2533,16996
1,12,11,1,2013,11,15010,2761,17771
1,12,11,1,2013,12,15305,2818,18123
1,12,11,1,2013,13,15130,2813,17943
1,12,11,1,2013,14,14814,2716,17530
1,12,11,1,2013,15,14871,2735,17606
1,12,11,1,2013,16,14948,2727,17675
1,12,11,1,2013,17,14278,2717,16995
1,12,11,1,2013,18,12834,2685,15519
1,12,11,1,2013,19,12900,2730,15630
1,12,11,1,2013,20,12730,2667,15397
1,12,11,1,2013,21,12888,2517,15405
1,12,11,1,2013,22,12222,2359,14581
1,12,11,1,2013,23,12024,2171,14195
1,12,11,1,2013,24,12039,2012,14051
1,13,11,1,2013,1,11995,1871,13866
1,13,11,1,2013,2,11952,1716,13668
1,13,11,1,2013,3,11764,1632,13396
1,13,11,1,2013,4,11867,1579,13446
1,13,11,1,2013,5,11996,1574,13570
1,13,11,1,2013,6,12805,1659,14464
1,13,11,1,2013,7,13297,1750,15047
1,13,11,1,2013,8,14011,1872,15883
1,13,11,1,2013,9,14220,2160,16380
1,13,11,1,2013,10,14762,2509,17271
1,13,11,1,2013,11,15057,2737,17794
1,13,11,1,2013,12,15522,2785,18307
1,13,11,1,2013,13,15054,2775,17829
1,13,11,1,2013,14,14706,2680,17386
1,13,11,1,2013,15,14798,2694,17492
1,13,11,1,2013,16,14525,2694,17219
1,13,11,1,2013,17,14144,2696,16840
1,13,11,1,2013,18,12958,2680,15638
1,13,11,1,2013,19,13188,2740,15928
1,13,11,1,2013,20,12951,2687,15638
1,13,11,1,2013,21,12383,2576,14959
1,13,11,1,2013,22,11907,2328,14235
1,13,11,1,2013,23,11625,2211,13836
1,13,11,1,2013,24,11818,2067,13885
3,14,11,1,2013,1,11804,1904,13708
3,14,11,1,2013,2,11732,1749,13481
3,14,11,1,2013,3,11748,1658,13406
3,14,11,1,2013,4,11779,1588,13367
3,14,11,1,2013,5,12071,1572,13643
3,14,11,1,2013,6,12709,1639,14348
3,14,11,1,2013,7,13294,1718,15012
3,14,11,1,2013,8,13969,1870,15839
3,14,11,1,2013,9,14297,2145,16442
3,14,11,1,2013,10,14409,2490,16899
3,14,11,1,2013,11,14930,2717,17647
3,14,11,1,2013,12,14902,2766,17668
3,14,11,1,2013,13,14908,2710,17618
3,14,11,1,2013,14,14526,2652,17178
3,14,11,1,2013,15,14666,2696,17362
3,14,11,1,2013,16,14613,2752,17365
3,14,11,1,2013,17,14059,2695,16754
3,14,11,1,2013,18,12737,2678,15415
3,14,11,1,2013,19,13158,2683,15841
3,14,11,1,2013,20,12913,2673,15586
3,14,11,1,2013,21,12428,2532,14960
3,14,11,1,2013,22,11810,2358,14168
3,14,11,1,2013,23,11771,2224,13995
3,14,11,1,2013,24,11869,2064,13933
1,15,11,1,2013,1,12027,1885,13912
1,15,11,1,2013,2,11867,1738,13605
1,15,11,1,2013,3,11697,1641,13338
1,15,11,1,2013,4,11898,1579,13477
1,15,11,1,2013,5,12229,1578,13807
1,15,11,1,2013,6,12855,1659,14514
1,15,11,1,2013,7,13433,1723,15156
1,15,11,1,2013,8,14331,1820,16151
1,15,11,1,2013,9,14467,2046,16513
1,15,11,1,2013,10,14642,2351,16993
1,15,11,1,2013,11,14832,2555,17387
1,15,11,1,2013,12,14710,2605,17315
1,15,11,1,2013,13,14374,2597,16971
1,15,11,1,2013,14,14209,2490,16699
1,15,11,1,2013,15,14115,2503,16618
1,15,11,1,2013,16,14135,2492,16627
1,15,11,1,2013,17,13573,2481,16054
1,15,11,1,2013,18,12220,2475,14695
1,15,11,1,2013,19,12589,2586,15175
1,15,11,1,2013,20,12352,2561,14913
1,15,11,1,2013,21,12112,2462,14574
1,15,11,1,2013,22,11588,2195,13783
1,15,11,1,2013,23,11247,2125,13372
1,15,11,1,2013,24,11297,1975,13272
2,16,11,1,2013,1,11352,1842,13194
2,16,11,1,2013,2,11388,1672,13060
2,16,11,1,2013,3,11491,1573,13064
2,16,11,1,2013,4,11357,1536,12893
2,16,11,1,2013,5,11809,1523,13332
2,16,11,1,2013,6,12473,1595,14068
2,16,11,1,2013,7,13160,1674,14834
2,16,11,1,2013,8,14109,1757,15866
2,16,11,1,2013,9,14314,1953,16267
2,16,11,1,2013,10,14607,2258,16865
2,16,11,1,2013,11,14385,2479,16864
2,16,11,1,2013,12,14693,2534,17227
2,16,11,1,2013,13,14597,2526,17123
2,16,11,1,2013,14,14359,2414,16773
2,16,11,1,2013,15,14712,2402,17114
2,16,11,1,2013,16,14588,2381,16969
2,16,11,1,2013,17,13975,2370,16345
2,16,11,1,2013,18,12556,2366,14922
2,16,11,1,2013,19,12802,2494,15296
2,16,11,1,2013,20,12534,2502,15036
2,16,11,1,2013,21,12077,2375,14452
2,16,11,1,2013,22,11649,2180,13829
2,16,11,1,2013,23,11342,2053,13395
2,16,11,1,2013,24,11495,1892,13387
3,17,11,1,2013,1,11292,1760,13052
3,17,11,1,2013,2,11488,1624,13112
3,17,11,1,2013,3,11227,1547,12774
3,17,11,1,2013,4,11371,1494,12865
3,17,11,1,2013,5,11836,1479,13315
3,17,11,1,2013,6,12305,1542,13847
3,17,11,1,2013,7,13120,1574,14694
3,17,11,1,2013,8,13526,1573,15099
3,17,11,1,2013,9,14072,1655,15727
3,17,11,1,2013,10,14311,1790,16101
3,17,11,1,2013,11,14731,1886,16617
3,17,11,1,2013,12,14877,1936,16813
3,17,11,1,2013,13,14710,1934,16644
3,17,11,1,2013,14,14361,1895,16256
3,17,11,1,2013,15,14316,1876,16192
3,17,11,1,2013,16,14334,1845,16179
3,17,11,1,2013,17,13641,1852,15493
3,17,11,1,2013,18,12136,1893,14029
3,17,11,1,2013,19,12414,2107,14521
3,17,11,1,2013,20,12294,2171,14465
3,17,11,1,2013,21,11953,2142,14095
3,17,11,1,2013,22,11410,2091,13501
3,17,11,1,2013,23,11300,1993,13293
3,17,11,1,2013,24,11220,1867,13087
1,18,11,1,2013,1,11264,1743,13007
1,18,11,1,2013,2,11293,1586,12879
1,18,11,1,2013,3,11237,1520,12757
1,18,11,1,2013,4,11358,1470,12828
1,18,11,1,2013,5,11719,1466,13185
1,18,11,1,2013,6,12492,1567,14059
1,18,11,1,2013,7,13335,1687,15022
1,18,11,1,2013,8,13569,1851,15420
1,18,11,1,2013,9,13867,2163,16030
1,18,11,1,2013,10,14531,2471,17002
1,18,11,1,2013,11,14914,2708,17622
1,18,11,1,2013,12,14904,2782,17686
1,18,11,1,2013,13,14813,2775,17588
1,18,11,1,2013,14,14617,2701,17318
1,18,11,1,2013,15,14632,2717,17349
1,18,11,1,2013,16,14753,2711,17464
1,18,11,1,2013,17,14001,2709,16710
1,18,11,1,2013,18,12964,2682,15646
1,18,11,1,2013,19,13265,2721,15986
1,18,11,1,2013,20,12447,2653,15100
1,18,11,1,2013,21,12405,2485,14890
1,18,11,1,2013,22,11700,2328,14028
1,18,11,1,2013,23,11990,2208,14198
1,18,11,1,2013,24,12095,2064,14159
1,19,11,1,2013,1,11943,1879,13822
1,19,11,1,2013,2,11869,1738,13607
1,19,11,1,2013,3,11833,1655,13488
1,19,11,1,2013,4,11836,1592,13428
1,19,11,1,2013,5,12256,1583,13839
1,19,11,1,2013,6,13034,1675,14709
1,19,11,1,2013,7,13892,1813,15705
1,19,11,1,2013,8,14526,1936,16462
1,19,11,1,2013,9,14673,2208,16881
1,19,11,1,2013,10,15020,2548,17568
1,19,11,1,2013,11,15278,2784,18062
1,19,11,1,2013,12,15217,2814,18031
1,19,11,1,2013,13,15205,2812,18017
1,19,11,1,2013,14,15111,2728,17839
1,19,11,1,2013,15,15008,2761,17769
1,19,11,1,2013,16,15119,2773,17892
1,19,11,1,2013,17,14409,2763,17172
1,19,11,1,2013,18,13024,2723,15747
1,19,11,1,2013,19,13188,2753,15941
1,19,11,1,2013,20,12680,2685,15365
1,19,11,1,2013,21,12168,2517,14685
1,19,11,1,2013,22,11679,2329,14008
1,19,11,1,2013,23,11772,2201,13973
1,19,11,1,2013,24,11737,2074,13811
1,20,11,1,2013,1,12177,1891,14068
1,20,11,1,2013,2,12350,1716,14066
1,20,11,1,2013,3,12382,1622,14004
1,20,11,1,2013,4,12402,1579,13981
1,20,11,1,2013,5,12637,1578,14215
1,20,11,1,2013,6,13177,1663,14840
1,20,11,1,2013,7,13784,1792,15576
1,20,11,1,2013,8,14431,1916,16347
1,20,11,1,2013,9,14646,2191,16837
1,20,11,1,2013,10,14910,2529,17439
1,20,11,1,2013,11,15029,2773,17802
1,20,11,1,2013,12,15275,2835,18110
1,20,11,1,2013,13,14840,2834,17674
1,20,11,1,2013,14,14522,2724,17246
1,20,11,1,2013,15,14673,2756,17429
1,20,11,1,2013,16,14964,2741,17705
1,20,11,1,2013,17,14330,2731,17061
1,20,11,1,2013,18,12916,2682,15598
1,20,11,1,2013,19,13461,2729,16190
1,20,11,1,2013,20,13049,2644,15693
1,20,11,1,2013,21,12459,2488,14947
1,20,11,1,2013,22,11974,2314,14288
1,20,11,1,2013,23,11860,2176,14036
1,20,11,1,2013,24,11830,2022,13852
1,21,11,1,2013,1,11991,1839,13830
1,21,11,1,2013,2,12066,1666,13732
1,21,11,1,2013,3,12195,1588,13783
1,21,11,1,2013,4,12143,1534,13677
1,21,11,1,2013,5,12354,1518,13872
1,21,11,1,2013,6,12980,1603,14583
1,21,11,1,2013,7,13813,1747,15560
1,21,11,1,2013,8,14348,1881,16229
1,21,11,1,2013,9,14780,2154,16934
1,21,11,1,2013,10,14761,2494,17255
1,21,11,1,2013,11,14903,2682,17585
1,21,11,1,2013,12,15206,2720,17926
1,21,11,1,2013,13,15185,2714,17899
1,21,11,1,2013,14,14640,2664,17304
1,21,11,1,2013,15,14728,2711,17439
1,21,11,1,2013,16,14904,2688,17592
1,21,11,1,2013,17,14287,2673,16960
1,21,11,1,2013,18,13171,2640,15811
1,21,11,1,2013,19,13202,2705,15907
1,21,11,1,2013,20,12784,2647,15431
1,21,11,1,2013,21,12348,2463,14811
1,21,11,1,2013,22,11779,2290,14069
1,21,11,1,2013,23,11564,2175,13739
1,21,11,1,2013,24,11494,1988,13482
1,22,11,1,2013,1,11701,1769,13470
1,22,11,1,2013,2,11754,1632,13386
1,22,11,1,2013,3,11989,1555,13544
1,22,11,1,2013,4,11960,1508,13468
1,22,11,1,2013,5,12111,1496,13607
1,22,11,1,2013,6,12842,1588,14430
1,22,11,1,2013,7,13696,1703,15399
1,22,11,1,2013,8,14015,1851,15866
1,22,11,1,2013,9,14423,2146,16569
1,22,11,1,2013,10,14620,2477,17097
1,22,11,1,2013,11,14960,2694,17654
1,22,11,1,2013,12,15001,2738,17739
1,22,11,1,2013,13,14784,2729,17513
1,22,11,1,2013,14,14548,2650,17198
1,22,11,1,2013,15,14522,2671,17193
1,22,11,1,2013,16,14544,2682,17226
1,22,11,1,2013,17,13931,2683,16614
1,22,11,1,2013,18,12711,2663,15374
1,22,11,1,2013,19,12844,2734,15578
1,22,11,1,2013,20,12376,2682,15058
1,22,11,1,2013,21,12157,2495,14652
1,22,11,1,2013,22,11572,2351,13923
1,22,11,1,2013,23,11509,2172,13681
1,22,11,1,2013,24,11693,2029,13722
2,23,11,1,2013,1,11824,1819,13643
2,23,11,1,2013,2,12026,1671,13697
2,23,11,1,2013,3,11949,1579,13528
2,23,11,1,2013,4,11975,1523,13498
2,23,11,1,2013,5,12200,1522,13722
2,23,11,1,2013,6,13010,1604,14614
2,23,11,1,2013,7,13812,1685,15497
2,23,11,1,2013,8,14439,1758,16197
2,23,11,1,2013,9,14642,1971,16613
2,23,11,1,2013,10,14783,2276,17059
2,23,11,1,2013,11,15147,2494,17641
2,23,11,1,2013,12,15333,2550,17883
2,23,11,1,2013,13,15603,2549,18152
2,23,11,1,2013,14,15030,2493,17523
2,23,11,1,2013,15,14974,2473,17447
2,23,11,1,2013,16,15010,2448,17458
2,23,11,1,2013,17,14172,2446,16618
2,23,11,1,2013,18,13218,2449,15667
2,23,11,1,2013,19,12969,2547,15516
2,23,11,1,2013,20,12810,2547,15357
2,23,11,1,2013,21,12536,2391,14927
2,23,11,1,2013,22,11932,2230,14162
2,23,11,1,2013,23,12033,2158,14191
2,23,11,1,2013,24,12071,1981,14052
2,24,11,1,2013,1,12223,1843,14066
2,24,11,1,2013,2,12335,1685,14020
2,24,11,1,2013,3,12213,1585,13798
2,24,11,1,2013,4,12015,1538,13553
2,24,11,1,2013,5,12141,1520,13661
2,24,11,1,2013,6,12786,1580,14366
2,24,11,1,2013,7,13397,1605,15002
2,24,11,1,2013,8,13836,1632,15468
2,24,11,1,2013,9,13959,1737,15696
2,24,11,1,2013,10,14416,1874,16290
2,24,11,1,2013,11,14980,1995,16975
2,24,11,1,2013,12,15023,2043,17066
2,24,11,1,2013,13,14788,2053,16841
2,24,11,1,2013,14,14748,1989,16737
2,24,11,1,2013,15,14776,1962,16738
2,24,11,1,2013,16,14916,1928,16844
2,24,11,1,2013,17,14226,1937,16163
2,24,11,1,2013,18,12828,1987,14815
2,24,11,1,2013,19,12972,2170,15142
2,24,11,1,2013,20,12319,2218,14537
2,24,11,1,2013,21,12369,2187,14556
2,24,11,1,2013,22,11928,2143,14071
2,24,11,1,2013,23,12124,2135,14259
2,24,11,1,2013,24,11976,2027,14003
1,25,11,1,2013,1,12112,1885,13997
1,25,11,1,2013,2,11877,1733,13610
1,25,11,1,2013,3,11783,1650,13433
1,25,11,1,2013,4,11764,1582,13346
1,25,11,1,2013,5,11983,1592,13575
1,25,11,1,2013,6,12516,1685,14201
1,25,11,1,2013,7,13057,1835,14892
1,25,11,1,2013,8,13798,1989,15787
1,25,11,1,2013,9,14262,2284,16546
1,25,11,1,2013,10,14506,2626,17132
1,25,11,1,2013,11,14923,2860,17783
1,25,11,1,2013,12,15060,2873,17933
1,25,11,1,2013,13,14836,2872,17708
1,25,11,1,2013,14,14451,2787,17238
1,25,11,1,2013,15,14659,2820,17479
1,25,11,1,2013,16,14902,2824,17726
1,25,11,1,2013,17,14166,2803,16969
1,25,11,1,2013,18,13305,2766,16071
1,25,11,1,2013,19,13353,2802,16155
1,25,11,1,2013,20,12866,2726,15592
1,25,11,1,2013,21,12531,2570,15101
1,25,11,1,2013,22,12027,2415,14442
1,25,11,1,2013,23,11971,2289,14260
1,25,11,1,2013,24,12003,2175,14178
1,26,11,1,2013,1,12091,2019,14110
1,26,11,1,2013,2,12219,1824,14043
1,26,11,1,2013,3,12201,1728,13929
1,26,11,1,2013,4,11925,1682,13607
1,26,11,1,2013,5,12197,1673,13870
1,26,11,1,2013,6,12927,1735,14662
1,26,11,1,2013,7,13647,1868,15515
1,26,11,1,2013,8,14191,2040,16231
1,26,11,1,2013,9,14681,2317,16998
1,26,11,1,2013,10,14680,2676,17356
1,26,11,1,2013,11,15051,2929,17980
1,26,11,1,2013,12,15287,2966,18253
1,26,11,1,2013,13,15123,2963,18086
1,26,11,1,2013,14,14919,2860,17779
1,26,11,1,2013,15,14895,2896,17791
1,26,11,1,2013,16,15094,2901,17995
1,26,11,1,2013,17,14273,2886,17159
1,26,11,1,2013,18,13184,2839,16023
1,26,11,1,2013,19,13536,2817,16353
1,26,11,1,2013,20,13127,2742,15869
1,26,11,1,2013,21,12736,2600,15336
1,26,11,1,2013,22,12314,2401,14715
1,26,11,1,2013,23,12084,2328,14412
1,26,11,1,2013,24,11958,2237,14195
1,27,11,1,2013,1,12084,1990,14074
1,27,11,1,2013,2,11992,1815,13807
1,27,11,1,2013,3,12027,1719,13746
1,27,11,1,2013,4,11996,1674,13670
1,27,11,1,2013,5,12168,1664,13832
1,27,11,1,2013,6,13000,1726,14726
1,27,11,1,2013,7,13604,1860,15464
1,27,11,1,2013,8,13960,2029,15989
1,27,11,1,2013,9,14300,2309,16609
1,27,11,1,2013,10,14729,2668,17397
1,27,11,1,2013,11,14802,2918,17720
1,27,11,1,2013,12,14893,2979,17872
1,27,11,1,2013,13,14892,2919,17811
1,27,11,1,2013,14,14789,2871,17660
1,27,11,1,2013,15,14609,2910,17519
1,27,11,1,2013,16,14829,2903,17732
1,27,11,1,2013,17,14147,2884,17031
1,27,11,1,2013,18,13301,2852,16153
1,27,11,1,2013,19,13412,2895,16307
1,27,11,1,2013,20,13008,2813,15821
1,27,11,1,2013,21,12455,2636,15091
1,27,11,1,2013,22,12041,2518,14559
1,27,11,1,2013,23,11879,2328,14207
1,27,11,1,2013,24,11877,2220,14097
1,28,11,1,2013,1,11978,2074,14052
1,28,11,1,2013,2,11934,1870,13804
1,28,11,1,2013,3,12046,1799,13845
1,28,11,1,2013,4,12002,1750,13752
1,28,11,1,2013,5,12148,1760,13908
1,28,11,1,2013,6,12982,1818,14800
1,28,11,1,2013,7,13713,1916,15629
1,28,11,1,2013,8,14206,2035,16241
1,28,11,1,2013,9,14300,2281,16581
1,28,11,1,2013,10,14430,2587,17017
1,28,11,1,2013,11,14827,2800,17627
1,28,11,1,2013,12,14773,2871,17644
1,28,11,1,2013,13,14512,2867,17379
1,28,11,1,2013,14,14251,2787,17038
1,28,11,1,2013,15,14566,2823,17389
1,28,11,1,2013,16,14655,2846,17501
1,28,11,1,2013,17,14009,2836,16845
1,28,11,1,2013,18,12620,2787,15407
1,28,11,1,2013,19,13032,2728,15760
1,28,11,1,2013,20,12852,2751,15603
1,28,11,1,2013,21,12674,2564,15238
1,28,11,1,2013,22,12226,2373,14599
1,28,11,1,2013,23,11846,2216,14062
1,28,11,1,2013,24,11817,2053,13870
1,29,11,1,2013,1,11770,1843,13613
1,29,11,1,2013,2,11395,1725,13120
1,29,11,1,2013,3,11345,1657,13002
1,29,11,1,2013,4,11320,1613,12933
1,29,11,1,2013,5,11665,1616,13281
1,29,11,1,2013,6,12404,1687,14091
1,29,11,1,2013,7,13417,1807,15224
1,29,11,1,2013,8,14144,1991,16135
1,29,11,1,2013,9,14201,2189,16390
1,29,11,1,2013,10,14526,2508,17034
1,29,11,1,2013,11,14853,2698,17551
1,29,11,1,2013,12,14976,2792,17768
1,29,11,1,2013,13,14732,2789,17521
1,29,11,1,2013,14,14498,2662,17160
1,29,11,1,2013,15,14428,2699,17127
1,29,11,1,2013,16,14382,2700,17082
1,29,11,1,2013,17,13747,2697,16444
1,29,11,1,2013,18,12788,2670,15458
1,29,11,1,2013,19,12870,2737,15607
1,29,11,1,2013,20,12469,2672,15141
1,29,11,1,2013,21,12218,2513,14731
1,29,11,1,2013,22,11710,2343,14053
1,29,11,1,2013,23,11469,2175,13644
1,29,11,1,2013,24,11441,2031,13472
2,30,11,1,2013,1,11472,1908,13380
2,30,11,1,2013,2,11353,1740,13093
2,30,11,1,2013,3,11366,1647,13013
2,30,11,1,2013,4,11312,1606,12918
2,30,11,1,2013,5,11483,1594,13077
2,30,11,1,2013,6,12571,1667,14238
2,30,11,1,2013,7,13152,1756,14908
2,30,11,1,2013,8,13876,1846,15722
2,30,11,1,2013,9,14092,2091,16183
2,30,11,1,2013,10,14417,2434,16851
2,30,11,1,2013,11,14754,2673,17427
2,30,11,1,2013,12,15047,2740,17787
2,30,11,1,2013,13,14793,2728,17521
2,30,11,1,2013,14,14583,2652,17235
2,30,11,1,2013,15,14709,2639,17348
2,30,11,1,2013,16,14673,2608,17281
2,30,11,1,2013,17,14164,2585,16749
2,30,11,1,2013,18,13107,2581,15688
2,30,11,1,2013,19,13350,2653,16003
2,30,11,1,2013,20,12590,2612,15202
2,30,11,1,2013,21,12462,2517,14979
2,30,11,1,2013,22,11971,2334,14305
2,30,11,1,2013,23,12038,2209,14247
2,30,11,1,2013,24,11883,2147,14030
2,1,12,1,2013,1,12068,1985,14053
2,1,12,1,2013,2,11911,1826,13737
2,1,12,1,2013,3,12025,1721,13746
2,1,12,1,2013,4,11993,1643,13636
2,1,12,1,2013,5,12162,1622,13784
2,1,12,1,2013,6,12722,1670,14392
2,1,12,1,2013,7,13117,1706,14823
2,1,12,1,2013,8,13984,1717,15701
2,1,12,1,2013,9,14142,1811,15953
2,1,12,1,2013,10,14571,1929,16500
2,1,12,1,2013,11,15002,2079,17081
2,1,12,1,2013,12,15450,2098,17548
2,1,12,1,2013,13,15046,2133,17179
2,1,12,1,2013,14,14965,2105,17070
2,1,12,1,2013,15,14865,2044,16909
2,1,12,1,2013,16,14661,2017,16678
2,1,12,1,2013,17,13883,2005,15888
2,1,12,1,2013,18,12828,2018,14846
2,1,12,1,2013,19,12763,2245,15008
2,1,12,1,2013,20,12678,2264,14942
2,1,12,1,2013,21,12219,2263,14482
2,1,12,1,2013,22,12129,2223,14352
2,1,12,1,2013,23,11999,2216,14215
2,1,12,1,2013,24,11999,2116,14115
1,2,12,1,2013,1,12216,1968,14184
1,2,12,1,2013,2,12040,1804,13844
1,2,12,1,2013,3,11944,1715,13659
1,2,12,1,2013,4,11985,1656,13641
1,2,12,1,2013,5,12231,1651,13882
1,2,12,1,2013,6,12808,1746,14554
1,2,12,1,2013,7,13548,1900,15448
1,2,12,1,2013,8,14594,2047,16641
1,2,12,1,2013,9,14561,2307,16868
1,2,12,1,2013,10,14771,2656,17427
1,2,12,1,2013,11,15306,2903,18209
1,2,12,1,2013,12,15523,2950,18473
1,2,12,1,2013,13,15435,2920,18355
1,2,12,1,2013,14,15267,2864,18131
1,2,12,1,2013,15,15072,2871,17943
1,2,12,1,2013,16,15034,2869,17903
1,2,12,1,2013,17,14249,2855,17104
1,2,12,1,2013,18,13111,2809,15920
1,2,12,1,2013,19,13376,2853,16229
1,2,12,1,2013,20,12882,2766,15648
1,2,12,1,2013,21,12734,2634,15368
1,2,12,1,2013,22,12128,2457,14585
1,2,12,1,2013,23,12061,2341,14402
1,2,12,1,2013,24,11955,2211,14166
1,3,12,1,2013,1,41,11863,2008
1,3,12,1,2013,2,85,11656,1862
1,3,12,1,2013,3,85,11640,1763
1,3,12,1,2013,4,85,11703,1692
1,3,12,1,2013,5,115,11882,1668
1,3,12,1,2013,6,249,12291,1763
1,3,12,1,2013,7,657,13115,1911
1,3,12,1,2013,8,733,13081,2009
1,3,12,1,2013,9,691,13796,2313
1,3,12,1,2013,10,513,13948,2639
1,3,12,1,2013,11,505,14201,2872
1,3,12,1,2013,12,630,14554,2941
1,3,12,1,2013,13,765,14444,2937
1,3,12,1,2013,14,685,14242,2860
1,3,12,1,2013,15,594,14399,2904
1,3,12,1,2013,16,531,14414,2897
1,3,12,1,2013,17,507,14036,2876
1,3,12,1,2013,18,704,12884,2825
1,3,12,1,2013,19,551,13405,2823
1,3,12,1,2013,20,521,13094,2722
1,3,12,1,2013,21,320,12750,2502
1,3,12,1,2013,22,172,12473,2328
1,3,12,1,2013,23,116,12407,2195
1,3,12,1,2013,24,83,12152,2071
1,4,12,1,2013,1,61,12046,1909
1,4,12,1,2013,2,13,11856,1746
1,4,12,1,2013,3,13,11760,1666
1,4,12,1,2013,4,13,11776,1623
1,4,12,1,2013,5,49,12070,1616
1,4,12,1,2013,6,242,12795,1713
1,4,12,1,2013,7,677,13194,1878
1,4,12,1,2013,8,871,13611,2000
1,4,12,1,2013,9,922,14035,2287
1,4,12,1,2013,10,672,14344,2601
1,4,12,1,2013,11,590,14514,2830
1,4,12,1,2013,12,627,14507,2884
1,4,12,1,2013,13,747,14342,2881
1,4,12,1,2013,14,635,14063,2814
1,4,12,1,2013,15,509,14167,2858
1,4,12,1,2013,16,424,14240,2873
1,4,12,1,2013,17,383,13442,2857
1,4,12,1,2013,18,579,13051,2843
1,4,12,1,2013,19,535,13272,2884
1,4,12,1,2013,20,572,12849,2814
1,4,12,1,2013,21,391,12437,2650
1,4,12,1,2013,22,210,11984,2473
1,4,12,1,2013,23,154,11997,2328
1,4,12,1,2013,24,126,11990,2207
1,5,12,1,2013,1,41,11884,2020
1,5,12,1,2013,2,80,11984,1828
1,5,12,1,2013,3,80,12017,1740
1,5,12,1,2013,4,84,11971,1678
1,5,12,1,2013,5,114,12046,1667
1,5,12,1,2013,6,266,12898,1776
1,5,12,1,2013,7,940,13528,1909
1,5,12,1,2013,8,955,14075,2033
1,5,12,1,2013,9,893,14192,2303
1,5,12,1,2013,10,661,14457,2641
1,5,12,1,2013,11,610,14827,2860
1,5,12,1,2013,12,714,14723,2887
1,5,12,1,2013,13,839,14507,2883
1,5,12,1,2013,14,725,14167,2797
1,5,12,1,2013,15,538,14230,2829
1,5,12,1,2013,16,477,14356,2837
1,5,12,1,2013,17,454,13617,2824
1,5,12,1,2013,18,678,12993,2799
1,5,12,1,2013,19,586,13132,2865
1,5,12,1,2013,20,615,12848,2776
1,5,12,1,2013,21,310,12275,2608
1,5,12,1,2013,22,136,11854,2434
1,5,12,1,2013,23,68,11800,2309
1,5,12,1,2013,24,54,11740,2170
1,6,12,1,2013,1,11,11577,1961
1,6,12,1,2013,2,20,11523,1801
1,6,12,1,2013,3,20,11291,1705
1,6,12,1,2013,4,20,11436,1642
1,6,12,1,2013,5,23,11777,1626
1,6,12,1,2013,6,185,12506,1728
1,6,12,1,2013,7,985,13381,1856
1,6,12,1,2013,8,1027,13827,1986
1,6,12,1,2013,9,966,14107,2254
1,6,12,1,2013,10,703,14356,2583
1,6,12,1,2013,11,661,14552,2797
1,6,12,1,2013,12,777,14552,2856
1,6,12,1,2013,13,917,14393,2853
1,6,12,1,2013,14,794,14191,2749
1,6,12,1,2013,15,612,13932,2791
1,6,12,1,2013,16,520,13961,2770
1,6,12,1,2013,17,484,13458,2760
1,6,12,1,2013,18,655,12225,2747
1,6,12,1,2013,19,539,12445,2815
1,6,12,1,2013,20,608,12204,2743
1,6,12,1,2013,21,371,11941,2559
1,6,12,1,2013,22,215,11351,2373
1,6,12,1,2013,23,147,11337,2222
1,6,12,1,2013,24,122,11342,2083
2,7,12,1,2013,1,10,11375,1926
2,7,12,1,2013,2,19,11465,1755
2,7,12,1,2013,3,19,11306,1664
2,7,12,1,2013,4,19,11278,1603
2,7,12,1,2013,5,19,11419,1590
2,7,12,1,2013,6,292,12020,1678
2,7,12,1,2013,7,818,12744,1767
2,7,12,1,2013,8,879,13462,1840
2,7,12,1,2013,9,870,14027,2063
2,7,12,1,2013,10,678,14106,2357
2,7,12,1,2013,11,656,14377,2586
2,7,12,1,2013,12,788,14721,2634
2,7,12,1,2013,13,939,14551,2633
2,7,12,1,2013,14,806,14172,2494
2,7,12,1,2013,15,604,14311,2489
2,7,12,1,2013,16,499,14355,2466
2,7,12,1,2013,17,461,13736,2428
2,7,12,1,2013,18,657,12566,2440
2,7,12,1,2013,19,582,12762,2538
2,7,12,1,2013,20,570,12587,2540
2,7,12,1,2013,21,293,12112,2428
2,7,12,1,2013,22,139,11379,2262
2,7,12,1,2013,23,65,11355,2107
2,7,12,1,2013,24,64,11286,1970
2,8,12,1,2013,1,50,11308,1810
2,8,12,1,2013,2,98,11124,1660
2,8,12,1,2013,3,98,11224,1572
2,8,12,1,2013,4,98,11174,1508
2,8,12,1,2013,5,98,11377,1500
2,8,12,1,2013,6,181,11749,1542
2,8,12,1,2013,7,390,12447,1520
2,8,12,1,2013,8,779,13193,1626
2,8,12,1,2013,9,971,13871,1724
2,8,12,1,2013,10,761,14085,1854
2,8,12,1,2013,11,742,14987,1968
2,8,12,1,2013,12,869,14915,1991
2,8,12,1,2013,13,994,14626,2066
2,8,12,1,2013,14,854,14300,1920
2,8,12,1,2013,15,656,14201,1869
2,8,12,1,2013,16,573,14275,1825
2,8,12,1,2013,17,573,13712,1822
2,8,12,1,2013,18,707,12423,1858
2,8,12,1,2013,19,311,12473,2071
2,8,12,1,2013,20,331,12437,2129
2,8,12,1,2013,21,197,12257,2122
2,8,12,1,2013,22,92,11572,2063
2,8,12,1,2013,23,30,11189,1943
2,8,12,1,2013,24,24,11206,1835
1,9,12,1,2013,1,8,11002,1671
1,9,12,1,2013,2,17,11023,1529
1,9,12,1,2013,3,30,11183,1460
1,9,12,1,2013,4,30,11195,1409
1,9,12,1,2013,5,37,11399,1410
1,9,12,1,2013,6,136,12023,1512
1,9,12,1,2013,7,418,12627,1683
1,9,12,1,2013,8,873,13627,1803
1,9,12,1,2013,9,890,14158,2059
1,9,12,1,2013,10,675,14841,2368
1,9,12,1,2013,11,644,14818,2568
1,9,12,1,2013,12,779,14855,2598
1,9,12,1,2013,13,918,15011,2590
1,9,12,1,2013,14,804,14657,2505
1,9,12,1,2013,15,664,14672,2524
1,9,12,1,2013,16,585,14780,2519
1,9,12,1,2013,17,556,14159,2522
1,9,12,1,2013,18,682,12935,2508
1,9,12,1,2013,19,259,12965,2584
1,9,12,1,2013,20,275,12977,2528
1,9,12,1,2013,21,148,12686,2384
1,9,12,1,2013,22,75,12038,2170
1,9,12,1,2013,23,29,11619,1996
1,9,12,1,2013,24,31,11577,1824
1,10,12,1,2013,1,8,11496,1639
1,10,12,1,2013,2,17,11539,1511
1,10,12,1,2013,3,29,11233,1439
1,10,12,1,2013,4,29,11368,1389
1,10,12,1,2013,5,38,11901,1400
1,10,12,1,2013,6,158,12671,1498
1,10,12,1,2013,7,444,13176,1685
1,10,12,1,2013,8,875,14344,1806
1,10,12,1,2013,9,908,14843,2034
1,10,12,1,2013,10,700,14957,2333
1,10,12,1,2013,11,673,15322,2548
1,10,12,1,2013,12,816,15319,2585
1,10,12,1,2013,13,957,15115,2582
1,10,12,1,2013,14,828,14783,2482
1,10,12,1,2013,15,641,14736,2523
1,10,12,1,2013,16,542,14955,2528
1,10,12,1,2013,17,525,14529,2540
1,10,12,1,2013,18,611,13308,2535
1,10,12,1,2013,19,354,13092,2584
1,10,12,1,2013,20,368,12761,2573
1,10,12,1,2013,21,197,12624,2383
1,10,12,1,2013,22,89,11868,2202
1,10,12,1,2013,23,18,11577,1949
1,10,12,1,2013,24,18,11247,1860
1,11,12,1,2013,1,61,11324,1624
1,11,12,1,2013,2,9,11003,1511
1,11,12,1,2013,3,9,11159,1437
1,11,12,1,2013,4,16,11276,1394
1,11,12,1,2013,5,69,11556,1382
1,11,12,1,2013,6,230,12473,1507
1,11,12,1,2013,7,683,13281,1665
1,11,12,1,2013,8,895,14166,1791
1,11,12,1,2013,9,862,14875,1999
1,11,12,1,2013,10,658,15116,2328
1,11,12,1,2013,11,611,15277,2552
1,11,12,1,2013,12,684,15314,2591
1,11,12,1,2013,13,822,15283,2588
1,11,12,1,2013,14,719,14778,2500
1,11,12,1,2013,15,598,14635,2529
1,11,12,1,2013,16,519,14823,2525
1,11,12,1,2013,17,502,14428,2527
1,11,12,1,2013,18,616,13125,2535
1,11,12,1,2013,19,492,13273,2608
1,11,12,1,2013,20,517,12715,2585
1,11,12,1,2013,21,354,12387,2397
1,11,12,1,2013,22,206,11742,2216
1,11,12,1,2013,23,143,11498,2027
1,11,12,1,2013,24,134,11313,1806
1,13,12,1,2013,1,11,11143,1618
1,13,12,1,2013,2,17,11042,1469
1,13,12,1,2013,3,17,10801,1402
1,13,12,1,2013,4,17,11481,1372
1,13,12,1,2013,5,17,11562,1369
1,13,12,1,2013,6,115,12487,1491
1,13,12,1,2013,7,789,13283,1664
1,13,12,1,2013,8,1034,13969,1797
1,13,12,1,2013,9,985,14209,2041
1,13,12,1,2013,10,750,14771,2327
1,13,12,1,2013,11,755,14668,2502
1,13,12,1,2013,12,866,14748,2567
1,13,12,1,2013,13,1009,14822,2564
1,13,12,1,2013,14,880,14188,2481
1,13,12,1,2013,15,860,14327,2478
1,13,12,1,2013,16,753,14232,2504
1,13,12,1,2013,17,723,13872,2510
1,13,12,1,2013,18,885,12843,2486
1,13,12,1,2013,19,660,13028,2564
1,13,12,1,2013,20,696,12721,2520
1,13,12,1,2013,21,398,12612,2384
1,13,12,1,2013,22,263,11879,2114
1,13,12,1,2013,23,18,11349,1924
1,13,12,1,2013,24,22,11355,1736
2,14,12,1,2013,1,4,11339,1574
2,14,12,1,2013,2,11,11203,1453
2,14,12,1,2013,3,11,11163,1387
2,14,12,1,2013,4,11,11293,1347
2,14,12,1,2013,5,15,11350,1351
2,14,12,1,2013,6,125,12009,1462
2,14,12,1,2013,7,857,12984,1572
2,14,12,1,2013,8,926,13989,1661
2,14,12,1,2013,9,889,14608,1878
2,14,12,1,2013,10,716,14979,2161
2,14,12,1,2013,11,704,15133,2347
2,14,12,1,2013,12,784,15181,2368
2,14,12,1,2013,13,934,15002,2341
2,14,12,1,2013,14,836,14797,2256
2,14,12,1,2013,15,630,14913,2262
2,14,12,1,2013,16,531,14657,2243
2,14,12,1,2013,17,524,14307,2215
2,14,12,1,2013,18,648,13035,2231
2,14,12,1,2013,19,517,12973,2355
2,14,12,1,2013,20,418,12757,2360
2,14,12,1,2013,21,271,12249,2264
2,14,12,1,2013,22,169,11498,2117
2,14,12,1,2013,23,107,11319,1969
2,14,12,1,2013,24,87,11381,1754
2,15,12,1,2013,1,100,11571,1555
2,15,12,1,2013,2,75,11504,1428
2,15,12,1,2013,3,75,11646,1365
2,15,12,1,2013,4,75,11614,1324
2,15,12,1,2013,5,82,11757,1323
2,15,12,1,2013,6,193,12516,1389
2,15,12,1,2013,7,622,13011,1461
2,15,12,1,2013,8,828,13993,1500
2,15,12,1,2013,9,933,14636,1615
2,15,12,1,2013,10,771,15202,1757
2,15,12,1,2013,11,746,15390,1868
2,15,12,1,2013,12,823,15336,1921
2,15,12,1,2013,13,1011,15246,1917
2,15,12,1,2013,14,883,15027,1848
2,15,12,1,2013,15,699,14590,1789
2,15,12,1,2013,16,587,14539,1750
2,15,12,1,2013,17,557,13808,1739
2,15,12,1,2013,18,620,12567,1806
2,15,12,1,2013,19,370,12773,2008
2,15,12,1,2013,20,379,12555,2027
2,15,12,1,2013,21,231,12018,2036
2,15,12,1,2013,22,139,11645,1979
2,15,12,1,2013,23,99,11269,1840
2,15,12,1,2013,24,84,11468,1636
1,17,12,1,2013,1,3,11714,1562
1,17,12,1,2013,2,3,11660,1424
1,17,12,1,2013,3,3,11503,1359
1,17,12,1,2013,4,12,11486,1332
1,17,12,1,2013,5,12,11775,1327
1,17,12,1,2013,6,118,12634,1451
1,17,12,1,2013,7,598,13605,1650
1,17,12,1,2013,8,969,14349,1782
1,17,12,1,2013,9,917,15022,2022
1,17,12,1,2013,10,711,15413,2309
1,17,12,1,2013,11,710,15288,2510
1,17,12,1,2013,12,796,15382,2544
1,17,12,1,2013,13,973,15075,2540
1,17,12,1,2013,14,860,14869,2423
1,17,12,1,2013,15,685,14949,2446
1,17,12,1,2013,16,591,14773,2460
1,17,12,1,2013,17,567,14429,2457
1,17,12,1,2013,18,690,13148,2448
1,17,12,1,2013,19,516,13180,2540
1,17,12,1,2013,20,546,12786,2497
1,17,12,1,2013,21,374,12414,2352
1,17,12,1,2013,22,237,11762,2043
1,17,12,1,2013,23,147,11263,1936
1,17,12,1,2013,24,123,11421,1731
1,18,12,1,2013,1,89,11517,1538
1,18,12,1,2013,2,69,11399,1401
1,18,12,1,2013,3,69,11579,1341
1,18,12,1,2013,4,78,11795,1319
1,18,12,1,2013,5,78,11798,1336
1,18,12,1,2013,6,162,12474,1440
1,18,12,1,2013,7,624,13257,1633
1,18,12,1,2013,8,944,14347,1773
1,18,12,1,2013,9,906,14916,2009
1,18,12,1,2013,10,731,15283,2304
1,18,12,1,2013,11,723,15308,2472
1,18,12,1,2013,12,815,15579,2515
1,18,12,1,2013,13,974,15126,2512
1,18,12,1,2013,14,828,14909,2406
1,18,12,1,2013,15,642,14614,2440
1,18,12,1,2013,16,541,14712,2431
1,18,12,1,2013,17,514,14178,2431
1,18,12,1,2013,18,657,12981,2437
1,18,12,1,2013,19,551,13172,2514
1,18,12,1,2013,20,616,12802,2492
1,18,12,1,2013,21,426,12573,2294
1,18,12,1,2013,22,263,11956,2148
1,18,12,1,2013,23,167,11530,1869
1,18,12,1,2013,24,135,11579,1739
1,19,12,1,2013,1,23,11518,1530
1,19,12,1,2013,2,37,11488,1400
1,19,12,1,2013,3,37,11497,1334
1,19,12,1,2013,4,37,11474,1304
1,19,12,1,2013,5,37,11742,1320
1,19,12,1,2013,6,357,12604,1440
1,19,12,1,2013,7,1117,13631,1629
1,19,12,1,2013,8,1201,14742,1778
1,19,12,1,2013,9,1161,15253,2017
1,19,12,1,2013,10,903,15309,2308
1,19,12,1,2013,11,832,15369,2474
1,19,12,1,2013,12,962,15511,2515
1,19,12,1,2013,13,1165,15295,2492
1,19,12,1,2013,14,1030,15049,2408
1,19,12,1,2013,15,780,14886,2434
1,19,12,1,2013,16,623,14802,2432
1,19,12,1,2013,17,580,14374,2450
1,19,12,1,2013,18,729,13078,2446
1,19,12,1,2013,19,605,12949,2512
1,19,12,1,2013,20,698,12669,2494
1,19,12,1,2013,21,484,12426,2267
1,19,12,1,2013,22,318,11724,2140
1,19,12,1,2013,23,173,11132,1957
1,19,12,1,2013,24,129,11358,1748
1,20,12,1,2013,1,61,11679,1535
1,20,12,1,2013,2,11,11586,1407
1,20,12,1,2013,3,11,11697,1347
1,20,12,1,2013,4,11,11879,1319
1,20,12,1,2013,5,27,11935,1311
1,20,12,1,2013,6,279,12627,1436
1,20,12,1,2013,7,827,13561,1633
1,20,12,1,2013,8,882,14376,1789
1,20,12,1,2013,9,855,14736,2049
1,20,12,1,2013,10,650,15064,2348
1,20,12,1,2013,11,623,14977,2549
1,20,12,1,2013,12,722,15110,2584
1,20,12,1,2013,13,861,14864,2582
1,20,12,1,2013,14,757,14414,2440
1,20,12,1,2013,15,623,14291,2443
1,20,12,1,2013,16,527,14126,2448
1,20,12,1,2013,17,501,13835,2442
1,20,12,1,2013,18,650,12701,2447
1,20,12,1,2013,19,577,13064,2549
1,20,12,1,2013,20,671,12666,2522
1,20,12,1,2013,21,458,12137,2321
1,20,12,1,2013,22,339,11327,2139
1,20,12,1,2013,23,247,11231,1919
1,20,12,1,2013,24,142,11383,1730
2,21,12,1,2013,1,12,11539,1581
2,21,12,1,2013,2,16,11626,1430
2,21,12,1,2013,3,16,11396,1364
2,21,12,1,2013,4,16,11531,1330
2,21,12,1,2013,5,16,11783,1326
2,21,12,1,2013,6,282,12497,1427
2,21,12,1,2013,7,852,13618,1567
2,21,12,1,2013,8,874,14163,1650
2,21,12,1,2013,9,790,14835,1889
2,21,12,1,2013,10,627,15029,2175
2,21,12,1,2013,11,658,15163,2365
2,21,12,1,2013,12,739,15140,2401
2,21,12,1,2013,13,888,14999,2398
2,21,12,1,2013,14,766,14736,2253
2,21,12,1,2013,15,616,14584,2227
2,21,12,1,2013,16,532,14621,2203
2,21,12,1,2013,17,487,14317,2157
2,21,12,1,2013,18,470,12811,2159
2,21,12,1,2013,19,227,12956,2303
2,21,12,1,2013,20,285,12625,2326
2,21,12,1,2013,21,177,12170,2173
2,21,12,1,2013,22,77,11564,1994
2,21,12,1,2013,23,29,11272,1798
2,21,12,1,2013,24,32,11375,1617
2,22,12,1,2013,1,4,11697,1467
2,22,12,1,2013,2,11,11762,1341
2,22,12,1,2013,3,11,11889,1279
2,22,12,1,2013,4,11,11880,1241
2,22,12,1,2013,5,11,12341,1240
2,22,12,1,2013,6,355,12944,1308
2,22,12,1,2013,7,1048,13816,1382
2,22,12,1,2013,8,1035,14228,1452
2,22,12,1,2013,9,943,14840,1579
2,22,12,1,2013,10,825,15189,1726
2,22,12,1,2013,11,811,15156,1839
2,22,12,1,2013,12,795,15420,1857
2,22,12,1,2013,13,935,15238,1845
2,22,12,1,2013,14,800,14696,1768
2,22,12,1,2013,15,582,14602,1704
2,22,12,1,2013,16,491,14669,1654
2,22,12,1,2013,17,456,13970,1644
2,22,12,1,2013,18,413,12751,1706
2,22,12,1,2013,19,173,12546,1888
2,22,12,1,2013,20,227,12471,1913
2,22,12,1,2013,21,144,12392,1896
2,22,12,1,2013,22,54,11720,1835
2,22,12,1,2013,23,10,11063,1719
2,22,12,1,2013,24,8,11433,1577
1,23,12,1,2013,1,5,11662,1417
1,23,12,1,2013,2,12,11257,1293
1,23,12,1,2013,3,12,11378,1236
1,23,12,1,2013,4,12,11608,1199
1,23,12,1,2013,5,12,11821,1208
1,23,12,1,2013,6,93,12431,1308
1,23,12,1,2013,7,331,13474,1472
1,23,12,1,2013,8,378,14437,1648
1,23,12,1,2013,9,523,14705,1941
1,23,12,1,2013,10,714,15212,2258
1,23,12,1,2013,11,743,15021,2456
1,23,12,1,2013,12,866,15386,2496
1,23,12,1,2013,13,1048,15162,2491
1,23,12,1,2013,14,927,14898,2373
1,23,12,1,2013,15,725,14869,2394
1,23,12,1,2013,16,623,14935,2394
1,23,12,1,2013,17,564,14097,2371
1,23,12,1,2013,18,561,12883,2377
1,23,12,1,2013,19,274,12988,2489
1,23,12,1,2013,20,288,12737,2461
1,23,12,1,2013,21,211,12125,2270
1,23,12,1,2013,22,161,11706,2082
1,23,12,1,2013,23,115,11634,1890
1,23,12,1,2013,24,101,11312,1707
1,24,12,1,2013,1,4,11661,1525
1,24,12,1,2013,2,11,11575,1397
1,24,12,1,2013,3,11,11551,1341
1,24,12,1,2013,4,11,11597,1305
1,24,12,1,2013,5,11,11928,1307
1,24,12,1,2013,6,74,12476,1405
1,24,12,1,2013,7,353,13730,1549
1,24,12,1,2013,8,1016,14601,1732
1,24,12,1,2013,9,933,15115,2024
1,24,12,1,2013,10,756,15272,2347
1,24,12,1,2013,11,819,15247,2542
1,24,12,1,2013,12,969,15297,2564
1,24,12,1,2013,13,1160,15172,2553
1,24,12,1,2013,14,1027,15034,2404
1,24,12,1,2013,15,760,14981,2443
1,24,12,1,2013,16,640,15143,2456
1,24,12,1,2013,17,636,14805,2453
1,24,12,1,2013,18,641,13510,2454
1,24,12,1,2013,19,239,13413,2536
1,24,12,1,2013,20,332,13220,2529
1,24,12,1,2013,21,186,12699,2339
1,24,12,1,2013,22,91,11809,2136
1,24,12,1,2013,23,25,11455,1929
1,24,12,1,2013,24,24,11397,1745
3,25,12,1,2013,1,59,11976,1574
3,25,12,1,2013,2,9,11697,1445
3,25,12,1,2013,3,9,11824,1376
3,25,12,1,2013,4,9,11846,1338
3,25,12,1,2013,5,9,12135,1335
3,25,12,1,2013,6,86,12884,1411
3,25,12,1,2013,7,405,13627,1480
3,25,12,1,2013,8,1072,14516,1581
3,25,12,1,2013,9,989,15079,1756
3,25,12,1,2013,10,779,15430,2015
3,25,12,1,2013,11,808,15260,2181
3,25,12,1,2013,12,909,15724,2221
3,25,12,1,2013,13,1057,15507,2215
3,25,12,1,2013,14,942,15234,2091
3,25,12,1,2013,15,718,15051,2087
3,25,12,1,2013,16,622,15015,2066
3,25,12,1,2013,17,616,14401,2083
3,25,12,1,2013,18,688,13016,2120
3,25,12,1,2013,19,478,12872,2255
3,25,12,1,2013,20,424,12736,2265
3,25,12,1,2013,21,242,12350,2214
3,25,12,1,2013,22,130,11766,2067
3,25,12,1,2013,23,65,11474,1905
3,25,12,1,2013,24,65,11783,1721
1,26,12,1,2013,1,3,11790,1550
1,26,12,1,2013,2,9,11829,1435
1,26,12,1,2013,3,9,11798,1361
1,26,12,1,2013,4,9,11863,1328
1,26,12,1,2013,5,9,12305,1325
1,26,12,1,2013,6,78,12756,1412
1,26,12,1,2013,7,387,13324,1542
1,26,12,1,2013,8,988,14609,1718
1,26,12,1,2013,9,901,14853,2015
1,26,12,1,2013,10,748,15506,2352
1,26,12,1,2013,11,793,15448,2553
1,26,12,1,2013,12,903,15488,2574
1,26,12,1,2013,13,1061,15536,2579
1,26,12,1,2013,14,925,15102,2475
1,26,12,1,2013,15,673,15079,2503
1,26,12,1,2013,16,587,15240,2480
1,26,12,1,2013,17,550,14652,2481
1,26,12,1,2013,18,579,13191,2466
1,26,12,1,2013,19,221,13407,2544
1,26,12,1,2013,20,207,13485,2504
1,26,12,1,2013,21,97,12953,2352
1,26,12,1,2013,22,50,12367,2144
1,26,12,1,2013,23,10,11939,1949
1,26,12,1,2013,24,6,11774,1812
1,27,12,1,2013,1,6,11873,1587
1,27,12,1,2013,2,13,11948,1470
1,27,12,1,2013,3,13,11880,1392
1,27,12,1,2013,4,13,11932,1369
1,27,12,1,2013,5,13,12079,1359
1,27,12,1,2013,6,72,12528,1448
1,27,12,1,2013,7,347,13624,1578
1,27,12,1,2013,8,916,14465,1753
1,27,12,1,2013,9,876,15789,2053
1,27,12,1,2013,10,724,15197,2388
1,27,12,1,2013,11,727,15308,2586
1,27,12,1,2013,12,827,15332,2634
1,27,12,1,2013,13,934,15239,2631
1,27,12,1,2013,14,826,14765,2472
1,27,12,1,2013,15,623,14680,2474
1,27,12,1,2013,16,550,14684,2455
1,27,12,1,2013,17,495,13969,2439
1,27,12,1,2013,18,438,12916,2430
1,27,12,1,2013,19,159,13231,2513
1,27,12,1,2013,20,147,13125,2490
1,27,12,1,2013,21,85,12775,2325
1,27,12,1,2013,22,35,12009,2126
1,27,12,1,2013,23,0,11792,1917
2,28,12,1,2013,1,7,11763,1542
2,28,12,1,2013,2,13,11709,1411
2,28,12,1,2013,3,13,11926,1343
2,28,12,1,2013,4,13,12181,1310
2,28,12,1,2013,5,13,12102,1310
2,28,12,1,2013,6,70,12614,1377
2,28,12,1,2013,7,342,13767,1474
2,28,12,1,2013,8,946,14836,1662
2,28,12,1,2013,9,911,15069,1873
2,28,12,1,2013,10,762,15262,2131
2,28,12,1,2013,11,790,15640,2294
2,28,12,1,2013,12,903,15787,2344
2,28,12,1,2013,13,1045,15546,2309
2,28,12,1,2013,14,896,15249,2176
2,28,12,1,2013,15,670,15222,2141
2,28,12,1,2013,16,587,15130,2110
2,28,12,1,2013,17,555,14441,2096
2,28,12,1,2013,18,519,13266,2109
2,28,12,1,2013,19,185,13427,2275
2,28,12,1,2013,20,206,12891,2293
2,28,12,1,2013,21,134,12206,2199
2,28,12,1,2013,22,50,11380,1989
2,28,12,1,2013,23,3,11265,1817
2,28,12,1,2013,24,5,11321,1654
2,29,12,1,2013,1,8,11407,1484
2,29,12,1,2013,2,14,11721,1352
2,29,12,1,2013,3,14,11605,1288
2,29,12,1,2013,4,14,11688,1247
2,29,12,1,2013,5,14,11870,1258
2,29,12,1,2013,6,88,12750,1323
2,29,12,1,2013,7,372,13507,1398
2,29,12,1,2013,8,952,14504,1461
2,29,12,1,2013,9,891,14913,1574
2,29,12,1,2013,10,712,15408,1714
2,29,12,1,2013,11,699,15617,1819
2,29,12,1,2013,12,809,15865,1845
2,29,12,1,2013,13,930,15419,1864
2,29,12,1,2013,14,805,15143,1776
2,29,12,1,2013,15,644,14950,1703
2,29,12,1,2013,16,571,14967,1647
2,29,12,1,2013,17,511,14270,1647
2,29,12,1,2013,18,439,13035,1704
2,29,12,1,2013,19,159,13224,1887
2,29,12,1,2013,20,171,13209,1939
2,29,12,1,2013,21,110,12527,1936
2,29,12,1,2013,22,49,11919,1867
2,29,12,1,2013,23,2,11541,1742
2,29,12,1,2013,24,5,11366,1707
1,30,12,1,2013,1,0,11597,1458
1,30,12,1,2013,2,0,11675,1334
1,30,12,1,2013,3,0,11615,1276
1,30,12,1,2013,4,0,11824,1243
1,30,12,1,2013,5,3,11800,1257
1,30,12,1,2013,6,51,12588,1354
1,30,12,1,2013,7,320,13297,1501
1,30,12,1,2013,8,815,14472,1682
1,30,12,1,2013,9,905,15002,2079
1,30,12,1,2013,10,699,15136,2403
1,30,12,1,2013,11,790,15288,2516
1,30,12,1,2013,12,947,15587,2548
1,30,12,1,2013,13,1090,15474,2534
1,30,12,1,2013,14,952,15095,2378
1,30,12,1,2013,15,691,14906,2376
1,30,12,1,2013,16,582,15039,2346
1,30,12,1,2013,17,406,14386,2349
1,30,12,1,2013,18,171,12935,2349
1,30,12,1,2013,19,92,13382,2450
1,30,12,1,2013,20,107,13065,2431
1,30,12,1,2013,21,68,12499,2224
1,30,12,1,2013,22,48,12056,2066
1,30,12,1,2013,23,19,11660,1874
1,30,12,1,2013,24,19,11620,1690
1,31,12,1,2013,1,0,11538,1524
1,31,12,1,2013,2,0,11597,1391
1,31,12,1,2013,3,0,11641,1327
1,31,12,1,2013,4,0,11676,1287
1,31,12,1,2013,5,0,11841,1300
1,31,12,1,2013,6,43,12418,1385
1,31,12,1,2013,7,264,13635,1529
1,31,12,1,2013,8,737,14487,1711
1,31,12,1,2013,9,856,14991,1981
1,31,12,1,2013,10,686,15409,2290
1,31,12,1,2013,11,695,15239,2475
1,31,12,1,2013,12,814,15580,2543
1,31,12,1,2013,13,954,15367,2502
1,31,12,1,2013,14,855,15088,2353
1,31,12,1,2013,15,650,14903,2349
1,31,12,1,2013,16,555,14811,2319
1,31,12,1,2013,17,478,14379,2295
1,31,12,1,2013,18,174,12920,2305
1,31,12,1,2013,19,73,13160,2382
1,31,12,1,2013,20,84,12985,2381
1,31,12,1,2013,21,59,12230,2209
1,31,12,1,2013,22,45,11741,2030
1,31,12,1,2013,23,4,11502,1888
1,31,12,1,2013,24,4,11523,1733
1,1,1,1,2014,1,11687,1558,13245
1,1,1,1,2014,2,11545,1436,12981
1,1,1,1,2014,3,11423,1360,12783
1,1,1,1,2014,4,11464,1304,12768
1,1,1,1,2014,5,11612,1295,12907
1,1,1,1,2014,6,12396,1368,13764
1,1,1,1,2014,7,13499,1447,14946
1,1,1,1,2014,8,14189,1568,15757
1,1,1,1,2014,9,14418,1764,16182
1,1,1,1,2014,10,15202,2009,17211
1,1,1,1,2014,11,15385,2210,17595
1,1,1,1,2014,12,15311,2293,17604
1,1,1,1,2014,13,15198,2267,17465
1,1,1,1,2014,14,14787,2154,16941
1,1,1,1,2014,15,14513,2137,16650
1,1,1,1,2014,16,14520,2096,16616
1,1,1,1,2014,17,13916,2093,16009
1,1,1,1,2014,18,12618,2116,14734
1,1,1,1,2014,19,13063,2229,15292
1,1,1,1,2014,20,13182,2255,15437
1,1,1,1,2014,21,12596,2137,14733
1,1,1,1,2014,22,11771,2002,13773
1,1,1,1,2014,23,11430,1863,13293
1,1,1,1,2014,24,11615,1671,13286
1,2,1,1,2014,1,11333,1507,12840
1,2,1,1,2014,2,11265,1384,12649
1,2,1,1,2014,3,11533,1324,12857
1,2,1,1,2014,4,11486,1297,12783
1,2,1,1,2014,5,11614,1309,12923
1,2,1,1,2014,6,12356,1419,13775
1,2,1,1,2014,7,13390,1580,14970
1,2,1,1,2014,8,14311,1763,16074
1,2,1,1,2014,9,15127,2037,17164
1,2,1,1,2014,10,15427,2345,17772
1,2,1,1,2014,11,15725,2550,18275
1,2,1,1,2014,12,15754,2582,18336
1,2,1,1,2014,13,15657,2562,18219
1,2,1,1,2014,14,15585,2426,18011
1,2,1,1,2014,15,15415,2450,17865
1,2,1,1,2014,16,15344,2446,17790
1,2,1,1,2014,17,14596,2450,17046
1,2,1,1,2014,18,13172,2434,15606
1,2,1,1,2014,19,13026,2515,15541
1,2,1,1,2014,20,13069,2489,15558
1,2,1,1,2014,21,12763,2179,14942
1,2,1,1,2014,22,12013,1955,13968
1,2,1,1,2014,23,11533,1799,13332
1,2,1,1,2014,24,11683,1636,13319
1,3,1,1,2014,1,11562,1563,13125
1,3,1,1,2014,2,11465,1430,12895
1,3,1,1,2014,3,11577,1369,12946
1,3,1,1,2014,4,11676,1333,13009
1,3,1,1,2014,5,11800,1350,13150
1,3,1,1,2014,6,12406,1470,13876
1,3,1,1,2014,7,13661,1655,15316
1,3,1,1,2014,8,14628,1818,16446
1,3,1,1,2014,9,15104,2070,17174
1,3,1,1,2014,10,15431,2390,17821
1,3,1,1,2014,11,15393,2595,17988
1,3,1,1,2014,12,15570,2659,18229
1,3,1,1,2014,13,15380,2634,18014
1,3,1,1,2014,14,15084,2484,17568
1,3,1,1,2014,15,14771,2514,17285
1,3,1,1,2014,16,14832,2501,17333
1,3,1,1,2014,17,14395,2498,16893
1,3,1,1,2014,18,13027,2472,15499
1,3,1,1,2014,19,12550,2542,15092
1,3,1,1,2014,20,12555,2532,15087
1,3,1,1,2014,21,12275,2381,14656
1,3,1,1,2014,22,11590,2242,13832
1,3,1,1,2014,23,11687,1976,13663
1,3,1,1,2014,24,11639,1793,13432
2,4,1,1,2014,1,11611,1619,13230
2,4,1,1,2014,2,11734,1474,13208
2,4,1,1,2014,3,11940,1412,13352
2,4,1,1,2014,4,11791,1374,13165
2,4,1,1,2014,5,12425,1389,13814
2,4,1,1,2014,6,12874,1486,14360
2,4,1,1,2014,7,13656,1629,15285
2,4,1,1,2014,8,14979,1741,16720
2,4,1,1,2014,9,15097,1973,17070
2,4,1,1,2014,10,15640,2264,17904
2,4,1,1,2014,11,16030,2473,18503
2,4,1,1,2014,12,15929,2517,18446
2,4,1,1,2014,13,15975,2496,18471
2,4,1,1,2014,14,15305,2343,17648
2,4,1,1,2014,15,15275,2314,17589
2,4,1,1,2014,16,15229,2283,17512
2,4,1,1,2014,17,14909,2251,17160
2,4,1,1,2014,18,13045,2245,15290
2,4,1,1,2014,19,13324,2365,15689
2,4,1,1,2014,20,13056,2372,15428
2,4,1,1,2014,21,12712,2244,14956
2,4,1,1,2014,22,12199,2087,14286
2,4,1,1,2014,23,11917,1896,13813
2,4,1,1,2014,24,11894,1732,13626
2,5,1,1,2014,1,11924,1550,13474
2,5,1,1,2014,2,12117,1416,13533
2,5,1,1,2014,3,12256,1338,13594
2,5,1,1,2014,4,12309,1299,13608
2,5,1,1,2014,5,12427,1317,13744
2,5,1,1,2014,6,13188,1389,14577
2,5,1,1,2014,7,13806,1454,15260
2,5,1,1,2014,8,14685,1510,16195
2,5,1,1,2014,9,14998,1620,16618
2,5,1,1,2014,10,15494,1753,17247
2,5,1,1,2014,11,15796,1841,17637
2,5,1,1,2014,12,16057,1868,17925
2,5,1,1,2014,13,15979,1841,17820
2,5,1,1,2014,14,15421,1759,17180
2,5,1,1,2014,15,15170,1687,16857
2,5,1,1,2014,16,15114,1623,16737
2,5,1,1,2014,17,14461,1616,16077
2,5,1,1,2014,18,12881,1668,14549
2,5,1,1,2014,19,13221,1844,15065
2,5,1,1,2014,20,13117,1938,15055
2,5,1,1,2014,21,12457,1901,14358
2,5,1,1,2014,22,11885,1832,13717
2,5,1,1,2014,23,11532,1697,13229
2,5,1,1,2014,24,11830,1522,13352
1,6,1,1,2014,1,11867,1364,13231
1,6,1,1,2014,2,11827,1235,13062
1,6,1,1,2014,3,11646,1186,12832
1,6,1,1,2014,4,11937,1153,13090
1,6,1,1,2014,5,12004,1173,13177
1,6,1,1,2014,6,12812,1307,14119
1,6,1,1,2014,7,13559,1516,15075
1,6,1,1,2014,8,14617,1675,16292
1,6,1,1,2014,9,15092,1934,17026
1,6,1,1,2014,10,15550,2180,17730
1,6,1,1,2014,11,15621,2362,17983
1,6,1,1,2014,12,15975,2400,18375
1,6,1,1,2014,13,15648,2377,18025
1,6,1,1,2014,14,15295,2262,17557
1,6,1,1,2014,15,15254,2276,17530
1,6,1,1,2014,16,15215,2268,17483
1,6,1,1,2014,17,14771,2266,17037
1,6,1,1,2014,18,13142,2262,15404
1,6,1,1,2014,19,13823,2345,16168
1,6,1,1,2014,20,13595,2332,15927
1,6,1,1,2014,21,12708,2184,14892
1,6,1,1,2014,22,12261,1987,14248
1,6,1,1,2014,23,11812,1801,13613
1,6,1,1,2014,24,11816,1628,13444
1,7,1,1,2014,1,11885,1416,13301
1,7,1,1,2014,2,11860,1288,13148
1,7,1,1,2014,3,12038,1233,13271
1,7,1,1,2014,4,11995,1200,13195
1,7,1,1,2014,5,12198,1208,13406
1,7,1,1,2014,6,13091,1341,14432
1,7,1,1,2014,7,14019,1565,15584
1,7,1,1,2014,8,15290,1725,17015
1,7,1,1,2014,9,15520,1965,17485
1,7,1,1,2014,10,15911,2246,18157
1,7,1,1,2014,11,16111,2428,18539
1,7,1,1,2014,12,15906,2480,18386
1,7,1,1,2014,13,15979,2474,18453
1,7,1,1,2014,14,15733,2366,18099
1,7,1,1,2014,15,15709,2399,18108
1,7,1,1,2014,16,15553,2408,17961
1,7,1,1,2014,17,14783,2414,17197
1,7,1,1,2014,18,13389,2404,15793
1,7,1,1,2014,19,13145,2477,15622
1,7,1,1,2014,20,13040,2467,15507
1,7,1,1,2014,21,12831,2303,15134
1,7,1,1,2014,22,12066,2098,14164
1,7,1,1,2014,23,11530,1905,13435
1,7,1,1,2014,24,11831,1701,13532
1,8,1,1,2014,1,11977,1504,13481
1,8,1,1,2014,2,11919,1377,13296
1,8,1,1,2014,3,11999,1323,13322
1,8,1,1,2014,4,11855,1297,13152
1,8,1,1,2014,5,11788,1299,13087
1,8,1,1,2014,6,12950,1422,14372
1,8,1,1,2014,7,13810,1628,15438
1,8,1,1,2014,8,14975,1801,16776
1,8,1,1,2014,9,15287,2056,17343
1,8,1,1,2014,10,15667,2332,17999
1,8,1,1,2014,11,15737,2539,18276
1,8,1,1,2014,12,15948,2591,18539
1,8,1,1,2014,13,15722,2590,18312
1,8,1,1,2014,14,15402,2464,17866
1,8,1,1,2014,15,15501,2475,17976
1,8,1,1,2014,16,15046,2467,17513
1,8,1,1,2014,17,14614,2461,17075
1,8,1,1,2014,18,13468,2453,15921
1,8,1,1,2014,19,13012,2524,15536
1,8,1,1,2014,20,12963,2474,15437
1,8,1,1,2014,21,12814,2372,15186
1,8,1,1,2014,22,11986,2193,14179
1,8,1,1,2014,23,11659,2018,13677
1,8,1,1,2014,24,12002,1814,13816
1,9,1,1,2014,1,11905,1592,13497
1,9,1,1,2014,2,11814,1444,13258
1,9,1,1,2014,3,11820,1383,13203
1,9,1,1,2014,4,12165,1344,13509
1,9,1,1,2014,5,12311,1350,13661
1,9,1,1,2014,6,12953,1475,14428
1,9,1,1,2014,7,13979,1671,15650
1,9,1,1,2014,8,14923,1834,16757
1,9,1,1,2014,9,15663,2087,17750
1,9,1,1,2014,10,15962,2378,18340
1,9,1,1,2014,11,16236,2574,18810
1,9,1,1,2014,12,16192,2620,18812
1,9,1,1,2014,13,16106,2564,18670
1,9,1,1,2014,14,15748,2441,18189
1,9,1,1,2014,15,15697,2436,18133
1,9,1,1,2014,16,15562,2423,17985
1,9,1,1,2014,17,14920,2405,17325
1,9,1,1,2014,18,13338,2392,15730
1,9,1,1,2014,19,13136,2448,15584
1,9,1,1,2014,20,13105,2447,15552
1,9,1,1,2014,21,12990,2299,15289
1,9,1,1,2014,22,12381,2094,14475
1,9,1,1,2014,23,12048,1918,13966
1,9,1,1,2014,24,12241,1721,13962
2,11,1,1,2014,1,12051,1380,13431
2,11,1,1,2014,2,11986,1266,13252
2,11,1,1,2014,3,11881,1252,13133
2,11,1,1,2014,4,12062,1220,13282
2,11,1,1,2014,5,12149,1234,13383
2,11,1,1,2014,6,12899,1287,14186
2,11,1,1,2014,7,13820,1418,15238
2,11,1,1,2014,8,14928,1536,16464
2,11,1,1,2014,9,15268,1750,17018
2,11,1,1,2014,10,15850,1991,17841
2,11,1,1,2014,11,15500,2125,17625
2,11,1,1,2014,12,15805,2179,17984
2,11,1,1,2014,13,15522,2121,17643
2,11,1,1,2014,14,15253,1968,17221
2,11,1,1,2014,15,14940,1935,16875
2,11,1,1,2014,16,14980,1897,16877
2,11,1,1,2014,17,14197,1887,16084
2,11,1,1,2014,18,12672,1925,14597
2,11,1,1,2014,19,12443,2049,14492
2,11,1,1,2014,20,12849,2127,14976
2,11,1,1,2014,21,12755,2024,14779
2,11,1,1,2014,22,12267,1892,14159
2,11,1,1,2014,23,11768,1703,13471
2,11,1,1,2014,24,11715,1496,13211
2,12,1,1,2014,1,12104,1328,13432
2,12,1,1,2014,2,11836,1185,13021
2,12,1,1,2014,3,11890,1128,13018
2,12,1,1,2014,4,12153,1105,13258
2,12,1,1,2014,5,11987,1125,13112
2,12,1,1,2014,6,12946,1222,14168
2,12,1,1,2014,7,13955,1277,15232
2,12,1,1,2014,8,14698,1370,16068
2,12,1,1,2014,9,14779,1507,16286
2,12,1,1,2014,10,15389,1642,17031
2,12,1,1,2014,11,15810,1729,17539
2,12,1,1,2014,12,15732,1763,17495
2,12,1,1,2014,13,15584,1757,17341
2,12,1,1,2014,14,14919,1681,16600
2,12,1,1,2014,15,14507,1610,16117
2,12,1,1,2014,16,14874,1538,16412
2,12,1,1,2014,17,14055,1431,15486
2,12,1,1,2014,18,12774,1450,14224
2,12,1,1,2014,19,13095,1683,14778
2,12,1,1,2014,20,13266,1821,15087
2,12,1,1,2014,21,12951,1804,14755
2,12,1,1,2014,22,12164,1753,13917
2,12,1,1,2014,23,11818,1605,13423
2,12,1,1,2014,24,11739,1428,13167
1,13,1,1,2014,1,11803,1276,13079
1,13,1,1,2014,2,11846,1156,13002
1,13,1,1,2014,3,11916,1105,13021
1,13,1,1,2014,4,11703,1078,12781
1,13,1,1,2014,5,11921,1109,13030
1,13,1,1,2014,6,12958,1236,14194
1,13,1,1,2014,7,13621,1470,15091
1,13,1,1,2014,8,14762,1663,16425
1,13,1,1,2014,9,15216,1905,17121
1,13,1,1,2014,10,15404,2156,17560
1,13,1,1,2014,11,15641,2303,17944
1,13,1,1,2014,12,15619,2334,17953
1,13,1,1,2014,13,15461,2330,17791
1,13,1,1,2014,14,15387,2210,17597
1,13,1,1,2014,15,15364,2213,17577
1,13,1,1,2014,16,15273,2200,17473
1,13,1,1,2014,17,14691,2199,16890
1,13,1,1,2014,18,13073,2215,15288
1,13,1,1,2014,19,13143,2308,15451
1,13,1,1,2014,20,13220,2315,15535
1,13,1,1,2014,21,12785,2171,14956
1,13,1,1,2014,22,12093,1991,14084
1,13,1,1,2014,23,11947,1798,13745
1,13,1,1,2014,24,12156,1613,13769
3,14,1,1,2014,1,12170,1440,13610
3,14,1,1,2014,2,12189,1309,13498
3,14,1,1,2014,3,12099,1244,13343
3,14,1,1,2014,4,12255,1216,13471
3,14,1,1,2014,5,12221,1234,13455
3,14,1,1,2014,6,12847,1344,14191
3,14,1,1,2014,7,13890,1463,15353
3,14,1,1,2014,8,15024,1624,16648
3,14,1,1,2014,9,16008,1879,17887
3,14,1,1,2014,10,16442,2118,18560
3,14,1,1,2014,11,16322,2269,18591
3,14,1,1,2014,12,16383,2326,18709
3,14,1,1,2014,13,16228,2278,18506
3,14,1,1,2014,14,15685,2150,17835
3,14,1,1,2014,15,15784,2130,17914
3,14,1,1,2014,16,15600,2088,17688
3,14,1,1,2014,17,14959,2073,17032
3,14,1,1,2014,18,13282,2045,15327
3,14,1,1,2014,19,12987,2158,15145
3,14,1,1,2014,20,13220,2177,15397
3,14,1,1,2014,21,12679,2051,14730
3,14,1,1,2014,22,12341,1908,14249
3,14,1,1,2014,23,11964,1760,13724
3,14,1,1,2014,24,11775,1609,13384
1,15,1,1,2014,1,12174,1400,13574
1,15,1,1,2014,2,11987,1286,13273
1,15,1,1,2014,3,11989,1237,13226
1,15,1,1,2014,4,12344,1193,13537
1,15,1,1,2014,5,12028,1208,13236
1,15,1,1,2014,6,13021,1349,14370
1,15,1,1,2014,7,13701,1558,15259
1,15,1,1,2014,8,15251,1724,16975
1,15,1,1,2014,9,15655,1969,17624
1,15,1,1,2014,10,16037,2225,18262
1,15,1,1,2014,11,15926,2389,18315
1,15,1,1,2014,12,16010,2417,18427
1,15,1,1,2014,13,15650,2362,18012
1,15,1,1,2014,14,15437,2225,17662
1,15,1,1,2014,15,15345,2223,17568
1,15,1,1,2014,16,15399,2189,17588
1,15,1,1,2014,17,14795,2218,17013
1,15,1,1,2014,18,13215,2215,15430
1,15,1,1,2014,19,13240,2282,15522
1,15,1,1,2014,20,13178,2315,15493
1,15,1,1,2014,21,12803,2207,15010
1,15,1,1,2014,22,12408,2010,14418
1,15,1,1,2014,23,12266,1818,14084
1,15,1,1,2014,24,12084,1611,13695
1,16,1,1,2014,1,12270,1399,13669
1,16,1,1,2014,2,12148,1271,13419
1,16,1,1,2014,3,12138,1216,13354
1,16,1,1,2014,4,12200,1169,13369
1,16,1,1,2014,5,12221,1191,13412
1,16,1,1,2014,6,13628,1321,14949
1,16,1,1,2014,7,14520,1536,16056
1,16,1,1,2014,8,15128,1709,16837
1,16,1,1,2014,9,15915,1950,17865
1,16,1,1,2014,10,15933,2199,18132
1,16,1,1,2014,11,16144,2370,18514
1,16,1,1,2014,12,16211,2377,18588
1,16,1,1,2014,13,15707,2324,18031
1,16,1,1,2014,14,15355,2249,17604
1,16,1,1,2014,15,15266,2272,17538
1,16,1,1,2014,16,15138,2246,17384
1,16,1,1,2014,17,14278,2246,16524
1,16,1,1,2014,18,13231,2224,15455
1,16,1,1,2014,19,12609,2257,14866
1,16,1,1,2014,20,12706,2286,14992
1,16,1,1,2014,21,12488,2184,14672
1,16,1,1,2014,22,11629,2107,13736
1,16,1,1,2014,23,11273,1817,13090
1,16,1,1,2014,24,11730,1614,13344
1,17,1,1,2014,1,12102,1405,13507
1,17,1,1,2014,2,12181,1281,13462
1,17,1,1,2014,3,12034,1230,13264
1,17,1,1,2014,4,12064,1192,13256
1,17,1,1,2014,5,12488,1206,13694
1,17,1,1,2014,6,12971,1343,14314
1,17,1,1,2014,7,13829,1547,15376
1,17,1,1,2014,8,14751,1750,16501
1,17,1,1,2014,9,15419,2006,17425
1,17,1,1,2014,10,15473,2263,17736
1,17,1,1,2014,11,15458,2419,17877
1,17,1,1,2014,12,15602,2441,18043
1,17,1,1,2014,13,15311,2397,17708
1,17,1,1,2014,14,14166,2249,16415
1,17,1,1,2014,15,14270,2251,16521
1,17,1,1,2014,16,14223,2225,16448
1,17,1,1,2014,17,13687,2222,15909
1,17,1,1,2014,18,12640,2202,14842
1,17,1,1,2014,19,12564,2272,14836
1,17,1,1,2014,20,13043,2300,15343
1,17,1,1,2014,21,12737,2165,14902
1,17,1,1,2014,22,11642,1979,13621
1,17,1,1,2014,23,11590,1793,13383
1,17,1,1,2014,24,11440,1570,13010
2,18,1,1,2014,1,11503,1360,12863
2,18,1,1,2014,2,11703,1236,12939
2,18,1,1,2014,3,11705,1171,12876
2,18,1,1,2014,4,11821,1137,12958
2,18,1,1,2014,5,11826,1157,12983
2,18,1,1,2014,6,12907,1270,14177
2,18,1,1,2014,7,13269,1415,14684
2,18,1,1,2014,8,14792,1575,16367
2,18,1,1,2014,9,14609,1819,16428
2,18,1,1,2014,10,15115,2062,17177
2,18,1,1,2014,11,15294,2195,17489
2,18,1,1,2014,12,15278,2197,17475
2,18,1,1,2014,13,15433,2127,17560
2,18,1,1,2014,14,14774,1993,16767
2,18,1,1,2014,15,14678,1986,16664
2,18,1,1,2014,16,14794,1941,16735
2,18,1,1,2014,17,14493,1929,16422
2,18,1,1,2014,18,12768,1932,14700
2,18,1,1,2014,19,12862,2042,14904
2,18,1,1,2014,20,13273,2105,15378
2,18,1,1,2014,21,12649,2024,14673
2,18,1,1,2014,22,12011,1872,13883
2,18,1,1,2014,23,11886,1665,13551
2,18,1,1,2014,24,11840,1496,13336
2,19,1,1,2014,1,11956,1307,13263
2,19,1,1,2014,2,11748,1192,12940
2,19,1,1,2014,3,12157,1135,13292
2,19,1,1,2014,4,12157,1111,13268
2,19,1,1,2014,5,12109,1114,13223
2,19,1,1,2014,6,12776,1196,13972
2,19,1,1,2014,7,13345,1287,14632
2,19,1,1,2014,8,14455,1402,15857
2,19,1,1,2014,9,15361,1569,16930
2,19,1,1,2014,10,15610,1728,17338
2,19,1,1,2014,11,15926,1829,17755
2,19,1,1,2014,12,15683,1852,17535
2,19,1,1,2014,13,15487,1796,17283
2,19,1,1,2014,14,15086,1691,16777
2,19,1,1,2014,15,14852,1605,16457
2,19,1,1,2014,16,15017,1548,16565
2,19,1,1,2014,17,14154,1547,15701
2,19,1,1,2014,18,12497,1590,14087
2,19,1,1,2014,19,12661,1775,14436
2,19,1,1,2014,20,12668,1917,14585
2,19,1,1,2014,21,12396,1925,14321
2,19,1,1,2014,22,11560,1789,13349
2,19,1,1,2014,23,11516,1659,13175
2,19,1,1,2014,24,11821,1533,13354
1,20,1,1,2014,1,12256,1493,13749
1,20,1,1,2014,2,12195,1355,13550
1,20,1,1,2014,3,12219,1285,13504
1,20,1,1,2014,4,12231,1247,13478
1,20,1,1,2014,5,12254,1261,13515
1,20,1,1,2014,6,12875,1407,14282
1,20,1,1,2014,7,13328,1608,14936
1,20,1,1,2014,8,14890,1813,16703
1,20,1,1,2014,9,15490,2076,17566
1,20,1,1,2014,10,15553,2351,17904
1,20,1,1,2014,11,15687,2507,18194
1,20,1,1,2014,12,15952,2506,18458
1,20,1,1,2014,13,15619,2496,18115
1,20,1,1,2014,14,15489,2357,17846
1,20,1,1,2014,15,15560,2369,17929
1,20,1,1,2014,16,15619,2369,17988
1,20,1,1,2014,17,15176,2382,17558
1,20,1,1,2014,18,13682,2348,16030
1,20,1,1,2014,19,13127,2399,15526
1,20,1,1,2014,20,13549,2427,15976
1,20,1,1,2014,21,13178,2272,15450
1,20,1,1,2014,22,12363,2098,14461
1,20,1,1,2014,23,12328,1899,14227
1,20,1,1,2014,24,12482,1688,14170
1,21,1,1,2014,1,12141,1483,13624
1,21,1,1,2014,2,12199,1311,13510
1,21,1,1,2014,3,12009,1281,13290
1,21,1,1,2014,4,12592,1247,13839
1,21,1,1,2014,5,12658,1280,13938
1,21,1,1,2014,6,13024,1416,14440
1,21,1,1,2014,7,13666,1625,15291
1,21,1,1,2014,8,14733,1811,16544
1,21,1,1,2014,9,15627,2081,17708
1,21,1,1,2014,10,16227,2328,18555
1,21,1,1,2014,11,15549,2465,18014
1,21,1,1,2014,12,15536,2472,18008
1,21,1,1,2014,13,15152,2429,17581
1,21,1,1,2014,14,15190,2277,17467
1,21,1,1,2014,15,15311,2287,17598
1,21,1,1,2014,16,15493,2291,17784
1,21,1,1,2014,17,14596,2301,16897
1,21,1,1,2014,18,13345,2309,15654
1,21,1,1,2014,19,13431,2400,15831
1,21,1,1,2014,20,13318,2417,15735
1,21,1,1,2014,21,12395,2257,14652
1,21,1,1,2014,22,11865,2086,13951
1,21,1,1,2014,23,11662,1864,13526
1,21,1,1,2014,24,12115,1668,13783
1,22,1,1,2014,1,12114,1354,13468
1,22,1,1,2014,2,12118,1226,13344
1,22,1,1,2014,3,11959,1170,13129
1,22,1,1,2014,4,12047,1141,13188
1,22,1,1,2014,5,12238,1175,13413
1,22,1,1,2014,6,13148,1300,14448
1,22,1,1,2014,7,14133,1511,15644
1,22,1,1,2014,8,14996,1705,16701
1,22,1,1,2014,9,15223,1952,17175
1,22,1,1,2014,10,15757,2223,17980
1,22,1,1,2014,11,15988,2408,18396
1,22,1,1,2014,12,15949,2437,18386
1,22,1,1,2014,13,15539,2405,17944
1,22,1,1,2014,14,15247,2270,17517
1,22,1,1,2014,15,15283,2253,17536
1,22,1,1,2014,16,15300,2234,17534
1,22,1,1,2014,17,14694,2244,16938
1,22,1,1,2014,18,13263,2258,15521
1,22,1,1,2014,19,13146,2343,15489
1,22,1,1,2014,20,13083,2352,15435
1,22,1,1,2014,21,12663,2193,14856
1,22,1,1,2014,22,12286,2058,14344
1,22,1,1,2014,23,12096,1860,13956
1,22,1,1,2014,24,12273,1647,13920
1,23,1,1,2014,1,12340,1502,13842
1,23,1,1,2014,2,12279,1375,13654
1,23,1,1,2014,3,12502,1304,13806
1,23,1,1,2014,4,12420,1268,13688
1,23,1,1,2014,5,12530,1285,13815
1,23,1,1,2014,6,13212,1406,14618
1,23,1,1,2014,7,14464,1615,16079
1,23,1,1,2014,8,15379,1805,17184
1,23,1,1,2014,9,15510,2070,17580
1,23,1,1,2014,10,15712,2333,18045
1,23,1,1,2014,11,16005,2503,18508
1,23,1,1,2014,12,16212,2529,18741
1,23,1,1,2014,13,15794,2495,18289
1,23,1,1,2014,14,15686,2372,18058
1,23,1,1,2014,15,15341,2379,17720
1,23,1,1,2014,16,15329,2375,17704
1,23,1,1,2014,17,14867,2377,17244
1,23,1,1,2014,18,13347,2365,15712
1,23,1,1,2014,19,12875,2399,15274
1,23,1,1,2014,20,13069,2417,15486
1,23,1,1,2014,21,12975,2279,15254
1,23,1,1,2014,22,12286,2094,14380
1,23,1,1,2014,23,11985,1895,13880
1,23,1,1,2014,24,11870,1693,13563
1,24,1,1,2014,1,12091,1478,13569
1,24,1,1,2014,2,11761,1350,13111
1,24,1,1,2014,3,11727,1286,13013
1,24,1,1,2014,4,11642,1274,12916
1,24,1,1,2014,5,11806,1316,13122
1,24,1,1,2014,6,12793,1462,14255
1,24,1,1,2014,7,13047,1626,14673
1,24,1,1,2014,8,14337,1807,16144
1,24,1,1,2014,9,14682,2075,16757
1,24,1,1,2014,10,14811,2348,17159
1,24,1,1,2014,11,14931,2517,17448
1,24,1,1,2014,12,15091,2541,17632
1,24,1,1,2014,13,14874,2522,17396
1,24,1,1,2014,14,14701,2369,17070
1,24,1,1,2014,15,13970,2402,16372
1,24,1,1,2014,16,14205,2402,16607
1,24,1,1,2014,17,13523,2367,15890
1,24,1,1,2014,18,12340,2364,14704
1,24,1,1,2014,19,12960,2401,15361
1,24,1,1,2014,20,13141,2424,15565
1,24,1,1,2014,21,12763,2242,15005
1,24,1,1,2014,22,12104,2105,14209
1,24,1,1,2014,23,11952,1900,13852
1,24,1,1,2014,24,12061,1739,13800
2,25,1,1,2014,1,11894,1512,13406
2,25,1,1,2014,2,11836,1374,13210
2,25,1,1,2014,3,11735,1314,13049
2,25,1,1,2014,4,11581,1281,12862
2,25,1,1,2014,5,11794,1294,13088
2,25,1,1,2014,6,12590,1393,13983
2,25,1,1,2014,7,13381,1551,14932
2,25,1,1,2014,8,14245,1689,15934
2,25,1,1,2014,9,14624,1926,16550
2,25,1,1,2014,10,14860,2204,17064
2,25,1,1,2014,11,15007,2384,17391
2,25,1,1,2014,12,15330,2418,17748
2,25,1,1,2014,13,14871,2399,17270
2,25,1,1,2014,14,14869,2263,17132
2,25,1,1,2014,15,14847,2243,17090
2,25,1,1,2014,16,15090,2206,17296
2,25,1,1,2014,17,14300,2183,16483
2,25,1,1,2014,18,12847,2191,15038
2,25,1,1,2014,19,12787,2291,15078
2,25,1,1,2014,20,13117,2377,15494
2,25,1,1,2014,21,12670,2273,14943
2,25,1,1,2014,22,12330,2109,14439
2,25,1,1,2014,23,11892,1953,13845
2,25,1,1,2014,24,11945,1792,13737
3,26,1,1,2014,1,11728,1604,13332
3,26,1,1,2014,2,11753,1412,13165
3,26,1,1,2014,3,11659,1317,12976
3,26,1,1,2014,4,11807,1279,13086
3,26,1,1,2014,5,12074,1294,13368
3,26,1,1,2014,6,13020,1387,14407
3,26,1,1,2014,7,13337,1485,14822
3,26,1,1,2014,8,13735,1539,15274
3,26,1,1,2014,9,13809,1656,15465
3,26,1,1,2014,10,13325,1758,15083
3,26,1,1,2014,11,13072,1811,14883
3,26,1,1,2014,12,12949,1824,14773
3,26,1,1,2014,13,13165,1823,14988
3,26,1,1,2014,14,12707,1769,14476
3,26,1,1,2014,15,12683,1698,14381
3,26,1,1,2014,16,12778,1659,14437
3,26,1,1,2014,17,11946,1643,13589
3,26,1,1,2014,18,11081,1706,12787
3,26,1,1,2014,19,11251,1890,13141
3,26,1,1,2014,20,11632,2037,13669
3,26,1,1,2014,21,11286,2014,13300
3,26,1,1,2014,22,10908,1936,12844
3,26,1,1,2014,23,10727,1823,12550
3,26,1,1,2014,24,10437,1725,12162
1,27,1,1,2014,1,10903,1533,12436
1,27,1,1,2014,2,10819,1403,12222
1,27,1,1,2014,3,10213,1338,11551
1,27,1,1,2014,4,10599,1304,11903
1,27,1,1,2014,5,11140,1333,12473
1,27,1,1,2014,6,11828,1450,13278
1,27,1,1,2014,7,12620,1649,14269
1,27,1,1,2014,8,13483,1826,15309
1,27,1,1,2014,9,14619,2083,16702
1,27,1,1,2014,10,15571,2371,17942
1,27,1,1,2014,11,15717,2555,18272
1,27,1,1,2014,12,15627,2617,18244
1,27,1,1,2014,13,15147,2607,17754
1,27,1,1,2014,14,14349,2501,16850
1,27,1,1,2014,15,14719,2514,17233
1,27,1,1,2014,16,14871,2501,17372
1,27,1,1,2014,17,14090,2503,16593
1,27,1,1,2014,18,12875,2481,15356
1,27,1,1,2014,19,12992,2517,15509
1,27,1,1,2014,20,13250,2581,15831
1,27,1,1,2014,21,12726,2366,15092
1,27,1,1,2014,22,11989,2178,14167
1,27,1,1,2014,23,11763,2002,13765
1,27,1,1,2014,24,11991,1809,13800
1,28,1,1,2014,1,11912,1609,13521
1,28,1,1,2014,2,11579,1471,13050
1,28,1,1,2014,3,11547,1408,12955
1,28,1,1,2014,4,11663,1378,13041
1,28,1,1,2014,5,11905,1383,13288
1,28,1,1,2014,6,12295,1499,13794
1,28,1,1,2014,7,13314,1708,15022
1,28,1,1,2014,8,14158,1868,16026
1,28,1,1,2014,9,14935,2115,17050
1,28,1,1,2014,10,15450,2386,17836
1,28,1,1,2014,11,15313,2582,17895
1,28,1,1,2014,12,15310,2601,17911
1,28,1,1,2014,13,15136,2558,17694
1,28,1,1,2014,14,14825,2455,17280
1,28,1,1,2014,15,15308,2462,17770
1,28,1,1,2014,16,15239,2458,17697
1,28,1,1,2014,17,14449,2463,16912
1,28,1,1,2014,18,13281,2438,15719
1,28,1,1,2014,19,12923,2430,15353
1,28,1,1,2014,20,13448,2450,15898
1,28,1,1,2014,21,12968,2361,15329
1,28,1,1,2014,22,12507,2175,14682
1,28,1,1,2014,23,12062,1988,14050
1,28,1,1,2014,24,11889,1782,13671
1,29,1,1,2014,1,11986,1581,13567
1,29,1,1,2014,2,12087,1439,13526
1,29,1,1,2014,3,11659,1378,13037
1,29,1,1,2014,4,11884,1341,13225
1,29,1,1,2014,5,12131,1342,13473
1,29,1,1,2014,6,12677,1456,14133
1,29,1,1,2014,7,13532,1660,15192
1,29,1,1,2014,8,14701,1825,16526
1,29,1,1,2014,9,16083,2075,18158
1,29,1,1,2014,10,15700,2344,18044
1,29,1,1,2014,11,15605,2530,18135
1,29,1,1,2014,12,15779,2575,18354
1,29,1,1,2014,13,15503,2557,18060
1,29,1,1,2014,14,15360,2423,17783
1,29,1,1,2014,15,15196,2448,17644
1,29,1,1,2014,16,15129,2482,17611
1,29,1,1,2014,17,14619,2454,17073
1,29,1,1,2014,18,13684,2433,16117
1,29,1,1,2014,19,13239,2455,15694
1,29,1,1,2014,20,13864,2498,16362
1,29,1,1,2014,21,13354,2327,15681
1,29,1,1,2014,22,12278,2137,14415
1,29,1,1,2014,23,11931,1942,13873
1,29,1,1,2014,24,11669,1740,13409
1,30,1,1,2014,1,12202,1585,13787
1,30,1,1,2014,2,11911,1453,13364
1,30,1,1,2014,3,11989,1371,13360
1,30,1,1,2014,4,12426,1323,13749
1,30,1,1,2014,5,12769,1347,14116
1,30,1,1,2014,6,12712,1463,14175
1,30,1,1,2014,7,13539,1671,15210
1,30,1,1,2014,8,14763,1845,16608
1,30,1,1,2014,9,15235,2055,17290
1,30,1,1,2014,10,15725,2349,18074
1,30,1,1,2014,11,15769,2526,18295
1,30,1,1,2014,12,15932,2554,18486
1,30,1,1,2014,13,15561,2531,18092
1,30,1,1,2014,14,15208,2436,17644
1,30,1,1,2014,15,15114,2457,17571
1,30,1,1,2014,16,15289,2463,17752
1,30,1,1,2014,17,14397,2468,16865
1,30,1,1,2014,18,13098,2454,15552
1,30,1,1,2014,19,13140,2451,15591
1,30,1,1,2014,20,13621,2500,16121
1,30,1,1,2014,21,13399,2346,15745
1,30,1,1,2014,22,12534,2170,14704
1,30,1,1,2014,23,12066,1976,14042
1,30,1,1,2014,24,11917,1790,13707
1,31,1,1,2014,1,11586,1575,13161
1,31,1,1,2014,2,11884,1454,13338
1,31,1,1,2014,3,11795,1390,13185
1,31,1,1,2014,4,12009,1357,13366
1,31,1,1,2014,5,11744,1363,13107
1,31,1,1,2014,6,12698,1484,14182
1,31,1,1,2014,7,13923,1679,15602
1,31,1,1,2014,8,14496,1852,16348
1,31,1,1,2014,9,15087,2107,17194
1,31,1,1,2014,10,15904,2375,18279
1,31,1,1,2014,11,15535,2570,18105
1,31,1,1,2014,12,15772,2630,18402
1,31,1,1,2014,13,15871,2616,18487
1,31,1,1,2014,14,14908,2477,17385
1,31,1,1,2014,15,14776,2507,17283
1,31,1,1,2014,16,14376,2518,16894
1,31,1,1,2014,17,14554,2511,17065
1,31,1,1,2014,18,12626,2485,15111
1,31,1,1,2014,19,12816,2489,15305
1,31,1,1,2014,20,13729,2534,16263
1,31,1,1,2014,21,12930,2395,15325
1,31,1,1,2014,22,11928,2227,14155
1,31,1,1,2014,23,11872,2040,13912
1,31,1,1,2014,24,11618,1832,13450
2,1,2,1,2014,1,11742,1594,13336
2,1,2,1,2014,2,11960,1462,13422
2,1,2,1,2014,3,11830,1391,13221
2,1,2,1,2014,4,11784,1360,13144
2,1,2,1,2014,5,12135,1361,13496
2,1,2,1,2014,6,12451,1467,13918
2,1,2,1,2014,7,13624,1624,15248
2,1,2,1,2014,8,14772,1744,16516
2,1,2,1,2014,9,15236,1974,17210
2,1,2,1,2014,10,15505,2257,17762
2,1,2,1,2014,11,15438,2444,17882
2,1,2,1,2014,12,15419,2482,17901
2,1,2,1,2014,13,15874,2478,18352
2,1,2,1,2014,14,15325,2340,17665
2,1,2,1,2014,15,15250,2331,17581
2,1,2,1,2014,16,15420,2307,17727
2,1,2,1,2014,17,14981,2287,17268
2,1,2,1,2014,18,12994,2256,15250
2,1,2,1,2014,19,13007,2327,15334
2,1,2,1,2014,20,13378,2388,15766
2,1,2,1,2014,21,12815,2283,15098
2,1,2,1,2014,22,11806,2131,13937
2,1,2,1,2014,23,11623,1945,13568
2,1,2,1,2014,24,11891,1804,13695
2,2,2,1,2014,1,12191,1629,13820
2,2,2,1,2014,2,12018,1497,13515
2,2,2,1,2014,3,11825,1429,13254
2,2,2,1,2014,4,11812,1397,13209
2,2,2,1,2014,5,11664,1404,13068
2,2,2,1,2014,6,12767,1456,14223
2,2,2,1,2014,7,13535,1486,15021
2,2,2,1,2014,8,14316,1571,15887
2,2,2,1,2014,9,14495,1688,16183
2,2,2,1,2014,10,15473,1823,17296
2,2,2,1,2014,11,15758,1916,17674
2,2,2,1,2014,12,15944,1930,17874
2,2,2,1,2014,13,15736,1918,17654
2,2,2,1,2014,14,15288,1841,17129
2,2,2,1,2014,15,15255,1774,17029
2,2,2,1,2014,16,15007,1739,16746
2,2,2,1,2014,17,14506,1731,16237
2,2,2,1,2014,18,12944,1757,14701
2,2,2,1,2014,19,12276,1899,14175
2,2,2,1,2014,20,12945,2041,14986
2,2,2,1,2014,21,12447,2047,14494
2,2,2,1,2014,22,12083,1980,14063
2,2,2,1,2014,23,11474,1886,13360
2,2,2,1,2014,24,11066,1749,12815
1,3,2,1,2014,1,11696,1598,13294
1,3,2,1,2014,2,11586,1504,13090
1,3,2,1,2014,3,11680,1398,13078
1,3,2,1,2014,4,11741,1362,13103
1,3,2,1,2014,5,11918,1384,13302
1,3,2,1,2014,6,12602,1485,14087
1,3,2,1,2014,7,13862,1669,15531
1,3,2,1,2014,8,14960,1834,16794
1,3,2,1,2014,9,15832,2085,17917
1,3,2,1,2014,10,15894,2367,18261
1,3,2,1,2014,11,16081,2564,18645
1,3,2,1,2014,12,16000,2643,18643
1,3,2,1,2014,13,16053,2633,18686
1,3,2,1,2014,14,15668,2534,18202
1,3,2,1,2014,15,15672,2552,18224
1,3,2,1,2014,16,15701,2541,18242
1,3,2,1,2014,17,15067,2529,17596
1,3,2,1,2014,18,13621,2490,16111
1,3,2,1,2014,19,13021,2478,15499
1,3,2,1,2014,20,13428,2487,15915
1,3,2,1,2014,21,12547,2370,14917
1,3,2,1,2014,22,12571,2191,14762
1,3,2,1,2014,23,11712,2038,13750
1,3,2,1,2014,24,11549,1849,13398
1,4,2,1,2014,1,12261,1644,13905
1,4,2,1,2014,2,12221,1510,13731
1,4,2,1,2014,3,12436,1429,13865
1,4,2,1,2014,4,12287,1393,13680
1,4,2,1,2014,5,12460,1393,13853
1,4,2,1,2014,6,13344,1518,14862
1,4,2,1,2014,7,13970,1726,15696
1,4,2,1,2014,8,15219,1895,17114
1,4,2,1,2014,9,15526,2139,17665
1,4,2,1,2014,10,16050,2367,18417
1,4,2,1,2014,11,16191,2613,18804
1,4,2,1,2014,12,16131,2654,18785
1,4,2,1,2014,13,16272,2658,18930
1,4,2,1,2014,14,15992,2531,18523
1,4,2,1,2014,15,15830,2571,18401
1,4,2,1,2014,16,15834,2588,18422
1,4,2,1,2014,17,15345,2576,17921
1,4,2,1,2014,18,13533,2539,16072
1,4,2,1,2014,19,13533,2528,16061
1,4,2,1,2014,20,13709,2545,16254
1,4,2,1,2014,21,12984,2383,15367
1,4,2,1,2014,22,12187,2229,14416
1,4,2,1,2014,23,12347,2051,14398
1,4,2,1,2014,24,12330,1862,14192
1,5,2,1,2014,1,12397,1678,14075
1,5,2,1,2014,2,12630,1527,14157
1,5,2,1,2014,3,12347,1458,13805
1,5,2,1,2014,4,12530,1421,13951
1,5,2,1,2014,5,12604,1427,14031
1,5,2,1,2014,6,12896,1537,14433
1,5,2,1,2014,7,13973,1748,15721
1,5,2,1,2014,8,16171,1889,18060
1,5,2,1,2014,9,16227,2138,18365
1,5,2,1,2014,10,16641,2437,19078
1,5,2,1,2014,11,16567,2647,19214
1,5,2,1,2014,12,16475,2699,19174
1,5,2,1,2014,13,16684,2680,19364
1,5,2,1,2014,14,15970,2561,18531
1,5,2,1,2014,15,16337,2595,18932
1,5,2,1,2014,16,16190,2586,18776
1,5,2,1,2014,17,15252,2569,17821
1,5,2,1,2014,18,13763,2531,16294
1,5,2,1,2014,19,12852,2530,15382
1,5,2,1,2014,20,13624,2560,16184
1,5,2,1,2014,21,13301,2394,15695
1,5,2,1,2014,22,12620,2224,14844
1,5,2,1,2014,23,12398,2050,14448
1,5,2,1,2014,24,12550,1867,14417
1,6,2,1,2014,1,12668,1682,14350
1,6,2,1,2014,2,12575,1542,14117
1,6,2,1,2014,3,12612,1473,14085
1,6,2,1,2014,4,12815,1437,14252
1,6,2,1,2014,5,13003,1436,14439
1,6,2,1,2014,6,13445,1564,15009
1,6,2,1,2014,7,14226,1740,15966
1,6,2,1,2014,8,15864,1910,17774
1,6,2,1,2014,9,16132,2160,18292
1,6,2,1,2014,10,16205,2443,18648
1,6,2,1,2014,11,16447,2639,19086
1,6,2,1,2014,12,16791,2679,19470
1,6,2,1,2014,13,16497,2661,19158
1,6,2,1,2014,14,15893,2538,18431
1,6,2,1,2014,15,16160,2577,18737
1,6,2,1,2014,16,15849,2562,18411
1,6,2,1,2014,17,15136,2577,17713
1,6,2,1,2014,18,13747,2546,16293
1,6,2,1,2014,19,13296,2531,15827
1,6,2,1,2014,20,13950,2561,16511
1,6,2,1,2014,21,13646,2414,16060
1,6,2,1,2014,22,13230,2251,15481
1,6,2,1,2014,23,12840,2050,14890
1,6,2,1,2014,24,12884,1847,14731
1,7,2,1,2014,1,12725,1663,14388
1,7,2,1,2014,2,12343,1508,13851
1,7,2,1,2014,3,12685,1442,14127
1,7,2,1,2014,4,12925,1395,14320
1,7,2,1,2014,5,12901,1409,14310
1,7,2,1,2014,6,13482,1507,14989
1,7,2,1,2014,7,14513,1706,16219
1,7,2,1,2014,8,15377,1854,17231
1,7,2,1,2014,9,15839,2112,17951
1,7,2,1,2014,10,15729,2406,18135
1,7,2,1,2014,11,15971,2598,18569
1,7,2,1,2014,12,16067,2651,18718
1,7,2,1,2014,13,15782,2641,18423
1,7,2,1,2014,14,15410,2520,17930
1,7,2,1,2014,15,15151,2543,17694
1,7,2,1,2014,16,15354,2553,17907
1,7,2,1,2014,17,14669,2531,17200
1,7,2,1,2014,18,13018,2500,15518
1,7,2,1,2014,19,13147,2476,15623
1,7,2,1,2014,20,13873,2517,16390
1,7,2,1,2014,21,13489,2355,15844
1,7,2,1,2014,22,12560,2185,14745
1,7,2,1,2014,23,12416,1970,14386
1,7,2,1,2014,24,12594,1807,14401
2,8,2,1,2014,1,12836,1661,14497
2,8,2,1,2014,2,12847,1494,14341
2,8,2,1,2014,3,12746,1418,14164
2,8,2,1,2014,4,12928,1380,14308
2,8,2,1,2014,5,12865,1384,14249
2,8,2,1,2014,6,13333,1475,14808
2,8,2,1,2014,7,14149,1608,15757
2,8,2,1,2014,8,15371,1695,17066
2,8,2,1,2014,9,16060,1871,17931
2,8,2,1,2014,10,16513,2080,18593
2,8,2,1,2014,11,16636,2394,19030
2,8,2,1,2014,12,16652,2449,19101
2,8,2,1,2014,13,16131,2445,18576
2,8,2,1,2014,14,15978,2291,18269
2,8,2,1,2014,15,15835,2266,18101
2,8,2,1,2014,16,15619,2239,17858
2,8,2,1,2014,17,15051,2206,17257
2,8,2,1,2014,18,13401,2179,15580
2,8,2,1,2014,19,12731,2240,14971
2,8,2,1,2014,20,13926,2334,16260
2,8,2,1,2014,21,13177,2227,15404
2,8,2,1,2014,22,12665,2086,14751
2,8,2,1,2014,23,12473,1885,14358
2,8,2,1,2014,24,12637,1728,14365
2,9,2,1,2014,1,12756,1516,14272
2,9,2,1,2014,2,12579,1425,14004
2,9,2,1,2014,3,12493,1380,13873
2,9,2,1,2014,4,12754,1358,14112
2,9,2,1,2014,5,12844,1314,14158
2,9,2,1,2014,6,13292,1406,14698
2,9,2,1,2014,7,13989,1448,15437
2,9,2,1,2014,8,14986,1535,16521
2,9,2,1,2014,9,15427,1643,17070
2,9,2,1,2014,10,15989,1797,17786
2,9,2,1,2014,11,16351,1883,18234
2,9,2,1,2014,12,16358,1904,18262
2,9,2,1,2014,13,16158,1854,18012
2,9,2,1,2014,14,15861,1770,17631
2,9,2,1,2014,15,15492,1692,17184
2,9,2,1,2014,16,15693,1631,17324
2,9,2,1,2014,17,14510,1600,16110
2,9,2,1,2014,18,12730,1624,14354
2,9,2,1,2014,19,12424,1746,14170
2,9,2,1,2014,20,13469,1916,15385
2,9,2,1,2014,21,13060,1908,14968
2,9,2,1,2014,22,12467,1833,14300
2,9,2,1,2014,23,12062,1679,13741
2,9,2,1,2014,24,12084,1495,13579
1,11,2,1,2014,1,12398,1386,13784
1,11,2,1,2014,2,12263,1300,13563
1,11,2,1,2014,3,12348,1219,13567
1,11,2,1,2014,4,12318,1186,13504
1,11,2,1,2014,5,12696,1201,13897
1,11,2,1,2014,6,13022,1341,14363
1,11,2,1,2014,7,14078,1557,15635
1,11,2,1,2014,8,15149,1731,16880
1,11,2,1,2014,9,15828,1979,17807
1,11,2,1,2014,10,16145,2241,18386
1,11,2,1,2014,11,16233,2401,18634
1,11,2,1,2014,12,16364,2424,18788
1,11,2,1,2014,13,15968,2399,18367
1,11,2,1,2014,14,15711,2289,18000
1,11,2,1,2014,15,15526,2299,17825
1,11,2,1,2014,16,15386,2283,17669
1,11,2,1,2014,17,14875,2280,17155
1,11,2,1,2014,18,13045,2256,15301
1,11,2,1,2014,19,13131,2264,15395
1,11,2,1,2014,20,13840,2328,16168
1,11,2,1,2014,21,13523,2205,15728
1,11,2,1,2014,22,12935,2000,14935
1,11,2,1,2014,23,12360,1824,14184
1,11,2,1,2014,24,12397,1621,14018
1,12,2,1,2014,1,12688,1438,14126
1,12,2,1,2014,2,12613,1321,13934
1,12,2,1,2014,3,12557,1267,13824
1,12,2,1,2014,4,12851,1233,14084
1,12,2,1,2014,5,12822,1260,14082
1,12,2,1,2014,6,13652,1388,15040
1,12,2,1,2014,7,14363,1581,15944
1,12,2,1,2014,8,15503,1738,17241
1,12,2,1,2014,9,16212,1990,18202
1,12,2,1,2014,10,16475,2251,18726
1,12,2,1,2014,11,16548,2406,18954
1,12,2,1,2014,12,16673,2439,19112
1,12,2,1,2014,13,16506,2405,18911
1,12,2,1,2014,14,15975,2283,18258
1,12,2,1,2014,15,15671,2290,17961
1,12,2,1,2014,16,15744,2288,18032
1,12,2,1,2014,17,15196,2281,17477
1,12,2,1,2014,18,13404,2276,15680
1,12,2,1,2014,19,12968,2262,15230
1,12,2,1,2014,20,13981,2301,16282
1,12,2,1,2014,21,13354,2217,15571
1,12,2,1,2014,22,12555,2061,14616
1,12,2,1,2014,23,12258,1882,14140
1,12,2,1,2014,24,12474,1706,14180
1,13,2,1,2014,1,12786,1470,14256
1,13,2,1,2014,2,12834,1354,14188
1,13,2,1,2014,3,12573,1299,13872
1,13,2,1,2014,4,12710,1267,13977
1,13,2,1,2014,5,12956,1292,14248
1,13,2,1,2014,6,13366,1422,14788
1,13,2,1,2014,7,14353,1614,15967
1,13,2,1,2014,8,15708,1770,17478
1,13,2,1,2014,9,15969,2023,17992
1,13,2,1,2014,10,16191,2285,18476
1,13,2,1,2014,11,16132,2440,18572
1,13,2,1,2014,12,16005,2470,18475
1,13,2,1,2014,13,15529,2431,17960
1,13,2,1,2014,14,14841,2315,17156
1,13,2,1,2014,15,14594,2327,16921
1,13,2,1,2014,16,14343,2315,16658
1,13,2,1,2014,17,14081,2318,16399
1,13,2,1,2014,18,12521,2309,14830
1,13,2,1,2014,19,12361,2308,14669
1,13,2,1,2014,20,13123,2385,15508
1,13,2,1,2014,21,13148,2238,15386
1,13,2,1,2014,22,12519,2089,14608
1,13,2,1,2014,23,12285,1888,14173
1,13,2,1,2014,24,12455,1710,14165
1,14,2,1,2014,1,12353,1504,13857
1,14,2,1,2014,2,12595,1352,13947
1,14,2,1,2014,3,12460,1286,13746
1,14,2,1,2014,4,12780,1270,14050
1,14,2,1,2014,5,12708,1291,13999
1,14,2,1,2014,6,13233,1416,14649
1,14,2,1,2014,7,14102,1642,15744
1,14,2,1,2014,8,14838,1810,16648
1,14,2,1,2014,9,15361,2075,17436
1,14,2,1,2014,10,15642,2354,17996
1,14,2,1,2014,11,15709,2508,18217
1,14,2,1,2014,12,15543,2536,18079
1,14,2,1,2014,13,15150,2503,17653
1,14,2,1,2014,14,14225,2338,16563
1,14,2,1,2014,15,13906,2350,16256
1,14,2,1,2014,16,13885,2336,16221
1,14,2,1,2014,17,13391,2345,15736
1,14,2,1,2014,18,12428,2326,14754
1,14,2,1,2014,19,12488,2318,14806
1,14,2,1,2014,20,12880,2328,15208
1,14,2,1,2014,21,13030,2189,15219
1,14,2,1,2014,22,12663,2052,14715
1,14,2,1,2014,23,12004,1914,13918
1,14,2,1,2014,24,12067,1692,13759
2,15,2,1,2014,1,12221,1568,13789
2,15,2,1,2014,2,12289,1343,13632
2,15,2,1,2014,3,12395,1273,13668
2,15,2,1,2014,4,12071,1245,13316
2,15,2,1,2014,5,12135,1272,13407
2,15,2,1,2014,6,13219,1373,14592
2,15,2,1,2014,7,13997,1555,15552
2,15,2,1,2014,8,15070,1671,16741
2,15,2,1,2014,9,15556,1882,17438
2,15,2,1,2014,10,15801,2184,17985
2,15,2,1,2014,11,15812,2358,18170
2,15,2,1,2014,12,15781,2335,18116
2,15,2,1,2014,13,15145,2231,17376
2,15,2,1,2014,14,14279,2046,16325
2,15,2,1,2014,15,14105,2021,16126
2,15,2,1,2014,16,14079,1981,16060
2,15,2,1,2014,17,13503,1992,15495
2,15,2,1,2014,18,12376,2008,14384
2,15,2,1,2014,19,12745,2061,14806
2,15,2,1,2014,20,13370,2194,15564
2,15,2,1,2014,21,12766,2094,14860
2,15,2,1,2014,22,11974,1944,13918
2,15,2,1,2014,23,11499,1758,13257
2,15,2,1,2014,24,11745,1613,13358
2,16,2,1,2014,1,11752,1454,13206
2,16,2,1,2014,2,12136,1272,13408
2,16,2,1,2014,3,12120,1199,13319
2,16,2,1,2014,4,12257,1179,13436
2,16,2,1,2014,5,12320,1212,13532
2,16,2,1,2014,6,12814,1285,14099
2,16,2,1,2014,7,13639,1351,14990
2,16,2,1,2014,8,14711,1416,16127
2,16,2,1,2014,9,15669,1568,17237
2,16,2,1,2014,10,15710,1714,17424
2,16,2,1,2014,11,16022,1821,17843
2,16,2,1,2014,12,16112,1787,17899
2,16,2,1,2014,13,15574,1768,17342
2,16,2,1,2014,14,14712,1691,16403
2,16,2,1,2014,15,14444,1612,16056
2,16,2,1,2014,16,14582,1542,16124
2,16,2,1,2014,17,14114,1552,15666
2,16,2,1,2014,18,12155,1589,13744
2,16,2,1,2014,19,12399,1716,14115
2,16,2,1,2014,20,12896,1871,14767
2,16,2,1,2014,21,12426,1868,14294
2,16,2,1,2014,22,11490,1780,13270
2,16,2,1,2014,23,11444,1677,13121
2,16,2,1,2014,24,11914,1577,13491
1,17,2,1,2014,1,12256,1382,13638
1,17,2,1,2014,2,11857,1298,13155
1,17,2,1,2014,3,11627,1206,12833
1,17,2,1,2014,4,12124,1173,13297
1,17,2,1,2014,5,12318,1196,13514
1,17,2,1,2014,6,12608,1316,13924
1,17,2,1,2014,7,14223,1528,15751
1,17,2,1,2014,8,14832,1684,16516
1,17,2,1,2014,9,15614,1895,17509
1,17,2,1,2014,10,15556,2100,17656
1,17,2,1,2014,11,15513,2362,17875
1,17,2,1,2014,12,15607,2388,17995
1,17,2,1,2014,13,15628,2380,18008
1,17,2,1,2014,14,15354,2280,17634
1,17,2,1,2014,15,15159,2290,17449
1,17,2,1,2014,16,15253,2276,17529
1,17,2,1,2014,17,14725,2273,16998
1,17,2,1,2014,18,13284,2249,15533
1,17,2,1,2014,19,12749,2258,15007
1,17,2,1,2014,20,13753,2321,16074
1,17,2,1,2014,21,12970,2258,15228
1,17,2,1,2014,22,12075,1989,14064
1,17,2,1,2014,23,12087,1738,13825
1,17,2,1,2014,24,12171,1589,13760
1,18,2,1,2014,1,11943,1437,13380
1,18,2,1,2014,2,11868,1316,13184
1,18,2,1,2014,3,11887,1256,13143
1,18,2,1,2014,4,11933,1215,13148
1,18,2,1,2014,5,12249,1249,13498
1,18,2,1,2014,6,12758,1417,14175
1,18,2,1,2014,7,13568,1625,15193
1,18,2,1,2014,8,15052,1791,16843
1,18,2,1,2014,9,15570,2032,17602
1,18,2,1,2014,10,16007,2260,18267
1,18,2,1,2014,11,15993,2428,18421
1,18,2,1,2014,12,16062,2440,18502
1,18,2,1,2014,13,15801,2433,18234
1,18,2,1,2014,14,15571,2368,17939
1,18,2,1,2014,15,15154,2380,17534
1,18,2,1,2014,16,15222,2368,17590
1,18,2,1,2014,17,15093,2372,17465
1,18,2,1,2014,18,13166,2352,15518
1,18,2,1,2014,19,12944,2351,15295
1,18,2,1,2014,20,13767,2428,16195
1,18,2,1,2014,21,13140,2252,15392
1,18,2,1,2014,22,12403,2062,14465
1,18,2,1,2014,23,11784,1915,13699
1,18,2,1,2014,24,11778,1774,13552
3,19,2,1,2014,1,12006,1513,13519
3,19,2,1,2014,2,11973,1383,13356
3,19,2,1,2014,3,11778,1317,13095
3,19,2,1,2014,4,12396,1285,13681
3,19,2,1,2014,5,12058,1307,13365
3,19,2,1,2014,6,12676,1428,14104
3,19,2,1,2014,7,13525,1583,15108
3,19,2,1,2014,8,15076,1730,16806
3,19,2,1,2014,9,16307,1973,18280
3,19,2,1,2014,10,16682,2263,18945
3,19,2,1,2014,11,16725,2463,19188
3,19,2,1,2014,12,17158,2477,19635
3,19,2,1,2014,13,16880,2472,19352
3,19,2,1,2014,14,16515,2381,18896
3,19,2,1,2014,15,16172,2375,18547
3,19,2,1,2014,16,16005,2370,18375
3,19,2,1,2014,17,15533,2368,17901
3,19,2,1,2014,18,13921,2371,16292
3,19,2,1,2014,19,13226,2373,15599
3,19,2,1,2014,20,13974,2437,16411
3,19,2,1,2014,21,13373,2340,15713
3,19,2,1,2014,22,12406,2172,14578
3,19,2,1,2014,23,12013,2022,14035
3,19,2,1,2014,24,12006,1811,13817
1,20,2,1,2014,1,12311,1619,13930
1,20,2,1,2014,2,12425,1478,13903
1,20,2,1,2014,3,12343,1414,13757
1,20,2,1,2014,4,12706,1396,14102
1,20,2,1,2014,5,12718,1416,14134
1,20,2,1,2014,6,13310,1539,14849
1,20,2,1,2014,7,14215,1712,15927
1,20,2,1,2014,8,15517,1892,17409
1,20,2,1,2014,9,16309,2139,18448
1,20,2,1,2014,10,16618,2402,19020
1,20,2,1,2014,11,16467,2617,19084
1,20,2,1,2014,12,16667,2627,19294
1,20,2,1,2014,13,16483,2602,19085
1,20,2,1,2014,14,16705,2504,19209
1,20,2,1,2014,15,16254,2516,18770
1,20,2,1,2014,16,15973,2513,18486
1,20,2,1,2014,17,15503,2489,17992
1,20,2,1,2014,18,13844,2446,16290
1,20,2,1,2014,19,13076,2447,15523
1,20,2,1,2014,20,13808,2515,16323
1,20,2,1,2014,21,13258,2420,15678
1,20,2,1,2014,22,12359,2171,14530
1,20,2,1,2014,23,12355,2006,14361
1,20,2,1,2014,24,12297,1784,14081
1,21,2,1,2014,1,12573,1643,14216
1,21,2,1,2014,2,12536,1519,14055
1,21,2,1,2014,3,12411,1456,13867
1,21,2,1,2014,4,12429,1424,13853
1,21,2,1,2014,5,12710,1425,14135
1,21,2,1,2014,6,13818,1564,15382
1,21,2,1,2014,7,14574,1754,16328
1,21,2,1,2014,8,15575,1924,17499
1,21,2,1,2014,9,15721,2157,17878
1,21,2,1,2014,10,16261,2416,18677
1,21,2,1,2014,11,16021,2608,18629
1,21,2,1,2014,12,16294,2687,18981
1,21,2,1,2014,13,15999,2679,18678
1,21,2,1,2014,14,15284,2485,17769
1,21,2,1,2014,15,15147,2472,17619
1,21,2,1,2014,16,15116,2480,17596
1,21,2,1,2014,17,14531,2485,17016
1,21,2,1,2014,18,12842,2454,15296
1,21,2,1,2014,19,13047,2440,15487
1,21,2,1,2014,20,14063,2497,16560
1,21,2,1,2014,21,13750,2337,16087
1,21,2,1,2014,22,12697,2166,14863
1,21,2,1,2014,23,12559,1996,14555
1,21,2,1,2014,24,12236,1793,14029
2,22,2,1,2014,1,12289,1656,13945
2,22,2,1,2014,2,12508,1502,14010
2,22,2,1,2014,3,12231,1418,13649
2,22,2,1,2014,4,12159,1385,13544
2,22,2,1,2014,5,12293,1393,13686
2,22,2,1,2014,6,13217,1490,14707
2,22,2,1,2014,7,13991,1631,15622
2,22,2,1,2014,8,15251,1746,16997
2,22,2,1,2014,9,15795,1967,17762
2,22,2,1,2014,10,16085,2241,18326
2,22,2,1,2014,11,16122,2439,18561
2,22,2,1,2014,12,16246,2471,18717
2,22,2,1,2014,13,16196,2456,18652
2,22,2,1,2014,14,15605,2263,17868
2,22,2,1,2014,15,15568,2256,17824
2,22,2,1,2014,16,15543,2229,17772
2,22,2,1,2014,17,14863,2212,17075
2,22,2,1,2014,18,13317,2201,15518
2,22,2,1,2014,19,13252,2227,15479
2,22,2,1,2014,20,13943,2366,16309
2,22,2,1,2014,21,13138,2312,15450
2,22,2,1,2014,22,13074,2043,15117
2,22,2,1,2014,23,12583,1910,14493
2,22,2,1,2014,24,12975,1796,14771
2,23,2,1,2014,1,13058,1617,14675
2,23,2,1,2014,2,12821,1473,14294
2,23,2,1,2014,3,12928,1407,14335
2,23,2,1,2014,4,12872,1366,14238
2,23,2,1,2014,5,13032,1375,14407
2,23,2,1,2014,6,13523,1447,14970
2,23,2,1,2014,7,14421,1508,15929
2,23,2,1,2014,8,14765,1566,16331
2,23,2,1,2014,9,15452,1682,17134
2,23,2,1,2014,10,15772,1825,17597
2,23,2,1,2014,11,15935,1924,17859
2,23,2,1,2014,12,16118,1949,18067
2,23,2,1,2014,13,15979,1918,17897
2,23,2,1,2014,14,15685,1833,17518
2,23,2,1,2014,15,15289,1782,17071
2,23,2,1,2014,16,15177,1734,16911
2,23,2,1,2014,17,14222,1729,15951
2,23,2,1,2014,18,12719,1746,14465
2,23,2,1,2014,19,12217,1851,14068
2,23,2,1,2014,20,12930,2033,14963
2,23,2,1,2014,21,12775,2044,14819
2,23,2,1,2014,22,12158,1974,14132
2,23,2,1,2014,23,11973,1846,13819
2,23,2,1,2014,24,11872,1709,13581
1,24,2,1,2014,1,12413,1600,14013
1,24,2,1,2014,2,12164,1470,13634
1,24,2,1,2014,3,12119,1405,13524
1,24,2,1,2014,4,11786,1364,13150
1,24,2,1,2014,5,12023,1385,13408
1,24,2,1,2014,6,12887,1503,14390
1,24,2,1,2014,7,13749,1708,15457
1,24,2,1,2014,8,14801,1880,16681
1,24,2,1,2014,9,14939,2134,17073
1,24,2,1,2014,10,15063,2431,17494
1,24,2,1,2014,11,15298,2665,17963
1,24,2,1,2014,12,15673,2688,18361
1,24,2,1,2014,13,15215,2687,17902
1,24,2,1,2014,14,15109,2566,17675
1,24,2,1,2014,15,15030,2576,17606
1,24,2,1,2014,16,15463,2569,18032
1,24,2,1,2014,17,14619,2581,17200
1,24,2,1,2014,18,12993,2539,15532
1,24,2,1,2014,19,12636,2519,15155
1,24,2,1,2014,20,13477,2592,16069
1,24,2,1,2014,21,12855,2427,15282
1,24,2,1,2014,22,12181,2230,14411
1,24,2,1,2014,23,11520,2102,13622
1,24,2,1,2014,24,11525,1940,13465
1,25,2,1,2014,1,11866,1702,13568
1,25,2,1,2014,2,11834,1563,13397
1,25,2,1,2014,3,12193,1484,13677
1,25,2,1,2014,4,11448,1445,12893
1,25,2,1,2014,5,11936,1465,13401
1,25,2,1,2014,6,12672,1571,14243
1,25,2,1,2014,7,13750,1795,15545
1,25,2,1,2014,8,14301,1964,16265
1,25,2,1,2014,9,14501,2234,16735
1,25,2,1,2014,10,15045,2531,17576
1,25,2,1,2014,11,14976,2761,17737
1,25,2,1,2014,12,15160,2812,17972
1,25,2,1,2014,13,15141,2805,17946
1,25,2,1,2014,14,15046,2670,17716
1,25,2,1,2014,15,14716,2695,17411
1,25,2,1,2014,16,14939,2696,17635
1,25,2,1,2014,17,14418,2692,17110
1,25,2,1,2014,18,12531,2652,15183
1,25,2,1,2014,19,12669,2614,15283
1,25,2,1,2014,20,13587,2650,16237
1,25,2,1,2014,21,12945,2505,15450
1,25,2,1,2014,22,12534,2329,14863
1,25,2,1,2014,23,12086,2179,14265
1,25,2,1,2014,24,12315,1970,14285
1,26,2,1,2014,1,12296,1777,14073
1,26,2,1,2014,2,12183,1626,13809
1,26,2,1,2014,3,12036,1555,13591
1,26,2,1,2014,4,12492,1500,13992
1,26,2,1,2014,5,12339,1507,13846
1,26,2,1,2014,6,13189,1620,14809
1,26,2,1,2014,7,13811,1812,15623
1,26,2,1,2014,8,14810,1968,16778
1,26,2,1,2014,9,15260,2230,17490
1,26,2,1,2014,10,15594,2531,18125
1,26,2,1,2014,11,15779,2743,18522
1,26,2,1,2014,12,15799,2782,18581
1,26,2,1,2014,13,15479,2777,18256
1,26,2,1,2014,14,15282,2639,17921
1,26,2,1,2014,15,15090,2674,17764
1,26,2,1,2014,16,15026,2684,17710
1,26,2,1,2014,17,14060,2681,16741
1,26,2,1,2014,18,12306,2633,14939
1,26,2,1,2014,19,12366,2595,14961
1,26,2,1,2014,20,12659,2646,15305
1,26,2,1,2014,21,12499,2508,15007
1,26,2,1,2014,22,12026,2322,14348
1,26,2,1,2014,23,11659,2170,13829
1,26,2,1,2014,24,11665,2007,13672
3,27,2,1,2014,1,11978,1802,13780
3,27,2,1,2014,2,11497,1636,13133
3,27,2,1,2014,3,11470,1557,13027
3,27,2,1,2014,4,11576,1514,13090
3,27,2,1,2014,5,11619,1520,13139
3,27,2,1,2014,6,12513,1616,14129
3,27,2,1,2014,7,12876,1719,14595
3,27,2,1,2014,8,13598,1888,15486
3,27,2,1,2014,9,13923,2143,16066
3,27,2,1,2014,10,14243,2432,16675
3,27,2,1,2014,11,14322,2613,16935
3,27,2,1,2014,12,14375,2624,16999
3,27,2,1,2014,13,13972,2588,16560
3,27,2,1,2014,14,13569,2434,16003
3,27,2,1,2014,15,13797,2445,16242
3,27,2,1,2014,16,13642,2425,16067
3,27,2,1,2014,17,12750,2410,15160
3,27,2,1,2014,18,11090,2377,13467
3,27,2,1,2014,19,11464,2341,13805
3,27,2,1,2014,20,12311,2423,14734
3,27,2,1,2014,21,11836,2337,14173
3,27,2,1,2014,22,11413,2228,13641
3,27,2,1,2014,23,11411,2004,13415
3,27,2,1,2014,24,11158,1816,12974
1,28,2,1,2014,1,11211,1740,12951
1,28,2,1,2014,2,10832,1605,12437
1,28,2,1,2014,3,11007,1536,12543
1,28,2,1,2014,4,10513,1492,12005
1,28,2,1,2014,5,10930,1501,12431
1,28,2,1,2014,6,11612,1602,13214
1,28,2,1,2014,7,12181,1773,13954
1,28,2,1,2014,8,13137,1955,15092
1,28,2,1,2014,9,13095,2188,15283
1,28,2,1,2014,10,12932,2470,15402
1,28,2,1,2014,11,13059,2639,15698
1,28,2,1,2014,12,13040,2653,15693
1,28,2,1,2014,13,12746,2628,15374
1,28,2,1,2014,14,12438,2468,14906
1,28,2,1,2014,15,12399,2484,14883
1,28,2,1,2014,16,12542,2494,15036
1,28,2,1,2014,17,12420,2487,14907
1,28,2,1,2014,18,10818,2446,13264
1,28,2,1,2014,19,10875,2410,13285
1,28,2,1,2014,20,12529,2469,14998
1,28,2,1,2014,21,11952,2333,14285
1,28,2,1,2014,22,11616,2102,13718
1,28,2,1,2014,23,11119,1997,13116
1,28,2,1,2014,24,10651,1898,12549
2,1,3,1,2014,1,10948,1582,12530
2,1,3,1,2014,2,10732,1495,12227
2,1,3,1,2014,3,10426,1435,11861
2,1,3,1,2014,4,10560,1398,11958
2,1,3,1,2014,5,11041,1403,12444
2,1,3,1,2014,6,11427,1498,12925
2,1,3,1,2014,7,12067,1600,13667
2,1,3,1,2014,8,12974,1704,14678
2,1,3,1,2014,9,13010,1924,14934
2,1,3,1,2014,10,13651,2158,15809
2,1,3,1,2014,11,13594,2324,15918
2,1,3,1,2014,12,13760,2411,16171
2,1,3,1,2014,13,13602,2375,15977
2,1,3,1,2014,14,13400,2235,15635
2,1,3,1,2014,15,13315,2215,15530
2,1,3,1,2014,16,13351,2193,15544
2,1,3,1,2014,17,12941,2197,15138
2,1,3,1,2014,18,11350,2177,13527
2,1,3,1,2014,19,11431,2186,13617
2,1,3,1,2014,20,12785,2302,15087
2,1,3,1,2014,21,12055,2212,14267
2,1,3,1,2014,22,11454,2065,13519
2,1,3,1,2014,23,11134,1894,13028
2,1,3,1,2014,24,11063,1726,12789
2,2,3,1,2014,1,10677,1542,12219
2,2,3,1,2014,2,10937,1423,12360
2,2,3,1,2014,3,10648,1367,12015
2,2,3,1,2014,4,10903,1327,12230
2,2,3,1,2014,5,10811,1338,12149
2,2,3,1,2014,6,11287,1408,12695
2,2,3,1,2014,7,11902,1449,13351
2,2,3,1,2014,8,13188,1506,14694
2,2,3,1,2014,9,13253,1633,14886
2,2,3,1,2014,10,13839,1753,15592
2,2,3,1,2014,11,13837,1834,15671
2,2,3,1,2014,12,13912,1818,15730
2,2,3,1,2014,13,13589,1827,15416
2,2,3,1,2014,14,13563,1770,15333
2,2,3,1,2014,15,13601,1722,15323
2,2,3,1,2014,16,13570,1680,15250
2,2,3,1,2014,17,13255,1700,14955
2,2,3,1,2014,18,11267,1733,13000
2,2,3,1,2014,19,11580,1792,13372
2,2,3,1,2014,20,12603,2004,14607
2,2,3,1,2014,21,11845,1985,13830
2,2,3,1,2014,22,11241,1929,13170
2,2,3,1,2014,23,10877,1810,12687
2,2,3,1,2014,24,10980,1665,12645
1,3,3,1,2014,1,11103,1504,12607
1,3,3,1,2014,2,10673,1396,12069
1,3,3,1,2014,3,10590,1345,11935
1,3,3,1,2014,4,10864,1314,12178
1,3,3,1,2014,5,11047,1317,12364
1,3,3,1,2014,6,11898,1424,13322
1,3,3,1,2014,7,13107,1603,14710
1,3,3,1,2014,8,13479,1771,15250
1,3,3,1,2014,9,14237,2017,16254
1,3,3,1,2014,10,14527,2263,16790
1,3,3,1,2014,11,14468,2423,16891
1,3,3,1,2014,12,14678,2547,17225
1,3,3,1,2014,13,14379,2555,16934
1,3,3,1,2014,14,14465,2431,16896
1,3,3,1,2014,15,14310,2434,16744
1,3,3,1,2014,16,14020,2429,16449
1,3,3,1,2014,17,13737,2422,16159
1,3,3,1,2014,18,11028,2406,13434
1,3,3,1,2014,19,11946,2367,14313
1,3,3,1,2014,20,12874,2440,15314
1,3,3,1,2014,21,12077,2291,14368
1,3,3,1,2014,22,11057,2112,13169
1,3,3,1,2014,23,10661,1930,12591
1,3,3,1,2014,24,10343,1762,12105
1,4,3,1,2014,1,10496,1598,12094
1,4,3,1,2014,2,10011,1499,11510
1,4,3,1,2014,3,9692,1454,11146
1,4,3,1,2014,4,9825,1397,11222
1,4,3,1,2014,5,9847,1368,11215
1,4,3,1,2014,6,10571,1493,12064
1,4,3,1,2014,7,11194,1664,12858
1,4,3,1,2014,8,12280,1828,14108
1,4,3,1,2014,9,12396,2063,14459
1,4,3,1,2014,10,12708,2340,15048
1,4,3,1,2014,11,12935,2534,15469
1,4,3,1,2014,12,12780,2631,15411
1,4,3,1,2014,13,12709,2609,15318
1,4,3,1,2014,14,12452,2488,14940
1,4,3,1,2014,15,12588,2500,15088
1,4,3,1,2014,16,12598,2530,15128
1,4,3,1,2014,17,12255,2542,14797
1,4,3,1,2014,18,11471,2521,13992
1,4,3,1,2014,19,11900,2507,14407
1,4,3,1,2014,20,12750,2584,15334
1,4,3,1,2014,21,12505,2427,14932
1,4,3,1,2014,22,11826,2251,14077
1,4,3,1,2014,23,11472,2067,13539
1,4,3,1,2014,24,10903,1851,12754
1,5,3,1,2014,1,10815,1696,12511
1,5,3,1,2014,2,10886,1563,12449
1,5,3,1,2014,3,10633,1493,12126
1,5,3,1,2014,4,10702,1457,12159
1,5,3,1,2014,5,11001,1453,12454
1,5,3,1,2014,6,11666,1593,13259
1,5,3,1,2014,7,12590,1649,14239
1,5,3,1,2014,8,13380,1790,15170
1,5,3,1,2014,9,13593,2130,15723
1,5,3,1,2014,10,13783,2509,16292
1,5,3,1,2014,11,14061,2720,16781
1,5,3,1,2014,12,14156,2749,16905
1,5,3,1,2014,13,13881,2714,16595
1,5,3,1,2014,14,13397,2576,15973
1,5,3,1,2014,15,13197,2585,15782
1,5,3,1,2014,16,12996,2595,15591
1,5,3,1,2014,17,12232,2586,14818
1,5,3,1,2014,18,11060,2541,13601
1,5,3,1,2014,19,11625,2500,14125
1,5,3,1,2014,20,12200,2689,14889
1,5,3,1,2014,21,12250,2460,14710
1,5,3,1,2014,22,11417,2244,13661
1,5,3,1,2014,23,11011,2075,13086
1,5,3,1,2014,24,10912,1870,12782
1,6,3,1,2014,1,10786,1702,12488
1,6,3,1,2014,2,10689,1555,12244
1,6,3,1,2014,3,10665,1494,12159
1,6,3,1,2014,4,10465,1451,11916
1,6,3,1,2014,5,10711,1463,12174
1,6,3,1,2014,6,11353,1572,12925
1,6,3,1,2014,7,11945,1754,13699
1,6,3,1,2014,8,12597,1928,14525
1,6,3,1,2014,9,12763,2207,14970
1,6,3,1,2014,10,13515,2507,16022
1,6,3,1,2014,11,13561,2696,16257
1,6,3,1,2014,12,13638,2739,16377
1,6,3,1,2014,13,13064,2706,15770
1,6,3,1,2014,14,12790,2574,15364
1,6,3,1,2014,15,12472,2588,15060
1,6,3,1,2014,16,12699,2591,15290
1,6,3,1,2014,17,12660,2582,15242
1,6,3,1,2014,18,11334,2539,13873
1,6,3,1,2014,19,11618,2506,14124
1,6,3,1,2014,20,12518,2563,15081
1,6,3,1,2014,21,12111,2448,14559
1,6,3,1,2014,22,11490,2255,13745
1,6,3,1,2014,23,11148,2078,13226
1,6,3,1,2014,24,11255,1917,13172
1,7,3,1,2014,1,10792,1723,12515
1,7,3,1,2014,2,10852,1568,12420
1,7,3,1,2014,3,10750,1505,12255
1,7,3,1,2014,4,10784,1466,12250
1,7,3,1,2014,5,10993,1471,12464
1,7,3,1,2014,6,11623,1589,13212
1,7,3,1,2014,7,12301,1783,14084
1,7,3,1,2014,8,12724,1973,14697
1,7,3,1,2014,9,12926,2221,15147
1,7,3,1,2014,10,12923,2519,15442
1,7,3,1,2014,11,12719,2725,15444
1,7,3,1,2014,12,12977,2802,15779
1,7,3,1,2014,13,12433,2767,15200
1,7,3,1,2014,14,12267,2606,14873
1,7,3,1,2014,15,12243,2604,14847
1,7,3,1,2014,16,12438,2632,15070
1,7,3,1,2014,17,12106,2627,14733
1,7,3,1,2014,18,10941,2598,13539
1,7,3,1,2014,19,11610,2539,14149
1,7,3,1,2014,20,12798,2609,15407
1,7,3,1,2014,21,12557,2477,15034
1,7,3,1,2014,22,11931,2313,14244
1,7,3,1,2014,23,11627,2114,13741
1,7,3,1,2014,24,11412,1943,13355
2,8,3,1,2014,1,11086,1823,12909
2,8,3,1,2014,2,11085,1644,12729
2,8,3,1,2014,3,11090,1557,12647
2,8,3,1,2014,4,11090,1515,12605
2,8,3,1,2014,5,11219,1516,12735
2,8,3,1,2014,6,11387,1615,13002
2,8,3,1,2014,7,12157,1726,13883
2,8,3,1,2014,8,12839,1848,14687
2,8,3,1,2014,9,13202,2050,15252
2,8,3,1,2014,10,13396,2337,15733
2,8,3,1,2014,11,13566,2548,16114
2,8,3,1,2014,12,13777,2589,16366
2,8,3,1,2014,13,13499,2587,16086
2,8,3,1,2014,14,13152,2448,15600
2,8,3,1,2014,15,12629,2463,15092
2,8,3,1,2014,16,12300,2423,14723
2,8,3,1,2014,17,11541,2481,14022
2,8,3,1,2014,18,10842,2368,13210
2,8,3,1,2014,19,11388,2399,13787
2,8,3,1,2014,20,11828,2513,14341
2,8,3,1,2014,21,11644,2442,14086
2,8,3,1,2014,22,11445,2214,13659
2,8,3,1,2014,23,10701,2090,12791
2,8,3,1,2014,24,10518,1963,12481
2,9,3,1,2014,1,10355,1787,12142
2,9,3,1,2014,2,10911,1639,12550
2,9,3,1,2014,3,10264,1550,11814
2,9,3,1,2014,4,10027,1498,11525
2,9,3,1,2014,5,10381,1505,11886
2,9,3,1,2014,6,10891,1569,12460
2,9,3,1,2014,7,11061,1613,12674
2,9,3,1,2014,8,11960,1665,13625
2,9,3,1,2014,9,11961,1770,13731
2,9,3,1,2014,10,12442,1909,14351
2,9,3,1,2014,11,12476,2004,14480
2,9,3,1,2014,12,12414,2040,14454
2,9,3,1,2014,13,12169,2034,14203
2,9,3,1,2014,14,11845,1954,13799
2,9,3,1,2014,15,11790,1898,13688
2,9,3,1,2014,16,11184,1866,13050
2,9,3,1,2014,17,10701,1843,12544
2,9,3,1,2014,18,10387,1860,12247
2,9,3,1,2014,19,10918,1925,12843
2,9,3,1,2014,20,11481,2097,13578
2,9,3,1,2014,21,11305,2113,13418
2,9,3,1,2014,22,10635,2114,12749
2,9,3,1,2014,23,10419,2016,12435
2,9,3,1,2014,24,10408,1905,12313
1,10,3,1,2014,1,10117,1762,11879
1,10,3,1,2014,2,9930,1587,11517
1,10,3,1,2014,3,9805,1516,11321
1,10,3,1,2014,4,9584,1475,11059
1,10,3,1,2014,5,9666,1479,11145
1,10,3,1,2014,6,10557,1589,12146
1,10,3,1,2014,7,11127,1785,12912
1,10,3,1,2014,8,11802,1947,13749
1,10,3,1,2014,9,11876,2218,14094
1,10,3,1,2014,10,12423,2527,14950
1,10,3,1,2014,11,12415,2737,15152
1,10,3,1,2014,12,12315,2778,15093
1,10,3,1,2014,13,12141,2777,14918
1,10,3,1,2014,14,11923,2662,14585
1,10,3,1,2014,15,12063,2679,14742
1,10,3,1,2014,16,12041,2680,14721
1,10,3,1,2014,17,11606,2649,14255
1,10,3,1,2014,18,10769,2589,13358
1,10,3,1,2014,19,11263,2540,13803
1,10,3,1,2014,20,12561,2590,15151
1,10,3,1,2014,21,12335,2501,14836
1,10,3,1,2014,22,11665,2342,14007
1,10,3,1,2014,23,11730,2176,13906
1,10,3,1,2014,24,11123,2023,13146
1,11,3,1,2014,1,10798,1804,12602
1,11,3,1,2014,2,10652,1638,12290
1,11,3,1,2014,3,10552,1557,12109
1,11,3,1,2014,4,10435,1513,11948
1,11,3,1,2014,5,10615,1519,12134
1,11,3,1,2014,6,11301,1623,12924
1,11,3,1,2014,7,12273,1795,14068
1,11,3,1,2014,8,12458,1951,14409
1,11,3,1,2014,9,12694,2218,14912
1,11,3,1,2014,10,13006,2522,15528
1,11,3,1,2014,11,12986,2714,15700
1,11,3,1,2014,12,12703,2750,15453
1,11,3,1,2014,13,12683,2747,15430
1,11,3,1,2014,14,12321,2624,14945
1,11,3,1,2014,15,12646,2645,15291
1,11,3,1,2014,16,12555,2641,15196
1,11,3,1,2014,17,12286,2645,14931
1,11,3,1,2014,18,11472,2600,14072
1,11,3,1,2014,19,11984,2560,14544
1,11,3,1,2014,20,12997,2631,15628
1,11,3,1,2014,21,12656,2530,15186
1,11,3,1,2014,22,11731,2363,14094
1,11,3,1,2014,23,11709,2189,13898
1,11,3,1,2014,24,11446,2042,13488
1,12,3,1,2014,1,11404,1797,13201
1,12,3,1,2014,2,11158,1648,12806
1,12,3,1,2014,3,10874,1565,12439
1,12,3,1,2014,4,11545,1522,13067
1,12,3,1,2014,5,11736,1517,13253
1,12,3,1,2014,6,12093,1629,13722
1,12,3,1,2014,7,12691,1813,14504
1,12,3,1,2014,8,13236,1971,15207
1,12,3,1,2014,9,13001,2244,15245
1,12,3,1,2014,10,13318,2546,15864
1,12,3,1,2014,11,13478,2774,16252
1,12,3,1,2014,12,13314,2814,16128
1,12,3,1,2014,13,13432,2795,16227
1,12,3,1,2014,14,12951,2706,15657
1,12,3,1,2014,15,13169,2732,15901
1,12,3,1,2014,16,13012,2708,15720
1,12,3,1,2014,17,13242,2722,15964
1,12,3,1,2014,18,11767,2675,14442
1,12,3,1,2014,19,11721,2619,14340
1,12,3,1,2014,20,11942,2685,14627
1,12,3,1,2014,21,12807,2582,15389
1,12,3,1,2014,22,12168,2341,14509
1,12,3,1,2014,23,11231,2221,13452
1,12,3,1,2014,24,11266,2123,13389
1,13,3,1,2014,1,11171,1897,13068
1,13,3,1,2014,2,10873,1683,12556
1,13,3,1,2014,3,10750,1645,12395
1,13,3,1,2014,4,10783,1628,12411
1,13,3,1,2014,5,10777,1645,12422
1,13,3,1,2014,6,11324,1681,13005
1,13,3,1,2014,7,11820,1951,13771
1,13,3,1,2014,8,12356,2061,14417
1,13,3,1,2014,9,12841,2181,15022
1,13,3,1,2014,10,13112,2533,15645
1,13,3,1,2014,11,13607,2730,16337
1,13,3,1,2014,12,13180,2860,16040
1,13,3,1,2014,13,12799,2859,15658
1,13,3,1,2014,14,12746,2821,15567
1,13,3,1,2014,15,12852,2821,15673
1,13,3,1,2014,16,13005,2824,15829
1,13,3,1,2014,17,12281,2807,15088
1,13,3,1,2014,18,11542,2750,14292
1,13,3,1,2014,19,11526,2656,14182
1,13,3,1,2014,20,12785,2673,15458
1,13,3,1,2014,21,12345,2631,14976
1,13,3,1,2014,22,11942,2361,14303
1,13,3,1,2014,23,11556,2242,13798
1,13,3,1,2014,24,11100,2123,13223
1,14,3,1,2014,1,11080,1926,13006
1,14,3,1,2014,2,10653,1799,12452
1,14,3,1,2014,3,10862,1689,12551
1,14,3,1,2014,4,10824,1653,12477
1,14,3,1,2014,5,10993,1663,12656
1,14,3,1,2014,6,11496,1737,13233
1,14,3,1,2014,7,12102,1887,13989
1,14,3,1,2014,8,12701,2065,14766
1,14,3,1,2014,9,12686,2300,14986
1,14,3,1,2014,10,12810,2649,15459
1,14,3,1,2014,11,12790,2878,15668
1,14,3,1,2014,12,12455,2951,15406
1,14,3,1,2014,13,12338,2945,15283
1,14,3,1,2014,14,12265,2809,15074
1,14,3,1,2014,15,12360,2854,15214
1,14,3,1,2014,16,12300,2869,15169
1,14,3,1,2014,17,12392,2864,15256
1,14,3,1,2014,18,11476,2807,14283
1,14,3,1,2014,19,11706,2710,14416
1,14,3,1,2014,20,12895,2723,15618
1,14,3,1,2014,21,12545,2798,15343
1,14,3,1,2014,22,12238,2444,14682
1,14,3,1,2014,23,12089,2202,14291
1,14,3,1,2014,24,11984,2058,14042
2,15,3,1,2014,1,11783,2001,13784
2,15,3,1,2014,2,11275,1819,13094
2,15,3,1,2014,3,11160,1745,12905
2,15,3,1,2014,4,11501,1693,13194
2,15,3,1,2014,5,11589,1686,13275
2,15,3,1,2014,6,12216,1795,14011
2,15,3,1,2014,7,12832,1898,14730
2,15,3,1,2014,8,13281,1970,15251
2,15,3,1,2014,9,13458,2138,15596
2,15,3,1,2014,10,13382,2393,15775
2,15,3,1,2014,11,13761,2688,16449
2,15,3,1,2014,12,14003,2709,16712
2,15,3,1,2014,13,13889,2682,16571
2,15,3,1,2014,14,13408,2669,16077
2,15,3,1,2014,15,13685,2667,16352
2,15,3,1,2014,16,13771,2677,16448
2,15,3,1,2014,17,13126,2659,15785
2,15,3,1,2014,18,11961,2614,14575
2,15,3,1,2014,19,12272,2542,14814
2,15,3,1,2014,20,13224,2585,15809
2,15,3,1,2014,21,13074,2504,15578
2,15,3,1,2014,22,12567,2362,14929
2,15,3,1,2014,23,12374,2217,14591
2,15,3,1,2014,24,12352,2126,14478
2,16,3,1,2014,1,12033,1961,13994
2,16,3,1,2014,2,11673,1778,13451
2,16,3,1,2014,3,11683,1719,13402
2,16,3,1,2014,4,11532,1666,13198
2,16,3,1,2014,5,11704,1658,13362
2,16,3,1,2014,6,12400,1755,14155
2,16,3,1,2014,7,12841,1824,14665
2,16,3,1,2014,8,13224,1838,15062
2,16,3,1,2014,9,14002,1898,15900
2,16,3,1,2014,10,14162,1972,16134
2,16,3,1,2014,11,14620,2037,16657
2,16,3,1,2014,12,14860,2141,17001
2,16,3,1,2014,13,14444,2148,16592
2,16,3,1,2014,14,14119,2087,16206
2,16,3,1,2014,15,14331,2083,16414
2,16,3,1,2014,16,14010,2044,16054
2,16,3,1,2014,17,13317,2002,15319
2,16,3,1,2014,18,11893,1973,13866
2,16,3,1,2014,19,12074,1999,14073
2,16,3,1,2014,20,13188,2206,15394
2,16,3,1,2014,21,12733,2236,14969
2,16,3,1,2014,22,12278,2153,14431
2,16,3,1,2014,23,12458,2135,14593
2,16,3,1,2014,24,12443,2000,14443
3,17,3,1,2014,1,12300,1928,14228
3,17,3,1,2014,2,12167,1786,13953
3,17,3,1,2014,3,12128,1696,13824
3,17,3,1,2014,4,11953,1626,13579
3,17,3,1,2014,5,11869,1625,13494
3,17,3,1,2014,6,12439,1672,14111
3,17,3,1,2014,7,12529,1690,14219
3,17,3,1,2014,8,12366,1685,14051
3,17,3,1,2014,9,12558,1745,14303
3,17,3,1,2014,10,12425,1761,14186
3,17,3,1,2014,11,12474,1787,14261
3,17,3,1,2014,12,12805,1814,14619
3,17,3,1,2014,13,12603,1875,14478
3,17,3,1,2014,14,12658,1885,14543
3,17,3,1,2014,15,12709,1863,14572
3,17,3,1,2014,16,12605,1859,14464
3,17,3,1,2014,17,12104,1860,13964
3,17,3,1,2014,18,11174,1856,13030
3,17,3,1,2014,19,11298,1902,13200
3,17,3,1,2014,20,12226,2102,14328
3,17,3,1,2014,21,12408,2150,14558
3,17,3,1,2014,22,11760,2189,13949
3,17,3,1,2014,23,11374,2177,13551
3,17,3,1,2014,24,11401,2155,13556
1,18,3,1,2014,1,11454,1979,13433
1,18,3,1,2014,2,11220,1810,13030
1,18,3,1,2014,3,11440,1721,13161
1,18,3,1,2014,4,11323,1660,12983
1,18,3,1,2014,5,11442,1655,13097
1,18,3,1,2014,6,11943,1736,13679
1,18,3,1,2014,7,12618,1860,14478
1,18,3,1,2014,8,13261,1990,15251
1,18,3,1,2014,9,13773,2272,16045
1,18,3,1,2014,10,14457,2621,17078
1,18,3,1,2014,11,14828,2881,17709
1,18,3,1,2014,12,14951,2963,17914
1,18,3,1,2014,13,15061,2970,18031
1,18,3,1,2014,14,14889,2897,17786
1,18,3,1,2014,15,14869,2929,17798
1,18,3,1,2014,16,15016,2947,17963
1,18,3,1,2014,17,14701,2917,17618
1,18,3,1,2014,18,12985,2813,15798
1,18,3,1,2014,19,12912,2691,15603
1,18,3,1,2014,20,13728,2719,16447
1,18,3,1,2014,21,13502,2565,16067
1,18,3,1,2014,22,12958,2410,15368
1,18,3,1,2014,23,12832,2277,15109
1,18,3,1,2014,24,12838,2153,14991
1,19,3,1,2014,1,13106,1996,15102
1,19,3,1,2014,2,12974,1820,14794
1,19,3,1,2014,3,12739,1723,14462
1,19,3,1,2014,4,12747,1683,14430
1,19,3,1,2014,5,12852,1674,14526
1,19,3,1,2014,6,13220,1760,14980
1,19,3,1,2014,7,14015,1867,15882
1,19,3,1,2014,8,14335,1995,16330
1,19,3,1,2014,9,14808,2256,17064
1,19,3,1,2014,10,15081,2593,17674
1,19,3,1,2014,11,15456,2837,18293
1,19,3,1,2014,12,15789,2883,18672
1,19,3,1,2014,13,15726,2897,18623
1,19,3,1,2014,14,15609,2866,18475
1,19,3,1,2014,15,15278,2892,18170
1,19,3,1,2014,16,15481,2893,18374
1,19,3,1,2014,17,15250,2888,18138
1,19,3,1,2014,18,13481,2827,16308
1,19,3,1,2014,19,13073,2737,15810
1,19,3,1,2014,20,14127,2782,16909
1,19,3,1,2014,21,13775,2612,16387
1,19,3,1,2014,22,13273,2434,15707
1,19,3,1,2014,23,13182,2323,15505
1,19,3,1,2014,24,13291,2225,15516
1,20,3,1,2014,1,13160,2079,15239
1,20,3,1,2014,2,12869,1899,14768
1,20,3,1,2014,3,13055,1787,14842
1,20,3,1,2014,4,12984,1730,14714
1,20,3,1,2014,5,13228,1729,14957
1,20,3,1,2014,6,13598,1802,15400
1,20,3,1,2014,7,14299,1909,16208
1,20,3,1,2014,8,14541,2036,16577
1,20,3,1,2014,9,14943,2314,17257
1,20,3,1,2014,10,15042,2628,17670
1,20,3,1,2014,11,15259,2877,18136
1,20,3,1,2014,12,15645,2945,18590
1,20,3,1,2014,13,15264,2944,18208
1,20,3,1,2014,14,15312,2883,18195
1,20,3,1,2014,15,15366,2927,18293
1,20,3,1,2014,16,15313,2927,18240
1,20,3,1,2014,17,15051,2896,17947
1,20,3,1,2014,18,13055,2767,15822
1,20,3,1,2014,19,12760,2726,15486
1,20,3,1,2014,20,14204,2727,16931
1,20,3,1,2014,21,13722,2613,16335
1,20,3,1,2014,22,13223,2467,15690
1,20,3,1,2014,23,13155,2350,15505
1,20,3,1,2014,24,12979,2238,15217
1,21,3,1,2014,1,13134,2078,15212
1,21,3,1,2014,2,13118,1886,15004
1,21,3,1,2014,3,12668,1767,14435
1,21,3,1,2014,4,12847,1712,14559
1,21,3,1,2014,5,12932,1679,14611
1,21,3,1,2014,6,13483,1763,15246
1,21,3,1,2014,7,14337,1874,16211
1,21,3,1,2014,8,14500,2006,16506
1,21,3,1,2014,9,14739,2276,17015
1,21,3,1,2014,10,15090,2605,17695
1,21,3,1,2014,11,15298,2836,18134
1,21,3,1,2014,12,15386,2903,18289
1,21,3,1,2014,13,15320,2892,18212
1,21,3,1,2014,14,14857,2730,17587
1,21,3,1,2014,15,14526,2773,17299
1,21,3,1,2014,16,14777,2790,17567
1,21,3,1,2014,17,13699,2786,16485
1,21,3,1,2014,18,12537,2732,15269
1,21,3,1,2014,19,12398,2640,15038
1,21,3,1,2014,20,13847,2701,16548
1,21,3,1,2014,21,13442,2588,16030
1,21,3,1,2014,22,12757,2451,15208
1,21,3,1,2014,23,12884,2325,15209
1,21,3,1,2014,24,12983,2165,15148
2,22,3,1,2014,1,12986,2046,15032
2,22,3,1,2014,2,12663,1860,14523
2,22,3,1,2014,3,12792,1748,14540
2,22,3,1,2014,4,12592,1695,14287
2,22,3,1,2014,5,12689,1690,14379
2,22,3,1,2014,6,13114,1747,14861
2,22,3,1,2014,7,13779,1814,15593
2,22,3,1,2014,8,14309,1909,16218
2,22,3,1,2014,9,14731,2123,16854
2,22,3,1,2014,10,14932,2409,17341
2,22,3,1,2014,11,15138,2621,17759
2,22,3,1,2014,12,15385,2654,18039
2,22,3,1,2014,13,15195,2640,17835
2,22,3,1,2014,14,14924,2618,17542
2,22,3,1,2014,15,15078,2555,17633
2,22,3,1,2014,16,15214,2604,17818
2,22,3,1,2014,17,14614,2563,17177
2,22,3,1,2014,18,12919,2428,15347
2,22,3,1,2014,19,12659,2361,15020
2,22,3,1,2014,20,13727,2587,16314
2,22,3,1,2014,21,13332,2540,15872
2,22,3,1,2014,22,12829,2380,15209
2,22,3,1,2014,23,12822,2229,15051
2,22,3,1,2014,24,13166,2138,15304
2,23,3,1,2014,1,13246,1986,15232
2,23,3,1,2014,2,13008,1831,14839
2,23,3,1,2014,3,12784,1738,14522
2,23,3,1,2014,4,12706,1695,14401
2,23,3,1,2014,5,12692,1660,14352
2,23,3,1,2014,6,13364,1707,15071
2,23,3,1,2014,7,14071,1721,15792
2,23,3,1,2014,8,14449,1726,16175
2,23,3,1,2014,9,14771,1839,16610
2,23,3,1,2014,10,15215,1954,17169
2,23,3,1,2014,11,15201,2071,17272
2,23,3,1,2014,12,15698,2116,17814
2,23,3,1,2014,13,15509,2121,17630
2,23,3,1,2014,14,15402,2072,17474
2,23,3,1,2014,15,15487,2046,17533
2,23,3,1,2014,16,15323,2017,17340
2,23,3,1,2014,17,14771,2042,16813
2,23,3,1,2014,18,13104,2009,15113
2,23,3,1,2014,19,12897,2059,14956
2,23,3,1,2014,20,14079,2218,16297
2,23,3,1,2014,21,13659,2284,15943
2,23,3,1,2014,22,13329,2223,15552
2,23,3,1,2014,23,13453,2240,15693
2,23,3,1,2014,24,13119,2167,15286
1,24,3,1,2014,1,13369,1997,15366
1,24,3,1,2014,2,13130,1820,14950
1,24,3,1,2014,3,13562,1714,15276
1,24,3,1,2014,4,13156,1668,14824
1,24,3,1,2014,5,13236,1649,14885
1,24,3,1,2014,6,14146,1733,15879
1,24,3,1,2014,7,14399,1862,16261
1,24,3,1,2014,8,15010,2010,17020
1,24,3,1,2014,9,15282,2293,17575
1,24,3,1,2014,10,15674,2629,18303
1,24,3,1,2014,11,16241,2851,19092
1,24,3,1,2014,12,16461,2895,19356
1,24,3,1,2014,13,16290,2896,19186
1,24,3,1,2014,14,15666,2837,18503
1,24,3,1,2014,15,15882,2867,18749
1,24,3,1,2014,16,15952,2887,18839
1,24,3,1,2014,17,15317,2855,18172
1,24,3,1,2014,18,13483,2787,16270
1,24,3,1,2014,19,13137,2684,15821
1,24,3,1,2014,20,14208,2707,16915
1,24,3,1,2014,21,13937,2571,16508
1,24,3,1,2014,22,13421,2385,15806
1,24,3,1,2014,23,13806,2309,16115
1,24,3,1,2014,24,13639,2211,15850
1,25,3,1,2014,1,13900,2018,15918
1,25,3,1,2014,2,13571,1829,15400
1,25,3,1,2014,3,13380,1733,15113
1,25,3,1,2014,4,13322,1696,15018
1,25,3,1,2014,5,13394,1677,15071
1,25,3,1,2014,6,13661,1799,15460
1,25,3,1,2014,7,14492,1893,16385
1,25,3,1,2014,8,15099,2020,17119
1,25,3,1,2014,9,15189,2306,17495
1,25,3,1,2014,10,15772,2626,18398
1,25,3,1,2014,11,16009,2870,18879
1,25,3,1,2014,12,16271,2921,19192
1,25,3,1,2014,13,16099,2963,19062
1,25,3,1,2014,14,15982,2813,18795
1,25,3,1,2014,15,16017,2812,18829
1,25,3,1,2014,16,16203,2818,19021
1,25,3,1,2014,17,15737,2806,18543
1,25,3,1,2014,18,13731,2760,16491
1,25,3,1,2014,19,13094,2673,15767
1,25,3,1,2014,20,14499,2729,17228
1,25,3,1,2014,21,13997,2709,16706
1,25,3,1,2014,22,13907,2404,16311
1,25,3,1,2014,23,13819,2305,16124
1,25,3,1,2014,24,13674,2275,15949
1,26,3,1,2014,1,14131,2065,16196
1,26,3,1,2014,2,13492,1859,15351
1,26,3,1,2014,3,13934,1741,15675
1,26,3,1,2014,4,13662,1675,15337
1,26,3,1,2014,5,13661,1678,15339
1,26,3,1,2014,6,14658,1766,16424
1,26,3,1,2014,7,14724,1885,16609
1,26,3,1,2014,8,15063,2022,17085
1,26,3,1,2014,9,15220,2307,17527
1,26,3,1,2014,10,15984,2657,18641
1,26,3,1,2014,11,16165,2900,19065
1,26,3,1,2014,12,16435,2980,19415
1,26,3,1,2014,13,16443,2980,19423
1,26,3,1,2014,14,16172,2885,19057
1,26,3,1,2014,15,16096,2937,19033
1,26,3,1,2014,16,16371,2943,19314
1,26,3,1,2014,17,15746,2934,18680
1,26,3,1,2014,18,14170,2876,17046
1,26,3,1,2014,19,13419,2759,16178
1,26,3,1,2014,20,14722,2814,17536
1,26,3,1,2014,21,14466,2700,17166
1,26,3,1,2014,22,13960,2458,16418
1,26,3,1,2014,23,13977,2393,16370
1,26,3,1,2014,24,14107,2301,16408
1,27,3,1,2014,1,13757,2153,15910
1,27,3,1,2014,2,14083,1921,16004
1,27,3,1,2014,3,14084,1804,15888
1,27,3,1,2014,4,13735,1738,15473
1,27,3,1,2014,5,13895,1719,15614
1,27,3,1,2014,6,14533,1785,16318
1,27,3,1,2014,7,15396,1897,17293
1,27,3,1,2014,8,15585,2013,17598
1,27,3,1,2014,9,15596,2329,17925
1,27,3,1,2014,10,16014,2666,18680
1,27,3,1,2014,11,16288,2909,19197
1,27,3,1,2014,12,16512,2988,19500
1,27,3,1,2014,13,16095,2990,19085
1,27,3,1,2014,14,16154,2927,19081
1,27,3,1,2014,15,15949,2958,18907
1,27,3,1,2014,16,16200,2947,19147
1,27,3,1,2014,17,15652,2936,18588
1,27,3,1,2014,18,14028,2862,16890
1,27,3,1,2014,19,13328,2764,16092
1,27,3,1,2014,20,14291,2819,17110
1,27,3,1,2014,21,14308,2645,16953
1,27,3,1,2014,22,13829,2507,16336
1,27,3,1,2014,23,14140,2399,16539
1,27,3,1,2014,24,14170,2291,16461
1,28,3,1,2014,1,14641,2114,16755
1,28,3,1,2014,2,14300,1912,16212
1,28,3,1,2014,3,14239,1799,16038
1,28,3,1,2014,4,14292,1732,16024
1,28,3,1,2014,5,14072,1699,15771
1,28,3,1,2014,6,14547,1807,16354
1,28,3,1,2014,7,15151,1907,17058
1,28,3,1,2014,8,15552,2043,17595
1,28,3,1,2014,9,15492,2328,17820
1,28,3,1,2014,10,15583,2680,18263
1,28,3,1,2014,11,16303,2931,19234
1,28,3,1,2014,12,16263,3008,19271
1,28,3,1,2014,13,16036,3003,19039
1,28,3,1,2014,14,15772,2898,18670
1,28,3,1,2014,15,15612,2933,18545
1,28,3,1,2014,16,15754,2942,18696
1,28,3,1,2014,17,15405,2931,18336
1,28,3,1,2014,18,13461,2849,16310
1,28,3,1,2014,19,13000,2727,15727
1,28,3,1,2014,20,14019,2786,16805
1,28,3,1,2014,21,14074,2545,16619
1,28,3,1,2014,22,13533,2484,16017
1,28,3,1,2014,23,13939,2379,16318
1,28,3,1,2014,24,14125,2286,16411
2,29,3,1,2014,1,14393,2104,16497
2,29,3,1,2014,2,14139,1910,16049
2,29,3,1,2014,3,14036,1785,15821
2,29,3,1,2014,4,14091,1725,15816
2,29,3,1,2014,5,13991,1694,15685
2,29,3,1,2014,6,14564,1763,16327
2,29,3,1,2014,7,15315,1829,17144
2,29,3,1,2014,8,15621,1930,17551
2,29,3,1,2014,9,15646,2168,17814
2,29,3,1,2014,10,16112,2486,18598
2,29,3,1,2014,11,16455,2735,19190
2,29,3,1,2014,12,16300,2815,19115
2,29,3,1,2014,13,16703,2823,19526
2,29,3,1,2014,14,16483,2761,19244
2,29,3,1,2014,15,16634,2784,19418
2,29,3,1,2014,16,16734,2782,19516
2,29,3,1,2014,17,16450,2737,19187
2,29,3,1,2014,18,14312,2673,16985
2,29,3,1,2014,19,13516,2600,16116
2,29,3,1,2014,20,14472,2697,17169
2,29,3,1,2014,21,14222,2628,16850
2,29,3,1,2014,22,13579,2492,16071
2,29,3,1,2014,23,13772,2363,16135
2,29,3,1,2014,24,14116,2274,16390
2,30,3,1,2014,1,14255,2151,16406
2,30,3,1,2014,2,14115,1961,16076
2,30,3,1,2014,3,13865,1841,15706
2,30,3,1,2014,4,14079,1767,15846
2,30,3,1,2014,5,13953,1746,15699
2,30,3,1,2014,6,14322,1768,16090
2,30,3,1,2014,7,14583,1787,16370
2,30,3,1,2014,8,15079,1801,16880
2,30,3,1,2014,9,15024,1887,16911
2,30,3,1,2014,10,15583,2027,17610
2,30,3,1,2014,11,15909,2164,18073
2,30,3,1,2014,12,16473,2197,18670
2,30,3,1,2014,13,16265,2261,18526
2,30,3,1,2014,14,16408,2252,18660
2,30,3,1,2014,15,16072,2250,18322
2,30,3,1,2014,16,16280,2216,18496
2,30,3,1,2014,17,15756,2171,17927
2,30,3,1,2014,18,13996,2110,16106
2,30,3,1,2014,19,13519,2130,15649
2,30,3,1,2014,20,14106,2288,16394
2,30,3,1,2014,21,14236,2295,16531
2,30,3,1,2014,22,13740,2293,16033
2,30,3,1,2014,23,13854,2275,16129
2,30,3,1,2014,24,13989,2260,16249
3,31,3,1,2014,1,14162,2136,16298
3,31,3,1,2014,2,14085,1951,16036
3,31,3,1,2014,3,13947,1836,15783
3,31,3,1,2014,4,13836,1765,15601
3,31,3,1,2014,5,13643,1744,15387
3,31,3,1,2014,6,14199,1799,15998
3,31,3,1,2014,7,14911,1848,16759
3,31,3,1,2014,8,15082,1933,17015
3,31,3,1,2014,9,14705,2134,16839
3,31,3,1,2014,10,15061,2384,17445
3,31,3,1,2014,11,15635,2562,18197
3,31,3,1,2014,12,16167,2592,18759
3,31,3,1,2014,13,16181,2586,18767
3,31,3,1,2014,14,15892,2535,18427
3,31,3,1,2014,15,15642,2559,18201
3,31,3,1,2014,16,16067,2560,18627
3,31,3,1,2014,17,15116,2513,17629
3,31,3,1,2014,18,13134,2478,15612
3,31,3,1,2014,19,12871,2444,15315
3,31,3,1,2014,20,13742,2553,16295
3,31,3,1,2014,21,13441,2482,15923
3,31,3,1,2014,22,13352,2394,15746
3,31,3,1,2014,23,13367,2333,15700
3,31,3,1,2014,24,13320,2265,15585
1,1,4,2,2014,1,13317,2101,15418
1,1,4,2,2014,2,13509,1899,15408
1,1,4,2,2014,3,13404,1785,15189
1,1,4,2,2014,4,13642,1706,15348
1,1,4,2,2014,5,13391,1692,15083
1,1,4,2,2014,6,13972,1758,15730
1,1,4,2,2014,7,14118,1901,16019
1,1,4,2,2014,8,14677,2013,16690
1,1,4,2,2014,9,14921,2260,17181
1,1,4,2,2014,10,15641,2588,18229
1,1,4,2,2014,11,15980,2872,18852
1,1,4,2,2014,12,16322,2934,19256
1,1,4,2,2014,13,16093,2921,19014
1,1,4,2,2014,14,16284,2860,19144
1,1,4,2,2014,15,16263,2882,19145
1,1,4,2,2014,16,16336,2882,19218
1,1,4,2,2014,17,15437,2856,18293
1,1,4,2,2014,18,13805,2773,16578
1,1,4,2,2014,19,13000,2665,15665
1,1,4,2,2014,20,14148,2723,16871
1,1,4,2,2014,21,13850,2612,16462
1,1,4,2,2014,22,13461,2454,15915
1,1,4,2,2014,23,13804,2362,16166
1,1,4,2,2014,24,13792,2268,16060
1,2,4,2,2014,1,14245,2074,16319
1,2,4,2,2014,2,13906,1895,15801
1,2,4,2,2014,3,13703,1795,15498
1,2,4,2,2014,4,13737,1732,15469
1,2,4,2,2014,5,13674,1720,15394
1,2,4,2,2014,6,14104,1812,15916
1,2,4,2,2014,7,14883,1945,16828
1,2,4,2,2014,8,15108,2064,17172
1,2,4,2,2014,9,15466,2337,17803
1,2,4,2,2014,10,15890,2679,18569
1,2,4,2,2014,11,15999,2933,18932
1,2,4,2,2014,12,16162,2984,19146
1,2,4,2,2014,13,15842,2983,18825
1,2,4,2,2014,14,15854,2941,18795
1,2,4,2,2014,15,16031,2973,19004
1,2,4,2,2014,16,16250,2978,19228
1,2,4,2,2014,17,16031,2973,19004
1,2,4,2,2014,18,13978,2881,16859
1,2,4,2,2014,19,13643,2758,16401
1,2,4,2,2014,20,14667,2777,17444
1,2,4,2,2014,21,14386,2572,16958
1,2,4,2,2014,22,14094,2525,16619
1,2,4,2,2014,23,14079,2416,16495
1,2,4,2,2014,24,13932,2327,16259
1,3,4,2,2014,1,14195,2134,16329
1,3,4,2,2014,2,13896,1915,15811
1,3,4,2,2014,3,13841,1804,15645
1,3,4,2,2014,4,13633,1726,15359
1,3,4,2,2014,5,13845,1721,15566
1,3,4,2,2014,6,14247,1820,16067
1,3,4,2,2014,7,14627,1993,16620
1,3,4,2,2014,8,15068,2138,17206
1,3,4,2,2014,9,15199,2387,17586
1,3,4,2,2014,10,15558,2687,18245
1,3,4,2,2014,11,15998,2968,18966
1,3,4,2,2014,12,16281,3007,19288
1,3,4,2,2014,13,16098,3001,19099
1,3,4,2,2014,14,16147,2960,19107
1,3,4,2,2014,15,16149,3003,19152
1,3,4,2,2014,16,16406,3001,19407
1,3,4,2,2014,17,16162,2900,19062
1,3,4,2,2014,18,14221,2932,17153
1,3,4,2,2014,19,13520,2792,16312
1,3,4,2,2014,20,14689,2819,17508
1,3,4,2,2014,21,14427,2714,17141
1,3,4,2,2014,22,14093,2567,16660
1,3,4,2,2014,23,14039,2464,16503
1,3,4,2,2014,24,14108,2371,16479
1,4,4,2,2014,1,14666,2203,16869
1,4,4,2,2014,2,14406,1960,16366
1,4,4,2,2014,3,14308,1853,16161
1,4,4,2,2014,4,14312,1770,16082
1,4,4,2,2014,5,14081,1748,15829
1,4,4,2,2014,6,14584,1815,16399
1,4,4,2,2014,7,15284,1931,17215
1,4,4,2,2014,8,15189,2061,17250
1,4,4,2,2014,9,15321,2347,17668
1,4,4,2,2014,10,15595,2699,18294
1,4,4,2,2014,11,16047,2985,19032
1,4,4,2,2014,12,16128,3043,19171
1,4,4,2,2014,13,15993,3052,19045
1,4,4,2,2014,14,15797,3002,18799
1,4,4,2,2014,15,15707,3046,18753
1,4,4,2,2014,16,16118,3065,19183
1,4,4,2,2014,17,15544,3053,18597
1,4,4,2,2014,18,14004,2982,16986
1,4,4,2,2014,19,13270,2873,16143
1,4,4,2,2014,20,14727,2903,17630
1,4,4,2,2014,21,14378,2798,17176
1,4,4,2,2014,22,13966,2628,16594
1,4,4,2,2014,23,14240,2554,16794
1,4,4,2,2014,24,14354,2491,16845
2,5,4,2,2014,1,14677,2306,16983
2,5,4,2,2014,2,14364,2091,16455
2,5,4,2,2014,3,14299,1959,16258
2,5,4,2,2014,4,13985,1866,15851
2,5,4,2,2014,5,13963,1839,15802
2,5,4,2,2014,6,14368,1890,16258
2,5,4,2,2014,7,15163,1941,17104
2,5,4,2,2014,8,15329,2025,17354
2,5,4,2,2014,9,15412,2269,17681
2,5,4,2,2014,10,15839,2598,18437
2,5,4,2,2014,11,16493,2872,19365
2,5,4,2,2014,12,16650,2916,19566
2,5,4,2,2014,13,16680,2924,19604
2,5,4,2,2014,14,16477,2844,19321
2,5,4,2,2014,15,16391,2865,19256
2,5,4,2,2014,16,16557,2882,19439
2,5,4,2,2014,17,16032,2831,18863
2,5,4,2,2014,18,14232,2732,16964
2,5,4,2,2014,19,13616,2671,16287
2,5,4,2,2014,20,14585,2733,17318
2,5,4,2,2014,21,14749,2671,17420
2,5,4,2,2014,22,14186,2576,16762
2,5,4,2,2014,23,14526,2455,16981
2,5,4,2,2014,24,14499,2422,16921
2,6,4,2,2014,1,15008,2297,17305
2,6,4,2,2014,2,14761,2101,16862
2,6,4,2,2014,3,14518,1966,16484
2,6,4,2,2014,4,14649,1881,16530
2,6,4,2,2014,5,14189,1843,16032
2,6,4,2,2014,6,14827,1871,16698
2,6,4,2,2014,7,15359,1868,17227
2,6,4,2,2014,8,15331,1861,17192
2,6,4,2,2014,9,15467,1946,17413
2,6,4,2,2014,10,16095,2074,18169
2,6,4,2,2014,11,16420,2188,18608
2,6,4,2,2014,12,16702,2250,18952
2,6,4,2,2014,13,16482,2263,18745
2,6,4,2,2014,14,16365,2200,18565
2,6,4,2,2014,15,16358,2191,18549
2,6,4,2,2014,16,16312,2180,18492
2,6,4,2,2014,17,15627,2116,17743
2,6,4,2,2014,18,13516,2108,15624
2,6,4,2,2014,19,13166,2187,15353
2,6,4,2,2014,20,14347,2305,16652
2,6,4,2,2014,21,14254,2311,16565
2,6,4,2,2014,22,13805,2309,16114
2,6,4,2,2014,23,14383,2283,16666
2,6,4,2,2014,24,14588,2245,16833
1,7,4,2,2014,1,14780,2130,16910
1,7,4,2,2014,2,14255,1951,16206
1,7,4,2,2014,3,14250,1864,16114
1,7,4,2,2014,4,13956,1804,15760
1,7,4,2,2014,5,13937,1762,15699
1,7,4,2,2014,6,14405,1804,16209
1,7,4,2,2014,7,15104,1906,17010
1,7,4,2,2014,8,15408,2036,17444
1,7,4,2,2014,9,15574,2321,17895
1,7,4,2,2014,10,16134,2673,18807
1,7,4,2,2014,11,16897,2941,19838
1,7,4,2,2014,12,17063,3020,20083
1,7,4,2,2014,13,17054,3018,20072
1,7,4,2,2014,14,16733,2928,19661
1,7,4,2,2014,15,16733,2961,19694
1,7,4,2,2014,16,16640,2981,19621
1,7,4,2,2014,17,16034,2959,18993
1,7,4,2,2014,18,14520,2876,17396
1,7,4,2,2014,19,14127,2776,16903
1,7,4,2,2014,20,15037,2808,17845
1,7,4,2,2014,21,14775,2709,17484
1,7,4,2,2014,22,14258,2575,16833
1,7,4,2,2014,23,14212,2512,16724
1,7,4,2,2014,24,14424,2448,16872
3,8,4,2,2014,1,15141,2254,17395
3,8,4,2,2014,2,14770,2050,16820
3,8,4,2,2014,3,14489,1939,16428
3,8,4,2,2014,4,14363,1843,16206
3,8,4,2,2014,5,14383,1800,16183
3,8,4,2,2014,6,14936,1876,16812
3,8,4,2,2014,7,15380,1914,17294
3,8,4,2,2014,8,15728,2015,17743
3,8,4,2,2014,9,15983,2278,18261
3,8,4,2,2014,10,16256,2592,18848
3,8,4,2,2014,11,16533,2868,19401
3,8,4,2,2014,12,16855,2911,19766
3,8,4,2,2014,13,16603,2909,19512
3,8,4,2,2014,14,16657,2841,19498
3,8,4,2,2014,15,16719,2866,19585
3,8,4,2,2014,16,16627,2866,19493
3,8,4,2,2014,17,15924,2823,18747
3,8,4,2,2014,18,14256,2757,17013
3,8,4,2,2014,19,13692,2694,16386
3,8,4,2,2014,20,14556,2764,17320
3,8,4,2,2014,21,14667,2639,17306
3,8,4,2,2014,22,14055,2580,16635
3,8,4,2,2014,23,14355,2454,16809
3,8,4,2,2014,24,14375,2408,16783
1,10,4,2,2014,1,14337,2098,16435
1,10,4,2,2014,2,14176,1920,16096
1,10,4,2,2014,3,13886,1836,15722
1,10,4,2,2014,4,13980,1775,15755
1,10,4,2,2014,5,14102,1732,15834
1,10,4,2,2014,6,14250,1775,16025
1,10,4,2,2014,7,14758,1877,16635
1,10,4,2,2014,8,15081,2007,17088
1,10,4,2,2014,9,15128,2293,17421
1,10,4,2,2014,10,15775,2643,18418
1,10,4,2,2014,11,16345,2914,19259
1,10,4,2,2014,12,16710,2992,19702
1,10,4,2,2014,13,16550,2988,19538
1,10,4,2,2014,14,16641,2880,19521
1,10,4,2,2014,15,16161,2901,19062
1,10,4,2,2014,16,16305,2917,19222
1,10,4,2,2014,17,16007,2890,18897
1,10,4,2,2014,18,14752,2814,17566
1,10,4,2,2014,19,13589,2706,16295
1,10,4,2,2014,20,14897,2739,17636
1,10,4,2,2014,21,14707,2649,17356
1,10,4,2,2014,22,14092,2515,16607
1,10,4,2,2014,23,14509,2410,16919
1,10,4,2,2014,24,14547,2324,16871
1,11,4,2,2014,1,14366,2100,16466
1,11,4,2,2014,2,14091,1923,16014
1,11,4,2,2014,3,13704,1836,15540
1,11,4,2,2014,4,13875,1776,15651
1,11,4,2,2014,5,13782,1733,15515
1,11,4,2,2014,6,14158,1775,15933
1,11,4,2,2014,7,14765,1876,16641
1,11,4,2,2014,8,15144,2028,17172
1,11,4,2,2014,9,15231,2288,17519
1,11,4,2,2014,10,15704,2626,18330
1,11,4,2,2014,11,15713,2873,18586
1,11,4,2,2014,12,15672,2989,18661
1,11,4,2,2014,13,15683,2984,18667
1,11,4,2,2014,14,15348,2906,18254
1,11,4,2,2014,15,15276,2940,18216
1,11,4,2,2014,16,15567,2965,18532
1,11,4,2,2014,17,14714,2948,17662
1,11,4,2,2014,18,13467,2867,16334
1,11,4,2,2014,19,13333,2742,16075
1,11,4,2,2014,20,14388,2762,17150
1,11,4,2,2014,21,14110,2625,16735
1,11,4,2,2014,22,13591,2491,16082
1,11,4,2,2014,23,13771,2382,16153
1,11,4,2,2014,24,14182,2295,16477
2,12,4,2,2014,1,14355,2103,16458
2,12,4,2,2014,2,14024,1935,15959
2,12,4,2,2014,3,14000,1807,15807
2,12,4,2,2014,4,13981,1736,15717
2,12,4,2,2014,5,13797,1708,15505
2,12,4,2,2014,6,14076,1765,15841
2,12,4,2,2014,7,14545,1805,16350
2,12,4,2,2014,8,15013,1892,16905
2,12,4,2,2014,9,15199,2109,17308
2,12,4,2,2014,10,15717,2423,18140
2,12,4,2,2014,11,16086,2668,18754
2,12,4,2,2014,12,16609,2703,19312
2,12,4,2,2014,13,16330,2705,19035
2,12,4,2,2014,14,16003,2639,18642
2,12,4,2,2014,15,16128,2645,18773
2,12,4,2,2014,16,16227,2631,18858
2,12,4,2,2014,17,15631,2607,18238
2,12,4,2,2014,18,13741,2551,16292
2,12,4,2,2014,19,13238,2503,15741
2,12,4,2,2014,20,14223,2591,16814
2,12,4,2,2014,21,13903,2514,16417
2,12,4,2,2014,22,13643,2418,16061
2,12,4,2,2014,23,13690,2308,15998
2,12,4,2,2014,24,14047,2205,16252
3,13,4,2,2014,1,14153,2084,16237
3,13,4,2,2014,2,13880,1920,15800
3,13,4,2,2014,3,13818,1820,15638
3,13,4,2,2014,4,13582,1744,15326
3,13,4,2,2014,5,13696,1716,15412
3,13,4,2,2014,6,14150,1756,15906
3,13,4,2,2014,7,14758,1756,16514
3,13,4,2,2014,8,14818,1768,16586
3,13,4,2,2014,9,15027,1847,16874
3,13,4,2,2014,10,15683,1975,17658
3,13,4,2,2014,11,15988,2080,18068
3,13,4,2,2014,12,16608,2131,18739
3,13,4,2,2014,13,16115,2144,18259
3,13,4,2,2014,14,15877,2074,17951
3,13,4,2,2014,15,15510,2060,17570
3,13,4,2,2014,16,15427,2059,17486
3,13,4,2,2014,17,15063,2038,17101
3,13,4,2,2014,18,13295,1974,15269
3,13,4,2,2014,19,12882,1979,14861
3,13,4,2,2014,20,14017,2166,16183
3,13,4,2,2014,21,13586,2222,15808
3,13,4,2,2014,22,13646,2186,15832
3,13,4,2,2014,23,13722,2209,15931
3,13,4,2,2014,24,13857,2156,16013
3,14,4,2,2014,1,14360,2051,16411
3,14,4,2,2014,2,14095,1905,16000
3,14,4,2,2014,3,14087,1805,15892
3,14,4,2,2014,4,14042,1705,15747
3,14,4,2,2014,5,13844,1664,15508
3,14,4,2,2014,6,14234,1720,15954
3,14,4,2,2014,7,14784,1701,16485
3,14,4,2,2014,8,15368,1833,17201
3,14,4,2,2014,9,15627,2110,17737
3,14,4,2,2014,10,15990,2399,18389
3,14,4,2,2014,11,16815,2641,19456
3,14,4,2,2014,12,17220,2674,19894
3,14,4,2,2014,13,17166,2680,19846
3,14,4,2,2014,14,16613,2627,19240
3,14,4,2,2014,15,16642,2649,19291
3,14,4,2,2014,16,16553,2648,19201
3,14,4,2,2014,17,15878,2637,18515
3,14,4,2,2014,18,14127,2604,16731
3,14,4,2,2014,19,13830,2513,16343
3,14,4,2,2014,20,14281,2582,16863
3,14,4,2,2014,21,14267,2504,16771
3,14,4,2,2014,22,14162,2360,16522
3,14,4,2,2014,23,14479,2321,16800
3,14,4,2,2014,24,14580,2193,16773
1,15,4,2,2014,1,14815,2065,16880
1,15,4,2,2014,2,14507,1872,16379
1,15,4,2,2014,3,14210,1773,15983
1,15,4,2,2014,4,14318,1712,16030
1,15,4,2,2014,5,14306,1699,16005
1,15,4,2,2014,6,14965,1767,16732
1,15,4,2,2014,7,15208,1842,17050
1,15,4,2,2014,8,15279,1997,17276
1,15,4,2,2014,9,15588,2282,17870
1,15,4,2,2014,10,16361,2625,18986
1,15,4,2,2014,11,16899,2862,19761
1,15,4,2,2014,12,16936,2933,19869
1,15,4,2,2014,13,16895,2925,19820
1,15,4,2,2014,14,16596,2831,19427
1,15,4,2,2014,15,16618,2862,19480
1,15,4,2,2014,16,16693,2870,19563
1,15,4,2,2014,17,16321,2863,19184
1,15,4,2,2014,18,14276,2789,17065
1,15,4,2,2014,19,13433,2668,16101
1,15,4,2,2014,20,14454,2720,17174
1,15,4,2,2014,21,14530,2604,17134
1,15,4,2,2014,22,14045,2475,16520
1,15,4,2,2014,23,14200,2360,16560
1,15,4,2,2014,24,14361,2302,16663
1,16,4,2,2014,1,14730,2080,16810
1,16,4,2,2014,2,14339,1915,16254
1,16,4,2,2014,3,14138,1823,15961
1,16,4,2,2014,4,14252,1765,16017
1,16,4,2,2014,5,14125,1744,15869
1,16,4,2,2014,6,14532,1796,16328
1,16,4,2,2014,7,14962,1873,16835
1,16,4,2,2014,8,15213,2016,17229
1,16,4,2,2014,9,15460,2294,17754
1,16,4,2,2014,10,15823,2637,18460
1,16,4,2,2014,11,16387,2899,19286
1,16,4,2,2014,12,16623,2987,19610
1,16,4,2,2014,13,16639,2983,19622
1,16,4,2,2014,14,16218,2908,19126
1,16,4,2,2014,15,16217,2924,19141
1,16,4,2,2014,16,16270,2915,19185
1,16,4,2,2014,17,15543,2909,18452
1,16,4,2,2014,18,14140,2869,17009
1,16,4,2,2014,19,13581,2749,16330
1,16,4,2,2014,20,14439,2816,17255
1,16,4,2,2014,21,14585,2652,17237
1,16,4,2,2014,22,14249,2540,16789
1,16,4,2,2014,23,14126,2393,16519
1,16,4,2,2014,24,14535,2344,16879
1,17,4,2,2014,1,14638,2154,16792
1,17,4,2,2014,2,14434,1972,16406
1,17,4,2,2014,3,14348,1847,16195
1,17,4,2,2014,4,14296,1778,16074
1,17,4,2,2014,5,14274,1756,16030
1,17,4,2,2014,6,14701,1832,16533
1,17,4,2,2014,7,15125,1911,17036
1,17,4,2,2014,8,15143,2049,17192
1,17,4,2,2014,9,15160,2343,17503
1,17,4,2,2014,10,15345,2670,18015
1,17,4,2,2014,11,15755,2936,18691
1,17,4,2,2014,12,16254,2973,19227
1,17,4,2,2014,13,15975,2967,18942
1,17,4,2,2014,14,15729,2905,18634
1,17,4,2,2014,15,15545,2929,18474
1,17,4,2,2014,16,15370,2932,18302
1,17,4,2,2014,17,14632,2919,17551
1,17,4,2,2014,18,13419,2849,16268
1,17,4,2,2014,19,13095,2740,15835
1,17,4,2,2014,20,14007,2769,16776
1,17,4,2,2014,21,14035,2675,16710
1,17,4,2,2014,22,13825,2464,16289
1,17,4,2,2014,23,13602,2400,16002
1,17,4,2,2014,24,13830,2322,16152
3,18,4,2,2014,1,14185,2147,16332
3,18,4,2,2014,2,13862,1958,15820
3,18,4,2,2014,3,13813,1830,15643
3,18,4,2,2014,4,13543,1749,15292
3,18,4,2,2014,5,13945,1736,15681
3,18,4,2,2014,6,14325,1797,16122
3,18,4,2,2014,7,14518,1831,16349
3,18,4,2,2014,8,14919,1935,16854
3,18,4,2,2014,9,15124,2156,17280
3,18,4,2,2014,10,15443,2457,17900
3,18,4,2,2014,11,15564,2706,18270
3,18,4,2,2014,12,15887,2768,18655
3,18,4,2,2014,13,15849,2763,18612
3,18,4,2,2014,14,15771,2651,18422
3,18,4,2,2014,15,15697,2675,18372
3,18,4,2,2014,16,15515,2686,18201
3,18,4,2,2014,17,15269,2667,17936
3,18,4,2,2014,18,13918,2641,16559
3,18,4,2,2014,19,13423,2561,15984
3,18,4,2,2014,20,14245,2657,16902
3,18,4,2,2014,21,14220,2574,16794
3,18,4,2,2014,22,13646,2448,16094
3,18,4,2,2014,23,13711,2363,16074
3,18,4,2,2014,24,13992,2303,16295
2,19,4,2,2014,1,14106,2166,16272
2,19,4,2,2014,2,13941,1973,15914
2,19,4,2,2014,3,13805,1848,15653
2,19,4,2,2014,4,13801,1787,15588
2,19,4,2,2014,5,13992,1774,15766
2,19,4,2,2014,6,14491,1820,16311
2,19,4,2,2014,7,14642,1845,16487
2,19,4,2,2014,8,15142,1929,17071
2,19,4,2,2014,9,15414,2168,17582
2,19,4,2,2014,10,15643,2494,18137
2,19,4,2,2014,11,16702,2766,19468
2,19,4,2,2014,12,16681,2836,19517
2,19,4,2,2014,13,16679,2835,19514
2,19,4,2,2014,14,15827,2715,18542
2,19,4,2,2014,15,15946,2728,18674
2,19,4,2,2014,16,15864,2722,18586
2,19,4,2,2014,17,15078,2703,17781
2,19,4,2,2014,18,13243,2649,15892
2,19,4,2,2014,19,12872,2580,15452
2,19,4,2,2014,20,13899,2680,16579
2,19,4,2,2014,21,13304,2587,15891
2,19,4,2,2014,22,13496,2470,15966
2,19,4,2,2014,23,13691,2377,16068
2,19,4,2,2014,24,13531,2326,15857
2,20,4,2,2014,1,13680,2202,15882
2,20,4,2,2014,2,13327,2033,15360
2,20,4,2,2014,3,13041,1907,14948
2,20,4,2,2014,4,12963,1818,14781
2,20,4,2,2014,5,12940,1788,14728
2,20,4,2,2014,6,13458,1821,15279
2,20,4,2,2014,7,13785,1804,15589
2,20,4,2,2014,8,13700,1794,15494
2,20,4,2,2014,9,13991,1893,15884
2,20,4,2,2014,10,14712,2035,16747
2,20,4,2,2014,11,15162,2167,17329
2,20,4,2,2014,12,15505,2224,17729
2,20,4,2,2014,13,15474,2231,17705
2,20,4,2,2014,14,15474,2197,17671
2,20,4,2,2014,15,15351,2195,17546
2,20,4,2,2014,16,15683,2167,17850
2,20,4,2,2014,17,15129,2132,17261
2,20,4,2,2014,18,13507,2095,15602
2,20,4,2,2014,19,12586,2100,14686
2,20,4,2,2014,20,13914,2289,16203
2,20,4,2,2014,21,13779,2372,16151
2,20,4,2,2014,22,13552,2379,15931
2,20,4,2,2014,23,13635,2380,16015
2,20,4,2,2014,24,13760,2387,16147
1,21,4,2,2014,1,13735,2273,16008
1,21,4,2,2014,2,13368,2075,15443
1,21,4,2,2014,3,13126,1941,15067
1,21,4,2,2014,4,13132,1847,14979
1,21,4,2,2014,5,13121,1815,14936
1,21,4,2,2014,6,13685,1880,15565
1,21,4,2,2014,7,13983,1926,15909
1,21,4,2,2014,8,14256,2060,16316
1,21,4,2,2014,9,14381,2350,16731
1,21,4,2,2014,10,15192,2717,17909
1,21,4,2,2014,11,16074,2999,19073
1,21,4,2,2014,12,16125,3094,19219
1,21,4,2,2014,13,16140,3122,19262
1,21,4,2,2014,14,15830,3065,18895
1,21,4,2,2014,15,15965,3129,19094
1,21,4,2,2014,16,16489,3134,19623
1,21,4,2,2014,17,16358,3132,19490
1,21,4,2,2014,18,14123,3035,17158
1,21,4,2,2014,19,13445,2862,16307
1,21,4,2,2014,20,13933,2902,16835
1,21,4,2,2014,21,13934,2812,16746
1,21,4,2,2014,22,13976,2691,16667
1,21,4,2,2014,23,13574,2627,16201
1,21,4,2,2014,24,14021,2552,16573
1,22,4,2,2014,1,14284,2433,16717
1,22,4,2,2014,2,13237,2223,15460
1,22,4,2,2014,3,14068,2085,16153
1,22,4,2,2014,4,13515,1976,15491
1,22,4,2,2014,5,12953,1923,14876
1,22,4,2,2014,6,13317,1949,15266
1,22,4,2,2014,7,14487,1977,16464
1,22,4,2,2014,8,14390,2114,16504
1,22,4,2,2014,9,14417,2405,16822
1,22,4,2,2014,10,15189,2775,17964
1,22,4,2,2014,11,15557,3067,18624
1,22,4,2,2014,12,15923,3173,19096
1,22,4,2,2014,13,15888,3183,19071
1,22,4,2,2014,14,15682,3143,18825
1,22,4,2,2014,15,16041,3180,19221
1,22,4,2,2014,16,16125,3180,19305
1,22,4,2,2014,17,15536,3159,18695
1,22,4,2,2014,18,14091,3039,17130
1,22,4,2,2014,19,13537,2890,16427
1,22,4,2,2014,20,14679,2912,17591
1,22,4,2,2014,21,14648,2777,17425
1,22,4,2,2014,22,14071,2631,16702
1,22,4,2,2014,23,14291,2593,16884
1,22,4,2,2014,24,14548,2569,17117
1,23,4,2,2014,1,15076,2433,17509
1,23,4,2,2014,2,14498,2224,16722
1,23,4,2,2014,3,14041,2090,16131
1,23,4,2,2014,4,14285,1989,16274
1,23,4,2,2014,5,14101,1942,16043
1,23,4,2,2014,6,14307,1982,16289
1,23,4,2,2014,7,14711,1985,16696
1,23,4,2,2014,8,14749,2103,16852
1,23,4,2,2014,9,15031,2376,17407
1,23,4,2,2014,10,15675,2736,18411
1,23,4,2,2014,11,15858,3030,18888
1,23,4,2,2014,12,16207,3162,19369
1,23,4,2,2014,13,16238,3188,19426
1,23,4,2,2014,14,15944,3227,19171
1,23,4,2,2014,15,16408,3227,19635
1,23,4,2,2014,16,16579,3236,19815
1,23,4,2,2014,17,15903,3219,19122
1,23,4,2,2014,18,14723,3138,17861
1,23,4,2,2014,19,13788,2970,16758
1,23,4,2,2014,20,14802,2980,17782
1,23,4,2,2014,21,14711,2870,17581
1,23,4,2,2014,22,14336,2722,17058
1,23,4,2,2014,23,14296,2651,16947
1,23,4,2,2014,24,14595,2647,17242
1,24,4,2,2014,1,14719,2508,17227
1,24,4,2,2014,2,14513,2354,16867
1,24,4,2,2014,3,14351,2204,16555
1,24,4,2,2014,4,14130,2077,16207
1,24,4,2,2014,5,13889,2011,15900
1,24,4,2,2014,6,14609,2030,16639
1,24,4,2,2014,7,14759,1977,16736
1,24,4,2,2014,8,14669,1979,16648
1,24,4,2,2014,9,14881,2067,16948
1,24,4,2,2014,10,15181,2201,17382
1,24,4,2,2014,11,15481,2338,17819
1,24,4,2,2014,12,15837,2441,18278
1,24,4,2,2014,13,15581,2514,18095
1,24,4,2,2014,14,15354,2480,17834
1,24,4,2,2014,15,15684,2518,18202
1,24,4,2,2014,16,15835,2515,18350
1,24,4,2,2014,17,14931,2500,17431
1,24,4,2,2014,18,13319,2443,15762
1,24,4,2,2014,19,12889,2451,15340
1,24,4,2,2014,20,14116,2520,16636
1,24,4,2,2014,21,14024,2709,16733
1,24,4,2,2014,22,13660,2759,16419
1,24,4,2,2014,23,13648,2754,16402
1,24,4,2,2014,24,14280,2769,17049
1,25,4,2,2014,1,14713,2515,17228
1,25,4,2,2014,2,14693,2287,16980
1,25,4,2,2014,3,14434,2144,16578
1,25,4,2,2014,4,14305,2037,16342
1,25,4,2,2014,5,14249,1984,16233
1,25,4,2,2014,6,14562,2005,16567
1,25,4,2,2014,7,14896,2038,16934
1,25,4,2,2014,8,14956,2136,17092
1,25,4,2,2014,9,15199,2439,17638
1,25,4,2,2014,10,15790,2845,18635
1,25,4,2,2014,11,16259,3146,19405
1,25,4,2,2014,12,16195,3233,19428
1,25,4,2,2014,13,16292,3235,19527
1,25,4,2,2014,14,15960,3180,19140
1,25,4,2,2014,15,16291,3228,19519
1,25,4,2,2014,16,16521,3231,19752
1,25,4,2,2014,17,15831,3220,19051
1,25,4,2,2014,18,14374,3111,17485
1,25,4,2,2014,19,13338,2930,16268
1,25,4,2,2014,20,14810,2949,17759
1,25,4,2,2014,21,14746,2833,17579
1,25,4,2,2014,22,14424,2726,17150
1,25,4,2,2014,23,14566,2673,17239
1,25,4,2,2014,24,14966,2649,17615
2,26,4,2,2014,1,15464,2498,17962
2,26,4,2,2014,2,15071,2283,17354
2,26,4,2,2014,3,14736,2130,16866
2,26,4,2,2014,4,14719,2061,16780
2,26,4,2,2014,5,14645,1985,16630
2,26,4,2,2014,6,14778,2000,16778
2,26,4,2,2014,7,15054,1974,17028
2,26,4,2,2014,8,15221,2038,17259
2,26,4,2,2014,9,15545,2235,17780
2,26,4,2,2014,10,16050,2567,18617
2,26,4,2,2014,11,16268,2858,19126
2,26,4,2,2014,12,16724,2970,19694
2,26,4,2,2014,13,16641,2976,19617
2,26,4,2,2014,14,16331,2956,19287
2,26,4,2,2014,15,16393,2973,19366
2,26,4,2,2014,16,16532,2973,19505
2,26,4,2,2014,17,16104,2945,19049
2,26,4,2,2014,18,14742,2807,17549
2,26,4,2,2014,19,13666,2695,16361
2,26,4,2,2014,20,15092,2776,17868
2,26,4,2,2014,21,14955,2680,17635
2,26,4,2,2014,22,14512,2701,17213
2,26,4,2,2014,23,14671,2538,17209
2,26,4,2,2014,24,14805,2543,17348
1,28,4,2,2014,1,15182,2465,17647
1,28,4,2,2014,2,15014,2222,17236
1,28,4,2,2014,3,14652,2082,16734
1,28,4,2,2014,4,14823,1944,16767
1,28,4,2,2014,5,14387,1939,16326
1,28,4,2,2014,6,14989,1978,16967
1,28,4,2,2014,7,15279,1987,17266
1,28,4,2,2014,8,15374,2103,17477
1,28,4,2,2014,9,15879,2422,18301
1,28,4,2,2014,10,16373,2805,19178
1,28,4,2,2014,11,17036,3114,20150
1,28,4,2,2014,12,17327,3207,20534
1,28,4,2,2014,13,16911,3208,20119
1,28,4,2,2014,14,17175,3188,20363
1,28,4,2,2014,15,16956,3196,20152
1,28,4,2,2014,16,16909,3205,20114
1,28,4,2,2014,17,16360,3189,19549
1,28,4,2,2014,18,15128,3116,18244
1,28,4,2,2014,19,14080,2941,17021
1,28,4,2,2014,20,14968,2968,17936
1,28,4,2,2014,21,14853,2861,17714
1,28,4,2,2014,22,14275,2795,17070
1,28,4,2,2014,23,14550,2689,17239
1,28,4,2,2014,24,14790,2676,17466
1,29,4,2,2014,1,14964,2543,17507
1,29,4,2,2014,2,14743,2248,16991
1,29,4,2,2014,3,14564,2114,16678
1,29,4,2,2014,4,14261,2013,16274
1,29,4,2,2014,5,14671,1968,16639
1,29,4,2,2014,6,14691,2000,16691
1,29,4,2,2014,7,15096,2004,17100
1,29,4,2,2014,8,15194,2136,17330
1,29,4,2,2014,9,15559,2439,17998
1,29,4,2,2014,10,16351,2860,19211
1,29,4,2,2014,11,16582,3160,19742
1,29,4,2,2014,12,16862,3274,20136
1,29,4,2,2014,13,16731,3273,20004
1,29,4,2,2014,14,16867,3157,20024
1,29,4,2,2014,15,16729,3193,19922
1,29,4,2,2014,16,16757,3219,19976
1,29,4,2,2014,17,15777,3186,18963
1,29,4,2,2014,18,14685,3086,17771
1,29,4,2,2014,19,14251,2928,17179
1,29,4,2,2014,20,15108,2943,18051
1,29,4,2,2014,21,14989,2892,17881
1,29,4,2,2014,22,14667,2794,17461
1,29,4,2,2014,23,14653,2704,17357
1,29,4,2,2014,24,14824,2671,17495
1,30,4,2,2014,1,15795,2540,18335
1,30,4,2,2014,2,14444,2307,16751
1,30,4,2,2014,3,14466,2142,16608
1,30,4,2,2014,4,14611,2040,16651
1,30,4,2,2014,5,14849,1990,16839
1,30,4,2,2014,6,14521,2017,16538
1,30,4,2,2014,7,15165,2033,17198
1,30,4,2,2014,8,15116,2138,17254
1,30,4,2,2014,9,15176,2445,17621
1,30,4,2,2014,10,15903,2815,18718
1,30,4,2,2014,11,16589,3094,19683
1,30,4,2,2014,12,16503,3193,19696
1,30,4,2,2014,13,16458,3205,19663
1,30,4,2,2014,14,16392,3109,19501
1,30,4,2,2014,15,16517,3148,19665
1,30,4,2,2014,16,16457,3174,19631
1,30,4,2,2014,17,15733,3148,18881
1,30,4,2,2014,18,13890,3038,16928
1,30,4,2,2014,19,13712,2876,16588
1,30,4,2,2014,20,14564,2888,17452
1,30,4,2,2014,21,14466,2866,17332
1,30,4,2,2014,22,13476,2708,16184
1,30,4,2,2014,23,14452,2666,17118
1,30,4,2,2014,24,14602,2651,17253
3,1,5,2,2014,1,15094,2454,17548
3,1,5,2,2014,2,14711,2276,16987
3,1,5,2,2014,3,14394,2131,16525
3,1,5,2,2014,4,14341,2032,16373
3,1,5,2,2014,5,14307,1969,16276
3,1,5,2,2014,6,14708,1980,16688
3,1,5,2,2014,7,14206,1920,16126
3,1,5,2,2014,8,14146,1910,16056
3,1,5,2,2014,9,13910,1972,15882
3,1,5,2,2014,10,13868,2105,15973
3,1,5,2,2014,11,13620,2265,15885
3,1,5,2,2014,12,14361,2366,16727
3,1,5,2,2014,13,14119,2403,16522
3,1,5,2,2014,14,13983,2389,16372
3,1,5,2,2014,15,13834,2412,16246
3,1,5,2,2014,16,14217,2418,16635
3,1,5,2,2014,17,13678,2396,16074
3,1,5,2,2014,18,12237,2315,14552
3,1,5,2,2014,19,12066,2319,14385
3,1,5,2,2014,20,13284,2441,15725
3,1,5,2,2014,21,13426,2470,15896
3,1,5,2,2014,22,13232,2460,15692
3,1,5,2,2014,23,13447,2464,15911
3,1,5,2,2014,24,13830,2460,16290
1,2,5,2,2014,1,13930,2389,16319
1,2,5,2,2014,2,13630,2207,15837
1,2,5,2,2014,3,13755,2063,15818
1,2,5,2,2014,4,14057,1962,16019
1,2,5,2,2014,5,13906,1913,15819
1,2,5,2,2014,6,14260,1937,16197
1,2,5,2,2014,7,14363,1966,16329
1,2,5,2,2014,8,14256,2071,16327
1,2,5,2,2014,9,14626,2379,17005
1,2,5,2,2014,10,14965,2769,17734
1,2,5,2,2014,11,15662,3066,18728
1,2,5,2,2014,12,15681,3148,18829
1,2,5,2,2014,13,15430,3145,18575
1,2,5,2,2014,14,15387,3067,18454
1,2,5,2,2014,15,15409,3119,18528
1,2,5,2,2014,16,15619,3146,18765
1,2,5,2,2014,17,15417,3108,18525
1,2,5,2,2014,18,13805,3024,16829
1,2,5,2,2014,19,12824,2868,15692
1,2,5,2,2014,20,14131,2910,17041
1,2,5,2,2014,21,13438,2791,16229
1,2,5,2,2014,22,14076,2650,16726
1,2,5,2,2014,23,14127,2586,16713
1,2,5,2,2014,24,14403,2606,17009
2,3,5,2,2014,1,14463,2581,17044
2,3,5,2,2014,2,14411,2350,16761
2,3,5,2,2014,3,14532,2079,16611
2,3,5,2,2014,4,14318,1862,16180
2,3,5,2,2014,5,14316,1849,16165
2,3,5,2,2014,6,14487,1892,16379
2,3,5,2,2014,7,14606,1915,16521
2,3,5,2,2014,8,14884,2039,16923
2,3,5,2,2014,9,14929,2210,17139
2,3,5,2,2014,10,15577,2643,18220
2,3,5,2,2014,11,16263,2758,19021
2,3,5,2,2014,12,16532,2890,19422
2,3,5,2,2014,13,16511,2945,19456
2,3,5,2,2014,14,16321,2866,19187
2,3,5,2,2014,15,16236,2853,19089
2,3,5,2,2014,16,16398,2829,19227
2,3,5,2,2014,17,15708,2800,18508
2,3,5,2,2014,18,13716,2713,16429
2,3,5,2,2014,19,13059,2615,15674
2,3,5,2,2014,20,13521,2700,16221
2,3,5,2,2014,21,13761,2646,16407
2,3,5,2,2014,22,13566,2558,16124
2,3,5,2,2014,23,13544,2481,16025
2,3,5,2,2014,24,13541,2493,16034
2,4,5,2,2014,1,13840,2343,16183
2,4,5,2,2014,2,13730,2215,15945
2,4,5,2,2014,3,13744,2077,15821
2,4,5,2,2014,4,13550,1969,15519
2,4,5,2,2014,5,13354,1924,15278
2,4,5,2,2014,6,13740,1924,15664
2,4,5,2,2014,7,14020,1878,15898
2,4,5,2,2014,8,14330,1852,16182
2,4,5,2,2014,9,14436,1914,16350
2,4,5,2,2014,10,14541,2042,16583
2,4,5,2,2014,11,15392,2146,17538
2,4,5,2,2014,12,15835,2216,18051
2,4,5,2,2014,13,15785,2243,18028
2,4,5,2,2014,14,15654,2244,17898
2,4,5,2,2014,15,15494,2253,17747
2,4,5,2,2014,16,15912,2244,18156
2,4,5,2,2014,17,15504,2201,17705
2,4,5,2,2014,18,13692,2122,15814
2,4,5,2,2014,19,13186,2098,15284
2,4,5,2,2014,20,13862,2279,16141
2,4,5,2,2014,21,14456,2394,16850
2,4,5,2,2014,22,14023,2414,16437
2,4,5,2,2014,23,14201,2437,16638
2,4,5,2,2014,24,14519,2462,16981
1,5,5,2,2014,1,15035,2381,17416
1,5,5,2,2014,2,14765,2174,16939
1,5,5,2,2014,3,14293,2041,16334
1,5,5,2,2014,4,14539,1952,16491
1,5,5,2,2014,5,14583,1910,16493
1,5,5,2,2014,6,14411,1931,16342
1,5,5,2,2014,7,14830,1942,16772
1,5,5,2,2014,8,14779,2076,16855
1,5,5,2,2014,9,14864,2366,17230
1,5,5,2,2014,10,15921,2750,18671
1,5,5,2,2014,11,15976,3035,19011
1,5,5,2,2014,12,16897,3118,20015
1,5,5,2,2014,13,16705,3118,19823
1,5,5,2,2014,14,16495,3088,19583
1,5,5,2,2014,15,16406,3114,19520
1,5,5,2,2014,16,16130,3115,19245
1,5,5,2,2014,17,15525,3094,18619
1,5,5,2,2014,18,14031,2995,17026
1,5,5,2,2014,19,13200,2865,16065
1,5,5,2,2014,20,14308,2845,17153
1,5,5,2,2014,21,14537,2777,17314
1,5,5,2,2014,22,14697,2673,17370
1,5,5,2,2014,23,14799,2656,17455
1,5,5,2,2014,24,14912,2615,17527
1,6,5,2,2014,1,15381,2459,17840
1,6,5,2,2014,2,15241,2259,17500
1,6,5,2,2014,3,14772,2093,16865
1,6,5,2,2014,4,14243,1998,16241
1,6,5,2,2014,5,14210,1962,16172
1,6,5,2,2014,6,14888,1982,16870
1,6,5,2,2014,7,15153,1978,17131
1,6,5,2,2014,8,15165,2092,17257
1,6,5,2,2014,9,15466,2395,17861
1,6,5,2,2014,10,16233,2778,19011
1,6,5,2,2014,11,16490,3089,19579
1,6,5,2,2014,12,16612,3213,19825
1,6,5,2,2014,13,16550,3215,19765
1,6,5,2,2014,14,16463,3163,19626
1,6,5,2,2014,15,16371,3204,19575
1,6,5,2,2014,16,16270,3213,19483
1,6,5,2,2014,17,15675,3207,18882
1,6,5,2,2014,18,14128,3120,17248
1,6,5,2,2014,19,13612,2947,16559
1,6,5,2,2014,20,14470,2964,17434
1,6,5,2,2014,21,14718,2915,17633
1,6,5,2,2014,22,14780,2789,17569
1,6,5,2,2014,23,14788,2763,17551
1,6,5,2,2014,24,15230,2709,17939
1,7,5,2,2014,1,15091,2605,17696
1,7,5,2,2014,2,15220,2362,17582
1,7,5,2,2014,3,14786,2208,16994
1,7,5,2,2014,4,14849,2097,16946
1,7,5,2,2014,5,14566,2027,16593
1,7,5,2,2014,6,14905,2043,16948
1,7,5,2,2014,7,15030,2030,17060
1,7,5,2,2014,8,15477,2137,17614
1,7,5,2,2014,9,15593,2473,18066
1,7,5,2,2014,10,16290,2857,19147
1,7,5,2,2014,11,15788,3196,18984
1,7,5,2,2014,12,16597,3320,19917
1,7,5,2,2014,13,16794,3330,20124
1,7,5,2,2014,14,16502,3264,19766
1,7,5,2,2014,15,16559,3320,19879
1,7,5,2,2014,16,16192,3318,19510
1,7,5,2,2014,17,14942,3256,18198
1,7,5,2,2014,18,13479,3034,16513
1,7,5,2,2014,19,13343,2864,16207
1,7,5,2,2014,20,14112,2833,16945
1,7,5,2,2014,21,14145,2714,16859
1,7,5,2,2014,22,13855,2586,16441
1,7,5,2,2014,23,14124,2582,16706
1,7,5,2,2014,24,13871,2567,16438
1,8,5,2,2014,1,13937,2453,16390
1,8,5,2,2014,2,14023,2269,16292
1,8,5,2,2014,3,14045,2120,16165
1,8,5,2,2014,4,13822,2028,15850
1,8,5,2,2014,5,13633,1987,15620
1,8,5,2,2014,6,14024,2033,16057
1,8,5,2,2014,7,14074,2008,16082
1,8,5,2,2014,8,14632,2126,16758
1,8,5,2,2014,9,14726,2433,17159
1,8,5,2,2014,10,15041,2810,17851
1,8,5,2,2014,11,15437,3101,18538
1,8,5,2,2014,12,15684,3205,18889
1,8,5,2,2014,13,15494,3213,18707
1,8,5,2,2014,14,15331,3191,18522
1,8,5,2,2014,15,15588,3163,18751
1,8,5,2,2014,16,15628,3178,18806
1,8,5,2,2014,17,15084,3161,18245
1,8,5,2,2014,18,13958,3108,17066
1,8,5,2,2014,19,13691,2986,16677
1,8,5,2,2014,20,14718,2936,17654
1,8,5,2,2014,21,14513,2878,17391
1,8,5,2,2014,22,14484,2823,17307
1,8,5,2,2014,23,14560,2719,17279
1,8,5,2,2014,24,14182,2729,16911
1,9,5,2,2014,1,14426,2588,17014
1,9,5,2,2014,2,14274,2361,16635
1,9,5,2,2014,3,13976,2217,16193
1,9,5,2,2014,4,13835,2114,15949
1,9,5,2,2014,5,13607,2057,15664
1,9,5,2,2014,6,13886,2073,15959
1,9,5,2,2014,7,14530,2057,16587
1,9,5,2,2014,8,14416,2153,16569
1,9,5,2,2014,9,14226,2448,16674
1,9,5,2,2014,10,14856,2824,17680
1,9,5,2,2014,11,14761,3124,17885
1,9,5,2,2014,12,14969,3218,18187
1,9,5,2,2014,13,14820,3249,18069
1,9,5,2,2014,14,14964,3175,18139
1,9,5,2,2014,15,14787,3246,18033
1,9,5,2,2014,16,14945,3252,18197
1,9,5,2,2014,17,14528,3240,17768
1,9,5,2,2014,18,13346,3082,16428
1,9,5,2,2014,19,13234,2928,16162
1,9,5,2,2014,20,14544,2925,17469
1,9,5,2,2014,21,14231,2773,17004
1,9,5,2,2014,22,14015,2751,16766
1,9,5,2,2014,23,14385,2653,17038
1,9,5,2,2014,24,14332,2580,16912
2,10,5,2,2014,1,14872,2458,17330
2,10,5,2,2014,2,14517,2332,16849
2,10,5,2,2014,3,14405,2209,16614
2,10,5,2,2014,4,14010,2121,16131
2,10,5,2,2014,5,13757,2003,15760
2,10,5,2,2014,6,13958,2017,15975
2,10,5,2,2014,7,14046,1962,16008
2,10,5,2,2014,8,14469,1987,16456
2,10,5,2,2014,9,14418,2225,16643
2,10,5,2,2014,10,14881,2484,17365
2,10,5,2,2014,11,15223,2754,17977
2,10,5,2,2014,12,15222,2846,18068
2,10,5,2,2014,13,15026,2864,17890
2,10,5,2,2014,14,14932,2795,17727
2,10,5,2,2014,15,15004,2828,17832
2,10,5,2,2014,16,15175,2841,18016
2,10,5,2,2014,17,14861,2811,17672
2,10,5,2,2014,18,13553,2673,16226
2,10,5,2,2014,19,13047,2583,15630
2,10,5,2,2014,20,14436,2660,17096
2,10,5,2,2014,21,14363,2638,17001
2,10,5,2,2014,22,14269,2520,16789
2,10,5,2,2014,23,14175,2483,16658
2,10,5,2,2014,24,14388,2447,16835
2,11,5,2,2014,1,14936,2381,17317
2,11,5,2,2014,2,14317,2222,16539
2,11,5,2,2014,3,14224,2085,16309
2,11,5,2,2014,4,14188,1989,16177
2,11,5,2,2014,5,13868,1935,15803
2,11,5,2,2014,6,14365,1923,16288
2,11,5,2,2014,7,14297,1893,16190
2,11,5,2,2014,8,14225,1883,16108
2,11,5,2,2014,9,14170,1926,16096
2,11,5,2,2014,10,14813,2021,16834
2,11,5,2,2014,11,14979,2133,17112
2,11,5,2,2014,12,15334,2176,17510
2,11,5,2,2014,13,14927,2171,17098
2,11,5,2,2014,14,15003,2071,17074
2,11,5,2,2014,15,15097,2185,17282
2,11,5,2,2014,16,15159,2227,17386
2,11,5,2,2014,17,14682,2192,16874
2,11,5,2,2014,18,13409,2143,15552
2,11,5,2,2014,19,12973,2107,15080
2,11,5,2,2014,20,13918,2237,16155
2,11,5,2,2014,21,13818,2321,16139
2,11,5,2,2014,22,13816,2343,16159
2,11,5,2,2014,23,13968,2398,16366
2,11,5,2,2014,24,14324,2433,16757
1,12,5,2,2014,1,14410,2368,16778
1,12,5,2,2014,2,14408,2188,16596
1,12,5,2,2014,3,14012,2047,16059
1,12,5,2,2014,4,14132,1962,16094
1,12,5,2,2014,5,13959,1907,15866
1,12,5,2,2014,6,13775,1931,15706
1,12,5,2,2014,7,14983,1926,16909
1,12,5,2,2014,8,14550,2058,16608
1,12,5,2,2014,9,14426,2356,16782
1,12,5,2,2014,10,15886,2717,18603
1,12,5,2,2014,11,15870,3003,18873
1,12,5,2,2014,12,16091,3073,19164
1,12,5,2,2014,13,16022,3086,19108
1,12,5,2,2014,14,15084,3041,18125
1,12,5,2,2014,15,15961,3075,19036
1,12,5,2,2014,16,15576,3082,18658
1,12,5,2,2014,17,15694,3072,18766
1,12,5,2,2014,18,14202,2945,17147
1,12,5,2,2014,19,13470,2767,16237
1,12,5,2,2014,20,14144,2744,16888
1,12,5,2,2014,21,14785,2659,17444
1,12,5,2,2014,22,13757,2540,16297
1,12,5,2,2014,23,14717,2510,17227
1,12,5,2,2014,24,14790,2498,17288
3,14,5,2,2014,1,14666,2430,17096
3,14,5,2,2014,2,14564,2205,16769
3,14,5,2,2014,3,14821,2073,16894
3,14,5,2,2014,4,14360,1984,16344
3,14,5,2,2014,5,14303,1936,16239
3,14,5,2,2014,6,14640,1960,16600
3,14,5,2,2014,7,14736,1939,16675
3,14,5,2,2014,8,14787,2018,16805
3,14,5,2,2014,9,14934,2265,17199
3,14,5,2,2014,10,15949,2581,18530
3,14,5,2,2014,11,15882,2809,18691
3,14,5,2,2014,12,16259,2900,19159
3,14,5,2,2014,13,16208,2904,19112
3,14,5,2,2014,14,15931,2841,18772
3,14,5,2,2014,15,15868,2901,18769
3,14,5,2,2014,16,16063,2901,18964
3,14,5,2,2014,17,15095,2904,17999
3,14,5,2,2014,18,13946,2873,16819
3,14,5,2,2014,19,13246,2688,15934
3,14,5,2,2014,20,14279,2766,17045
3,14,5,2,2014,21,14028,2601,16629
3,14,5,2,2014,22,14006,2546,16552
3,14,5,2,2014,23,14209,2480,16689
3,14,5,2,2014,24,14463,2499,16962
1,15,5,2,2014,1,15030,2379,17409
1,15,5,2,2014,2,14732,2209,16941
1,15,5,2,2014,3,14269,2062,16331
1,15,5,2,2014,4,15134,1959,17093
1,15,5,2,2014,5,14993,1904,16897
1,15,5,2,2014,6,14343,1939,16282
1,15,5,2,2014,7,14886,1926,16812
1,15,5,2,2014,8,14973,2038,17011
1,15,5,2,2014,9,14967,2328,17295
1,15,5,2,2014,10,16010,2699,18709
1,15,5,2,2014,11,15789,2980,18769
1,15,5,2,2014,12,15655,3053,18708
1,15,5,2,2014,13,15856,3064,18920
1,15,5,2,2014,14,15297,3040,18337
1,15,5,2,2014,15,15273,3057,18330
1,15,5,2,2014,16,15496,3057,18553
1,15,5,2,2014,17,14715,3054,17769
1,15,5,2,2014,18,13224,2956,16180
1,15,5,2,2014,19,13954,2760,16714
1,15,5,2,2014,20,14488,2784,17272
1,15,5,2,2014,21,14907,2685,17592
1,15,5,2,2014,22,13929,2582,16511
1,15,5,2,2014,23,14347,2538,16885
1,15,5,2,2014,24,13803,2525,16328
1,16,5,2,2014,1,15274,2417,17691
1,16,5,2,2014,2,14944,2221,17165
1,16,5,2,2014,3,14786,2059,16845
1,16,5,2,2014,4,14283,1970,16253
1,16,5,2,2014,5,14362,1938,16300
1,16,5,2,2014,6,14655,1955,16610
1,16,5,2,2014,7,14680,1953,16633
1,16,5,2,2014,8,15251,2086,17337
1,16,5,2,2014,9,15610,2393,18003
1,16,5,2,2014,10,15811,2760,18571
1,16,5,2,2014,11,16414,3039,19453
1,16,5,2,2014,12,16789,3104,19893
1,16,5,2,2014,13,16687,3015,19702
1,16,5,2,2014,14,16411,2873,19284
1,16,5,2,2014,15,16325,2956,19281
1,16,5,2,2014,16,16475,2951,19426
1,16,5,2,2014,17,15913,2931,18844
1,16,5,2,2014,18,14142,2816,16958
1,16,5,2,2014,19,13211,2613,15824
1,16,5,2,2014,20,14556,2586,17142
1,16,5,2,2014,21,14604,2555,17159
1,16,5,2,2014,22,14289,2443,16732
1,16,5,2,2014,23,14467,2387,16854
1,16,5,2,2014,24,14865,2288,17153
2,17,5,2,2014,1,14951,2396,17347
2,17,5,2,2014,2,14678,2177,16855
2,17,5,2,2014,3,14235,2066,16301
2,17,5,2,2014,4,14162,1984,16146
2,17,5,2,2014,5,14168,1942,16110
2,17,5,2,2014,6,14570,1946,16516
2,17,5,2,2014,7,14816,1910,16726
2,17,5,2,2014,8,14698,1980,16678
2,17,5,2,2014,9,15491,2184,17675
2,17,5,2,2014,10,15225,2498,17723
2,17,5,2,2014,11,15854,2766,18620
2,17,5,2,2014,12,16074,2877,18951
2,17,5,2,2014,13,16000,2880,18880
2,17,5,2,2014,14,15663,2846,18509
2,17,5,2,2014,15,15534,2870,18404
2,17,5,2,2014,16,15533,2873,18406
2,17,5,2,2014,17,15026,2854,17880
2,17,5,2,2014,18,13493,2675,16168
2,17,5,2,2014,19,13129,2574,15703
2,17,5,2,2014,20,13821,2656,16477
2,17,5,2,2014,21,13780,2617,16397
2,17,5,2,2014,22,13914,2532,16446
2,17,5,2,2014,23,13911,2492,16403
2,17,5,2,2014,24,14573,2520,17093
2,18,5,2,2014,1,14660,2380,17040
2,18,5,2,2014,2,14669,2220,16889
2,18,5,2,2014,3,14693,2077,16770
2,18,5,2,2014,4,14412,1989,16401
2,18,5,2,2014,5,14206,1934,16140
2,18,5,2,2014,6,14642,1949,16591
2,18,5,2,2014,7,14373,1878,16251
2,18,5,2,2014,8,14288,1867,16155
2,18,5,2,2014,9,14455,1927,16382
2,18,5,2,2014,10,15402,2021,17423
2,18,5,2,2014,11,15850,2126,17976
2,18,5,2,2014,12,15804,2237,18041
2,18,5,2,2014,13,15792,2272,18064
2,18,5,2,2014,14,15568,2249,17817
2,18,5,2,2014,15,15524,2275,17799
2,18,5,2,2014,16,15413,2288,17701
2,18,5,2,2014,17,14891,2243,17134
2,18,5,2,2014,18,13229,2184,15413
2,18,5,2,2014,19,12876,2185,15061
2,18,5,2,2014,20,13459,2333,15792
2,18,5,2,2014,21,13604,2363,15967
2,18,5,2,2014,22,13419,2411,15830
2,18,5,2,2014,23,14022,2388,16410
2,18,5,2,2014,24,13736,2551,16287
1,19,5,2,2014,1,14261,2436,16697
1,19,5,2,2014,2,14161,2230,16391
1,19,5,2,2014,3,14200,2145,16345
1,19,5,2,2014,4,13828,2089,15917
1,19,5,2,2014,5,14033,1992,16025
1,19,5,2,2014,6,14259,2015,16274
1,19,5,2,2014,7,14356,2049,16405
1,19,5,2,2014,8,14493,2110,16603
1,19,5,2,2014,9,14806,2399,17205
1,19,5,2,2014,10,15645,2654,18299
1,19,5,2,2014,11,15849,3043,18892
1,19,5,2,2014,12,16058,3224,19282
1,19,5,2,2014,13,15767,3258,19025
1,19,5,2,2014,14,15570,3198,18768
1,19,5,2,2014,15,15812,3255,19067
1,19,5,2,2014,16,16096,3259,19355
1,19,5,2,2014,17,15443,3251,18694
1,19,5,2,2014,18,14057,3112,17169
1,19,5,2,2014,19,13458,2915,16373
1,19,5,2,2014,20,14130,2889,17019
1,19,5,2,2014,21,14372,2825,17197
1,19,5,2,2014,22,14151,2753,16904
1,19,5,2,2014,23,15237,2716,17953
1,19,5,2,2014,24,15093,2769,17862
1,20,5,2,2014,1,14893,2620,17513
1,20,5,2,2014,2,14489,2391,16880
1,20,5,2,2014,3,14397,2231,16628
1,20,5,2,2014,4,14082,2126,16208
1,20,5,2,2014,5,14066,2080,16146
1,20,5,2,2014,6,14403,2084,16487
1,20,5,2,2014,7,14378,2053,16431
1,20,5,2,2014,8,14808,2142,16950
1,20,5,2,2014,9,15230,2460,17690
1,20,5,2,2014,10,15652,2846,18498
1,20,5,2,2014,11,16186,3151,19337
1,20,5,2,2014,12,16334,3261,19595
1,20,5,2,2014,13,16144,3279,19423
1,20,5,2,2014,14,16262,3242,19504
1,20,5,2,2014,15,16097,3277,19374
1,20,5,2,2014,16,16276,3280,19556
1,20,5,2,2014,17,15602,3257,18859
1,20,5,2,2014,18,14362,3095,17457
1,20,5,2,2014,19,13895,2919,16814
1,20,5,2,2014,20,14495,2893,17388
1,20,5,2,2014,21,14266,2830,17096
1,20,5,2,2014,22,14174,2724,16898
1,20,5,2,2014,23,14503,2726,17229
1,20,5,2,2014,24,14312,2739,17051
1,21,5,2,2014,1,14176,2597,16773
1,21,5,2,2014,2,14252,2347,16599
1,21,5,2,2014,3,14369,2203,16572
1,21,5,2,2014,4,14012,2109,16121
1,21,5,2,2014,5,13775,2057,15832
1,21,5,2,2014,6,14317,2063,16380
1,21,5,2,2014,7,14700,2030,16730
1,21,5,2,2014,8,14811,2138,16949
1,21,5,2,2014,9,15135,2431,17566
1,21,5,2,2014,10,15807,2826,18633
1,21,5,2,2014,11,16299,3114,19413
1,21,5,2,2014,12,16048,3225,19273
1,21,5,2,2014,13,15951,3229,19180
1,21,5,2,2014,14,15692,3175,18867
1,21,5,2,2014,15,16082,3230,19312
1,21,5,2,2014,16,16294,3233,19527
1,21,5,2,2014,17,15841,3195,19036
1,21,5,2,2014,18,14758,3100,17858
1,21,5,2,2014,19,14295,2915,17210
1,21,5,2,2014,20,14844,2921,17765
1,21,5,2,2014,21,14926,2849,17775
1,21,5,2,2014,22,14652,2737,17389
1,21,5,2,2014,23,14865,2695,17560
1,21,5,2,2014,24,15395,2688,18083
1,22,5,2,2014,1,15177,2523,17700
1,22,5,2,2014,2,14988,2337,17325
1,22,5,2,2014,3,14646,2192,16838
1,22,5,2,2014,4,14869,2095,16964
1,22,5,2,2014,5,14348,2048,16396
1,22,5,2,2014,6,14581,2063,16644
1,22,5,2,2014,7,15196,2035,17231
1,22,5,2,2014,8,14772,2128,16900
1,22,5,2,2014,9,15490,2437,17927
1,22,5,2,2014,10,15872,2799,18671
1,22,5,2,2014,11,15998,3069,19067
1,22,5,2,2014,12,16129,3164,19293
1,22,5,2,2014,13,15958,3161,19119
1,22,5,2,2014,14,15016,3078,18094
1,22,5,2,2014,15,15730,3143,18873
1,22,5,2,2014,16,16105,3153,19258
1,22,5,2,2014,17,15766,3159,18925
1,22,5,2,2014,18,14185,3031,17216
1,22,5,2,2014,19,14003,2864,16867
1,22,5,2,2014,20,14615,2817,17432
1,22,5,2,2014,21,14838,2740,17578
1,22,5,2,2014,22,14524,2640,17164
1,22,5,2,2014,23,14917,2629,17546
1,22,5,2,2014,24,15035,2637,17672
1,23,5,2,2014,1,14876,2511,17387
1,23,5,2,2014,2,14198,2309,16507
1,23,5,2,2014,3,14332,2172,16504
1,23,5,2,2014,4,14397,2066,16463
1,23,5,2,2014,5,14028,2014,16042
1,23,5,2,2014,6,14526,2031,16557
1,23,5,2,2014,7,14707,2031,16738
1,23,5,2,2014,8,14758,2133,16891
1,23,5,2,2014,9,15092,2401,17493
1,23,5,2,2014,10,15108,2731,17839
1,23,5,2,2014,11,14732,3055,17787
1,23,5,2,2014,12,15091,3146,18237
1,23,5,2,2014,13,15284,3150,18434
1,23,5,2,2014,14,15198,3081,18279
1,23,5,2,2014,15,15102,3151,18253
1,23,5,2,2014,16,15910,3143,19053
1,23,5,2,2014,17,15054,3150,18204
1,23,5,2,2014,18,13847,3085,16932
1,23,5,2,2014,19,13619,2889,16508
1,23,5,2,2014,20,14203,2857,17060
1,23,5,2,2014,21,14453,2764,17217
1,23,5,2,2014,22,14346,2654,17000
1,23,5,2,2014,23,14545,2632,17177
1,23,5,2,2014,24,14574,2629,17203
2,24,5,2,2014,1,14747,2493,17240
2,24,5,2,2014,2,14418,2292,16710
2,24,5,2,2014,3,14430,2153,16583
2,24,5,2,2014,4,14459,2079,16538
2,24,5,2,2014,5,14397,2041,16438
2,24,5,2,2014,6,14641,2041,16682
2,24,5,2,2014,7,14940,2016,16956
2,24,5,2,2014,8,14994,2069,17063
2,24,5,2,2014,9,15392,2237,17629
2,24,5,2,2014,10,15388,2501,17889
2,24,5,2,2014,11,15229,2692,17921
2,24,5,2,2014,12,15331,2788,18119
2,24,5,2,2014,13,15845,2763,18608
2,24,5,2,2014,14,15810,2725,18535
2,24,5,2,2014,15,15995,2745,18740
2,24,5,2,2014,16,16307,2711,19018
2,24,5,2,2014,17,16150,2716,18866
2,24,5,2,2014,18,14413,2632,17045
2,24,5,2,2014,19,14154,2517,16671
2,24,5,2,2014,20,14815,2570,17385
2,24,5,2,2014,21,15069,2676,17745
2,24,5,2,2014,22,14805,2653,17458
2,24,5,2,2014,23,14682,2574,17256
2,24,5,2,2014,24,14925,2533,17458
1,26,5,2,2014,1,14997,2377,17374
1,26,5,2,2014,2,14932,2246,17178
1,26,5,2,2014,3,14534,2152,16686
1,26,5,2,2014,4,14467,2077,16544
1,26,5,2,2014,5,14426,1957,16383
1,26,5,2,2014,6,14822,2043,16865
1,26,5,2,2014,7,14729,2066,16795
1,26,5,2,2014,8,15225,2148,17373
1,26,5,2,2014,9,15499,2357,17856
1,26,5,2,2014,10,16003,2665,18668
1,26,5,2,2014,11,16469,2924,19393
1,26,5,2,2014,12,16805,3184,19989
1,26,5,2,2014,13,16514,3192,19706
1,26,5,2,2014,14,16204,3163,19367
1,26,5,2,2014,15,15932,3191,19123
1,26,5,2,2014,16,16210,3193,19403
1,26,5,2,2014,17,15208,3165,18373
1,26,5,2,2014,18,14577,3041,17618
1,26,5,2,2014,19,14196,2863,17059
1,26,5,2,2014,20,14847,2851,17698
1,26,5,2,2014,21,14694,2780,17474
1,26,5,2,2014,22,14441,2703,17144
1,26,5,2,2014,23,14702,2715,17417
1,26,5,2,2014,24,15064,2668,17732
1,27,5,2,2014,1,15081,2546,17627
1,27,5,2,2014,2,14884,2343,17227
1,27,5,2,2014,3,14447,2206,16653
1,27,5,2,2014,4,14369,2092,16461
1,27,5,2,2014,5,14714,2030,16744
1,27,5,2,2014,6,15305,2046,17351
1,27,5,2,2014,7,15514,2037,17551
1,27,5,2,2014,8,15406,2149,17555
1,27,5,2,2014,9,15374,2453,17827
1,27,5,2,2014,10,16184,2872,19056
1,27,5,2,2014,11,16280,3189,19469
1,27,5,2,2014,12,15740,3248,18988
1,27,5,2,2014,13,16100,3244,19344
1,27,5,2,2014,14,15296,3210,18506
1,27,5,2,2014,15,14930,3243,18173
1,27,5,2,2014,16,14469,3243,17712
1,27,5,2,2014,17,13976,3228,17204
1,27,5,2,2014,18,13174,3118,16292
1,27,5,2,2014,19,13022,2896,15918
1,27,5,2,2014,20,13807,2884,16691
1,27,5,2,2014,21,13819,2849,16668
1,27,5,2,2014,22,14045,2717,16762
1,27,5,2,2014,23,14112,2685,16797
1,27,5,2,2014,24,14520,2788,17308
1,28,5,2,2014,1,14843,2531,17374
1,28,5,2,2014,2,14393,2382,16775
1,28,5,2,2014,3,14268,2222,16490
1,28,5,2,2014,4,14090,2123,16213
1,28,5,2,2014,5,13789,2111,15900
1,28,5,2,2014,6,14194,2199,16393
1,28,5,2,2014,7,14178,2125,16303
1,28,5,2,2014,8,14946,2215,17161
1,28,5,2,2014,9,14913,2459,17372
1,28,5,2,2014,10,15476,2824,18300
1,28,5,2,2014,11,15261,3144,18405
1,28,5,2,2014,12,16047,3218,19265
1,28,5,2,2014,13,16327,3221,19548
1,28,5,2,2014,14,16262,3168,19430
1,28,5,2,2014,15,15995,3218,19213
1,28,5,2,2014,16,15613,3216,18829
1,28,5,2,2014,17,15186,3208,18394
1,28,5,2,2014,18,14146,3088,17234
1,28,5,2,2014,19,13829,2891,16720
1,28,5,2,2014,20,14327,2842,17169
1,28,5,2,2014,21,14426,2815,17241
1,28,5,2,2014,22,14055,2726,16781
1,28,5,2,2014,23,14083,2698,16781
1,28,5,2,2014,24,14288,2693,16981
1,29,5,2,2014,1,14850,2614,17464
1,29,5,2,2014,2,14744,2388,17132
1,29,5,2,2014,3,14342,2243,16585
1,29,5,2,2014,4,14643,2137,16780
1,29,5,2,2014,5,14305,2091,16396
1,29,5,2,2014,6,14477,2115,16592
1,29,5,2,2014,7,14803,2086,16889
1,29,5,2,2014,8,15210,2180,17390
1,29,5,2,2014,9,15135,2472,17607
1,29,5,2,2014,10,15294,2850,18144
1,29,5,2,2014,11,15622,3121,18743
1,29,5,2,2014,12,15562,3207,18769
1,29,5,2,2014,13,16019,3239,19258
1,29,5,2,2014,14,16025,3181,19206
1,29,5,2,2014,15,15700,3238,18938
1,29,5,2,2014,16,15921,3240,19161
1,29,5,2,2014,17,15219,3239,18458
1,29,5,2,2014,18,13597,3099,16696
1,29,5,2,2014,19,13634,2926,16560
1,29,5,2,2014,20,14313,2896,17209
1,29,5,2,2014,21,14438,2807,17245
1,29,5,2,2014,22,13965,2717,16682
1,29,5,2,2014,23,14271,2698,16969
1,29,5,2,2014,24,14479,2714,17193
1,30,5,2,2014,1,14669,2598,17267
1,30,5,2,2014,2,14259,2351,16610
1,30,5,2,2014,3,14135,2210,16345
1,30,5,2,2014,4,14236,2102,16338
1,30,5,2,2014,5,14187,2083,16270
1,30,5,2,2014,6,14419,2100,16519
1,30,5,2,2014,7,14454,2074,16528
1,30,5,2,2014,8,14353,2162,16515
1,30,5,2,2014,9,14452,2458,16910
1,30,5,2,2014,10,14844,2866,17710
1,30,5,2,2014,11,14953,3133,18086
1,30,5,2,2014,12,15122,3226,18348
1,30,5,2,2014,13,15061,3223,18284
1,30,5,2,2014,14,14868,3145,18013
1,30,5,2,2014,15,15151,3216,18367
1,30,5,2,2014,16,14943,3223,18166
1,30,5,2,2014,17,14729,3206,17935
1,30,5,2,2014,18,13612,3087,16699
1,30,5,2,2014,19,13258,2902,16160
1,30,5,2,2014,20,14071,2858,16929
1,30,5,2,2014,21,14205,2800,17005
1,30,5,2,2014,22,14130,2769,16899
1,30,5,2,2014,23,14460,2743,17203
1,30,5,2,2014,24,14756,2685,17441
2,31,5,2,2014,1,14650,2619,17269
2,31,5,2,2014,2,14554,2419,16973
2,31,5,2,2014,3,14603,2277,16880
2,31,5,2,2014,4,14536,2145,16681
2,31,5,2,2014,5,14448,2088,16536
2,31,5,2,2014,6,14820,2084,16904
2,31,5,2,2014,7,15254,2034,17288
2,31,5,2,2014,8,15120,2078,17198
2,31,5,2,2014,9,15463,2289,17752
2,31,5,2,2014,10,15806,2583,18389
2,31,5,2,2014,11,16019,2915,18934
2,31,5,2,2014,12,16359,2964,19323
2,31,5,2,2014,13,16341,2962,19303
2,31,5,2,2014,14,16348,2925,19273
2,31,5,2,2014,15,16147,2956,19103
2,31,5,2,2014,16,15972,2963,18935
2,31,5,2,2014,17,15849,2905,18754
2,31,5,2,2014,18,14277,2770,17047
2,31,5,2,2014,19,13703,2665,16368
2,31,5,2,2014,20,14797,2723,17520
2,31,5,2,2014,21,14848,2640,17488
2,31,5,2,2014,22,14486,2581,17067
2,31,5,2,2014,23,14431,2568,16999
2,31,5,2,2014,24,14285,2610,16895
2,1,6,2,2014,1,15036,2489,17525
2,1,6,2,2014,2,14795,2361,17156
2,1,6,2,2014,3,14157,2217,16374
2,1,6,2,2014,4,14362,2093,16455
2,1,6,2,2014,5,14208,2032,16240
2,1,6,2,2014,6,14601,2027,16628
2,1,6,2,2014,7,14604,1957,16561
2,1,6,2,2014,8,14662,1937,16599
2,1,6,2,2014,9,14767,1986,16753
2,1,6,2,2014,10,15016,2074,17090
2,1,6,2,2014,11,15310,2142,17452
2,1,6,2,2014,12,15473,2231,17704
2,1,6,2,2014,13,15548,2264,17812
2,1,6,2,2014,14,15356,2249,17605
2,1,6,2,2014,15,14891,2303,17194
2,1,6,2,2014,16,15012,2293,17305
2,1,6,2,2014,17,14662,2257,16919
2,1,6,2,2014,18,13276,2207,15483
2,1,6,2,2014,19,12903,2156,15059
2,1,6,2,2014,20,14038,2313,16351
2,1,6,2,2014,21,13901,2497,16398
2,1,6,2,2014,22,13645,2487,16132
2,1,6,2,2014,23,13719,2521,16240
2,1,6,2,2014,24,13375,2540,15915
1,2,6,2,2014,1,14229,2476,16705
1,2,6,2,2014,2,14209,2335,16544
1,2,6,2,2014,3,13980,2195,16175
1,2,6,2,2014,4,14378,2132,16510
1,2,6,2,2014,5,13798,2114,15912
1,2,6,2,2014,6,13716,2153,15869
1,2,6,2,2014,7,14123,2120,16243
1,2,6,2,2014,8,14466,2093,16559
1,2,6,2,2014,9,14849,2359,17208
1,2,6,2,2014,10,15074,2761,17835
1,2,6,2,2014,11,15117,3096,18213
1,2,6,2,2014,12,16015,3195,19210
1,2,6,2,2014,13,14904,3266,18170
1,2,6,2,2014,14,14921,3196,18117
1,2,6,2,2014,15,16050,3261,19311
1,2,6,2,2014,16,16071,3268,19339
1,2,6,2,2014,17,14943,3231,18174
1,2,6,2,2014,18,14319,3078,17397
1,2,6,2,2014,19,12992,2905,15897
1,2,6,2,2014,20,13329,2874,16203
1,2,6,2,2014,21,13204,2786,15990
1,2,6,2,2014,22,12966,2705,15671
1,2,6,2,2014,23,13194,2709,15903
1,2,6,2,2014,24,13400,2741,16141
1,3,6,2,2014,1,13055,2637,15692
1,3,6,2,2014,2,13218,2421,15639
1,3,6,2,2014,3,13340,2284,15624
1,3,6,2,2014,4,13589,2175,15764
1,3,6,2,2014,5,13351,2106,15457
1,3,6,2,2014,6,13715,2114,15829
1,3,6,2,2014,7,14068,2086,16154
1,3,6,2,2014,8,14223,2174,16397
1,3,6,2,2014,9,13888,2468,16356
1,3,6,2,2014,10,14730,2869,17599
1,3,6,2,2014,11,14362,3153,17515
1,3,6,2,2014,12,14937,3265,18202
1,3,6,2,2014,13,14944,3308,18252
1,3,6,2,2014,14,14492,3252,17744
1,3,6,2,2014,15,15065,3307,18372
1,3,6,2,2014,16,15210,3310,18520
1,3,6,2,2014,17,14410,3264,17674
1,3,6,2,2014,18,13752,3135,16887
1,3,6,2,2014,19,13391,2931,16322
1,3,6,2,2014,20,13527,2910,16437
1,3,6,2,2014,21,13632,2822,16454
1,3,6,2,2014,22,13601,2796,16397
1,3,6,2,2014,23,13803,2759,16562
1,3,6,2,2014,24,13167,2793,15960
1,4,6,2,2014,1,13985,2648,16633
1,4,6,2,2014,2,13393,2426,15819
1,4,6,2,2014,3,13586,2280,15866
1,4,6,2,2014,4,13706,2176,15882
1,4,6,2,2014,5,13485,2100,15585
1,4,6,2,2014,6,13879,2112,15991
1,4,6,2,2014,7,14331,2103,16434
1,4,6,2,2014,8,14195,2189,16384
1,4,6,2,2014,9,14700,2463,17163
1,4,6,2,2014,10,14924,2854,17778
1,4,6,2,2014,11,14861,3143,18004
1,4,6,2,2014,12,15777,3253,19030
1,4,6,2,2014,13,15613,3261,18874
1,4,6,2,2014,14,15746,3232,18978
1,4,6,2,2014,15,14911,3262,18173
1,4,6,2,2014,16,15031,3261,18292
1,4,6,2,2014,17,14621,3261,17882
1,4,6,2,2014,18,13313,3160,16473
1,4,6,2,2014,19,12913,2954,15867
1,4,6,2,2014,20,13635,2930,16565
1,4,6,2,2014,21,13529,2884,16413
1,4,6,2,2014,22,13323,2834,16157
1,4,6,2,2014,23,13454,2838,16292
1,4,6,2,2014,24,13328,2729,16057
1,5,6,2,2014,1,13291,2662,15953
1,5,6,2,2014,2,13342,2459,15801
1,5,6,2,2014,3,13076,2302,15378
1,5,6,2,2014,4,13210,2196,15406
1,5,6,2,2014,5,12792,2152,14944
1,5,6,2,2014,6,13130,2147,15277
1,5,6,2,2014,7,13130,2123,15253
1,5,6,2,2014,8,13266,2220,15486
1,5,6,2,2014,9,13420,2511,15931
1,5,6,2,2014,10,13716,2896,16612
1,5,6,2,2014,11,13640,3148,16788
1,5,6,2,2014,12,13952,3239,17191
1,5,6,2,2014,13,14810,3251,18061
1,5,6,2,2014,14,14884,3201,18085
1,5,6,2,2014,15,15393,3252,18645
1,5,6,2,2014,16,15096,3254,18350
1,5,6,2,2014,17,14636,3239,17875
1,5,6,2,2014,18,13972,3123,17095
1,5,6,2,2014,19,12964,2973,15937
1,5,6,2,2014,20,13869,2952,16821
1,5,6,2,2014,21,14210,2889,17099
1,5,6,2,2014,22,13845,2832,16677
1,5,6,2,2014,23,13783,2795,16578
1,5,6,2,2014,24,13864,2786,16650
1,6,6,2,2014,1,14228,2666,16894
1,6,6,2,2014,2,13861,2466,16327
1,6,6,2,2014,3,13951,2320,16271
1,6,6,2,2014,4,14012,2205,16217
1,6,6,2,2014,5,13574,2139,15713
1,6,6,2,2014,6,13761,2138,15899
1,6,6,2,2014,7,14242,2113,16355
1,6,6,2,2014,8,14143,2210,16353
1,6,6,2,2014,9,14133,2506,16639
1,6,6,2,2014,10,14560,2846,17406
1,6,6,2,2014,11,14388,3183,17571
1,6,6,2,2014,12,14555,3308,17863
1,6,6,2,2014,13,14669,3317,17986
1,6,6,2,2014,14,14835,3241,18076
1,6,6,2,2014,15,14946,3316,18262
1,6,6,2,2014,16,15056,3314,18370
1,6,6,2,2014,17,14640,3284,17924
1,6,6,2,2014,18,13494,3151,16645
1,6,6,2,2014,19,12776,2930,15706
1,6,6,2,2014,20,14120,2898,17018
1,6,6,2,2014,21,14277,2876,17153
1,6,6,2,2014,22,13181,2782,15963
1,6,6,2,2014,23,13704,2747,16451
1,6,6,2,2014,24,13870,2733,16603
2,7,6,2,2014,1,13923,2603,16526
2,7,6,2,2014,2,13584,2395,15979
2,7,6,2,2014,3,13611,2251,15862
2,7,6,2,2014,4,12750,2130,14880
2,7,6,2,2014,5,12944,2073,15017
2,7,6,2,2014,6,13266,2077,15343
2,7,6,2,2014,7,13145,2049,15194
2,7,6,2,2014,8,13149,2144,15293
2,7,6,2,2014,9,13496,2355,15851
2,7,6,2,2014,10,13789,2682,16471
2,7,6,2,2014,11,13935,2964,16899
2,7,6,2,2014,12,14782,3055,17837
2,7,6,2,2014,13,14638,3066,17704
2,7,6,2,2014,14,14856,3004,17860
2,7,6,2,2014,15,14954,3044,17998
2,7,6,2,2014,16,15255,3065,18320
2,7,6,2,2014,17,14994,2985,17979
2,7,6,2,2014,18,13877,2840,16717
2,7,6,2,2014,19,13666,2710,16376
2,7,6,2,2014,20,14053,2742,16795
2,7,6,2,2014,21,14791,2768,17559
2,7,6,2,2014,22,14120,2687,16807
2,7,6,2,2014,23,14064,2667,16731
2,7,6,2,2014,24,14573,2679,17252
2,8,6,2,2014,1,14371,2555,16926
2,8,6,2,2014,2,14404,2410,16814
2,8,6,2,2014,3,14451,2273,16724
2,8,6,2,2014,4,14337,2159,16496
2,8,6,2,2014,5,13925,2104,16029
2,8,6,2,2014,6,14499,2113,16612
2,8,6,2,2014,7,14546,2053,16599
2,8,6,2,2014,8,14373,2043,16416
2,8,6,2,2014,9,14196,2056,16252
2,8,6,2,2014,10,14912,2074,16986
2,8,6,2,2014,11,15411,2171,17582
2,8,6,2,2014,12,15319,2224,17543
2,8,6,2,2014,13,15445,2281,17726
2,8,6,2,2014,14,15566,2315,17881
2,8,6,2,2014,15,15576,2379,17955
2,8,6,2,2014,16,15354,2382,17736
2,8,6,2,2014,17,15152,2339,17491
2,8,6,2,2014,18,13793,2256,16049
2,8,6,2,2014,19,13676,2217,15893
2,8,6,2,2014,20,13985,2376,16361
2,8,6,2,2014,21,14584,2476,17060
2,8,6,2,2014,22,14121,2561,16682
2,8,6,2,2014,23,14716,2652,17368
2,8,6,2,2014,24,14463,2679,17142
1,9,6,2,2014,1,14946,2644,17590
1,9,6,2,2014,2,14466,2467,16933
1,9,6,2,2014,3,14561,2337,16898
1,9,6,2,2014,4,14418,2223,16641
1,9,6,2,2014,5,14023,2169,16192
1,9,6,2,2014,6,14269,2163,16432
1,9,6,2,2014,7,14725,2141,16866
1,9,6,2,2014,8,14559,2236,16795
1,9,6,2,2014,9,15137,2544,17681
1,9,6,2,2014,10,15303,2928,18231
1,9,6,2,2014,11,15857,3215,19072
1,9,6,2,2014,12,16299,3285,19584
1,9,6,2,2014,13,15815,3284,19099
1,9,6,2,2014,14,15132,3211,18343
1,9,6,2,2014,15,15695,3259,18954
1,9,6,2,2014,16,16011,3288,19299
1,9,6,2,2014,17,15777,3265,19042
1,9,6,2,2014,18,14550,3140,17690
1,9,6,2,2014,19,13839,3013,16852
1,9,6,2,2014,20,14206,2933,17139
1,9,6,2,2014,21,14352,2864,17216
1,9,6,2,2014,22,13905,2797,16702
1,9,6,2,2014,23,14196,2810,17006
1,9,6,2,2014,24,13493,2816,16309
1,10,6,2,2014,1,13815,2658,16473
1,10,6,2,2014,2,13801,2473,16274
1,10,6,2,2014,3,13808,2288,16096
1,10,6,2,2014,4,14324,2172,16496
1,10,6,2,2014,5,13747,2124,15871
1,10,6,2,2014,6,13953,2142,16095
1,10,6,2,2014,7,13674,2144,15818
1,10,6,2,2014,8,14185,2206,16391
1,10,6,2,2014,9,15072,2461,17533
1,10,6,2,2014,10,14032,2843,16875
1,10,6,2,2014,11,14487,3121,17608
1,10,6,2,2014,12,14983,3224,18207
1,10,6,2,2014,13,15438,3272,18710
1,10,6,2,2014,14,15246,3287,18533
1,10,6,2,2014,15,15836,3358,19194
1,10,6,2,2014,16,15570,3365,18935
1,10,6,2,2014,17,15483,3347,18830
1,10,6,2,2014,18,14262,3238,17500
1,10,6,2,2014,19,13824,3021,16845
1,10,6,2,2014,20,14097,2992,17089
1,10,6,2,2014,21,14354,2900,17254
1,10,6,2,2014,22,14203,2833,17036
1,10,6,2,2014,23,14057,2839,16896
1,10,6,2,2014,24,14184,2865,17049
1,11,6,2,2014,1,14356,2706,17062
1,11,6,2,2014,2,14047,2513,16560
1,11,6,2,2014,3,14306,2361,16667
1,11,6,2,2014,4,14282,2256,16538
1,11,6,2,2014,5,14035,2183,16218
1,11,6,2,2014,6,13926,2193,16119
1,11,6,2,2014,7,14709,2150,16859
1,11,6,2,2014,8,14356,2243,16599
1,11,6,2,2014,9,14910,2440,17350
1,11,6,2,2014,10,15310,2934,18244
1,11,6,2,2014,11,15237,3151,18388
1,11,6,2,2014,12,15722,3244,18966
1,11,6,2,2014,13,15577,3285,18862
1,11,6,2,2014,14,15413,3212,18625
1,11,6,2,2014,15,15646,3316,18962
1,11,6,2,2014,16,16061,3324,19385
1,11,6,2,2014,17,15307,3287,18594
1,11,6,2,2014,18,13746,3143,16889
1,11,6,2,2014,19,13643,2951,16594
1,11,6,2,2014,20,14408,2949,17357
1,11,6,2,2014,21,14362,2872,17234
1,11,6,2,2014,22,13836,2688,16524
1,11,6,2,2014,23,14117,2830,16947
1,11,6,2,2014,24,14327,2765,17092
1,12,6,2,2014,1,14020,2683,16703
1,12,6,2,2014,2,13761,2472,16233
1,12,6,2,2014,3,13772,2322,16094
1,12,6,2,2014,4,13336,2215,15551
1,12,6,2,2014,5,13486,2144,15630
1,12,6,2,2014,6,13903,2143,16046
1,12,6,2,2014,7,13259,2134,15393
1,12,6,2,2014,8,14297,2222,16519
1,12,6,2,2014,9,14730,2514,17244
1,12,6,2,2014,10,15233,2852,18085
1,12,6,2,2014,11,14377,3182,17559
1,12,6,2,2014,12,14541,3284,17825
1,12,6,2,2014,13,15134,3238,18372
1,12,6,2,2014,14,15277,3248,18525
1,12,6,2,2014,15,15509,3332,18841
1,12,6,2,2014,16,15331,3341,18672
1,12,6,2,2014,17,15880,3313,19193
1,12,6,2,2014,18,14378,3164,17542
1,12,6,2,2014,19,13263,2967,16230
1,12,6,2,2014,20,14358,2980,17338
1,12,6,2,2014,21,14729,2917,17646
1,12,6,2,2014,22,14388,2821,17209
1,12,6,2,2014,23,14254,2829,17083
1,12,6,2,2014,24,13355,2756,16111
1,13,6,2,2014,1,14013,2668,16681
1,13,6,2,2014,2,13944,2488,16432
1,13,6,2,2014,3,14291,2341,16632
1,13,6,2,2014,4,14133,2254,16387
1,13,6,2,2014,5,13953,2233,16186
1,13,6,2,2014,6,14428,2235,16663
1,13,6,2,2014,7,14299,2225,16524
1,13,6,2,2014,8,14729,2283,17012
1,13,6,2,2014,9,15209,2459,17668
1,13,6,2,2014,10,15115,2772,17887
1,13,6,2,2014,11,15377,3120,18497
1,13,6,2,2014,12,14962,3231,18193
1,13,6,2,2014,13,15541,3233,18774
1,13,6,2,2014,14,15342,3182,18524
1,13,6,2,2014,15,15476,3228,18704
1,13,6,2,2014,16,15496,3228,18724
1,13,6,2,2014,17,14148,3209,17357
1,13,6,2,2014,18,12986,3067,16053
1,13,6,2,2014,19,12759,2843,15602
1,13,6,2,2014,20,13514,2825,16339
1,13,6,2,2014,21,13613,2783,16396
1,13,6,2,2014,22,13224,2706,15930
1,13,6,2,2014,23,13480,2685,16165
1,13,6,2,2014,24,13373,2709,16082
2,14,6,2,2014,1,13918,2548,16466
2,14,6,2,2014,2,13634,2352,15986
2,14,6,2,2014,3,13372,2220,15592
2,14,6,2,2014,4,12955,2111,15066
2,14,6,2,2014,5,13007,2058,15065
2,14,6,2,2014,6,13736,2062,15798
2,14,6,2,2014,7,13870,2024,15894
2,14,6,2,2014,8,14148,2063,16211
2,14,6,2,2014,9,14462,2272,16734
2,14,6,2,2014,10,14605,2630,17235
2,14,6,2,2014,11,15188,2884,18072
2,14,6,2,2014,12,15070,2979,18049
2,14,6,2,2014,13,15587,2983,18570
2,14,6,2,2014,14,15358,2942,18300
2,14,6,2,2014,15,15626,2956,18582
2,14,6,2,2014,16,15460,2968,18428
2,14,6,2,2014,17,15332,2934,18266
2,14,6,2,2014,18,13368,2806,16174
2,14,6,2,2014,19,12841,2727,15568
2,14,6,2,2014,20,13831,2694,16525
2,14,6,2,2014,21,14098,2687,16785
2,14,6,2,2014,22,13933,2636,16569
2,14,6,2,2014,23,14093,2620,16713
2,14,6,2,2014,24,13999,2629,16628
2,15,6,2,2014,1,14468,2458,16926
2,15,6,2,2014,2,14383,2311,16694
2,15,6,2,2014,3,13951,2199,16150
2,15,6,2,2014,4,14066,2111,16177
2,15,6,2,2014,5,13989,2044,16033
2,15,6,2,2014,6,14117,2041,16158
2,15,6,2,2014,7,14424,1985,16409
2,15,6,2,2014,8,14232,1962,16194
2,15,6,2,2014,9,14679,1996,16675
2,15,6,2,2014,10,14361,2097,16458
2,15,6,2,2014,11,14742,2228,16970
2,15,6,2,2014,12,14853,2280,17133
2,15,6,2,2014,13,15332,2268,17600
2,15,6,2,2014,14,14808,2267,17075
2,15,6,2,2014,15,14631,2293,16924
2,15,6,2,2014,16,14782,2316,17098
2,15,6,2,2014,17,13868,2242,16110
2,15,6,2,2014,18,12927,2195,15122
2,15,6,2,2014,19,12445,2191,14636
2,15,6,2,2014,20,13151,2336,15487
2,15,6,2,2014,21,13681,2382,16063
2,15,6,2,2014,22,13169,2387,15556
2,15,6,2,2014,23,13673,2433,16106
2,15,6,2,2014,24,13735,2428,16163
1,16,6,2,2014,1,13780,2361,16141
1,16,6,2,2014,2,13744,2183,15927
1,16,6,2,2014,3,13577,2072,15649
1,16,6,2,2014,4,13686,2000,15686
1,16,6,2,2014,5,13315,1951,15266
1,16,6,2,2014,6,13971,1997,15968
1,16,6,2,2014,7,14130,2040,16170
1,16,6,2,2014,8,14065,2140,16205
1,16,6,2,2014,9,14409,2417,16826
1,16,6,2,2014,10,15138,2745,17883
1,16,6,2,2014,11,15148,3067,18215
1,16,6,2,2014,12,15386,3115,18501
1,16,6,2,2014,13,14977,3114,18091
1,16,6,2,2014,14,14856,3062,17918
1,16,6,2,2014,15,15017,3080,18097
1,16,6,2,2014,16,15129,3053,18182
1,16,6,2,2014,17,14642,3018,17660
1,16,6,2,2014,18,13603,2976,16579
1,16,6,2,2014,19,13203,2843,16046
1,16,6,2,2014,20,13965,2768,16733
1,16,6,2,2014,21,14268,2683,16951
1,16,6,2,2014,22,13820,2606,16426
1,16,6,2,2014,23,14272,2565,16837
1,16,6,2,2014,24,14144,2467,16611
1,17,6,2,2014,1,14464,2263,16727
1,17,6,2,2014,2,13984,2082,16066
1,17,6,2,2014,3,14049,1985,16034
1,17,6,2,2014,4,13821,1899,15720
1,17,6,2,2014,5,13646,1865,15511
1,17,6,2,2014,6,14227,1931,16158
1,17,6,2,2014,7,14327,1997,16324
1,17,6,2,2014,8,14396,2112,16508
1,17,6,2,2014,9,14615,2417,17032
1,17,6,2,2014,10,14782,2774,17556
1,17,6,2,2014,11,15034,3054,18088
1,17,6,2,2014,12,14983,3146,18129
1,17,6,2,2014,13,14896,3094,17990
1,17,6,2,2014,14,14583,3122,17705
1,17,6,2,2014,15,14895,3072,17967
1,17,6,2,2014,16,15008,3093,18101
1,17,6,2,2014,17,14771,3062,17833
1,17,6,2,2014,18,13139,2997,16136
1,17,6,2,2014,19,13332,2847,16179
1,17,6,2,2014,20,13904,2809,16713
1,17,6,2,2014,21,13723,2745,16468
1,17,6,2,2014,22,13789,2657,16446
1,17,6,2,2014,23,13972,2685,16657
1,17,6,2,2014,24,13894,2491,16385
1,18,6,2,2014,1,14139,2367,16506
1,18,6,2,2014,2,13843,2147,15990
1,18,6,2,2014,3,13746,2023,15769
1,18,6,2,2014,4,13727,1965,15692
1,18,6,2,2014,5,13660,1931,15591
1,18,6,2,2014,6,13688,1961,15649
1,18,6,2,2014,7,14873,2015,16888
1,18,6,2,2014,8,14598,2122,16720
1,18,6,2,2014,9,14431,2476,16907
1,18,6,2,2014,10,15007,2775,17782
1,18,6,2,2014,11,15069,3081,18150
1,18,6,2,2014,12,15090,3128,18218
1,18,6,2,2014,13,14557,3125,17682
1,18,6,2,2014,14,14694,3098,17792
1,18,6,2,2014,15,14692,3125,17817
1,18,6,2,2014,16,14786,3125,17911
1,18,6,2,2014,17,14449,3120,17569
1,18,6,2,2014,18,13394,3049,16443
1,18,6,2,2014,19,13060,2888,15948
1,18,6,2,2014,20,13945,2869,16814
1,18,6,2,2014,21,14333,2814,17147
1,18,6,2,2014,22,13743,2697,16440
1,18,6,2,2014,23,14050,2662,16712
1,18,6,2,2014,24,14169,2565,16734
1,19,6,2,2014,1,14221,2503,16724
1,19,6,2,2014,2,13897,2242,16139
1,19,6,2,2014,3,13982,2059,16041
1,19,6,2,2014,4,13816,1947,15763
1,19,6,2,2014,5,13708,1929,15637
1,19,6,2,2014,6,14100,1948,16048
1,19,6,2,2014,7,14582,1998,16580
1,19,6,2,2014,8,14824,2098,16922
1,19,6,2,2014,9,14814,2429,17243
1,19,6,2,2014,10,15223,2809,18032
1,19,6,2,2014,11,15300,3086,18386
1,19,6,2,2014,12,15556,3152,18708
1,19,6,2,2014,13,15362,3149,18511
1,19,6,2,2014,14,14750,3103,17853
1,19,6,2,2014,15,14476,3147,17623
1,19,6,2,2014,16,14402,3143,17545
1,19,6,2,2014,17,13936,3135,17071
1,19,6,2,2014,18,12838,3027,15865
1,19,6,2,2014,19,12872,2911,15783
1,19,6,2,2014,20,13841,2881,16722
1,19,6,2,2014,21,13947,2777,16724
1,19,6,2,2014,22,13354,2677,16031
1,19,6,2,2014,23,13793,2691,16484
1,19,6,2,2014,24,13546,2606,16152
1,20,6,2,2014,1,13423,2424,15847
1,20,6,2,2014,2,13378,2220,15598
1,20,6,2,2014,3,13013,2091,15104
1,20,6,2,2014,4,13272,1986,15258
1,20,6,2,2014,5,13048,1946,14994
1,20,6,2,2014,6,13267,1996,15263
1,20,6,2,2014,7,13623,2032,15655
1,20,6,2,2014,8,13725,2139,15864
1,20,6,2,2014,9,14020,2437,16457
1,20,6,2,2014,10,13770,2821,16591
1,20,6,2,2014,11,13844,3136,16980
1,20,6,2,2014,12,13690,3183,16873
1,20,6,2,2014,13,13674,3180,16854
1,20,6,2,2014,14,13222,3089,16311
1,20,6,2,2014,15,13656,3150,16806
1,20,6,2,2014,16,13558,3166,16724
1,20,6,2,2014,17,13463,3116,16579
1,20,6,2,2014,18,12551,3036,15587
1,20,6,2,2014,19,12571,2931,15502
1,20,6,2,2014,20,13341,2891,16232
1,20,6,2,2014,21,13915,2774,16689
1,20,6,2,2014,22,13513,2744,16257
1,20,6,2,2014,23,13692,2641,16333
1,20,6,2,2014,24,13986,2507,16493
2,21,6,2,2014,1,13934,2447,16381
2,21,6,2,2014,2,13530,2274,15804
2,21,6,2,2014,3,13244,2105,15349
2,21,6,2,2014,4,13357,2010,15367
2,21,6,2,2014,5,13194,1956,15150
2,21,6,2,2014,6,13735,1984,15719
2,21,6,2,2014,7,14349,1978,16327
2,21,6,2,2014,8,14412,2054,16466
2,21,6,2,2014,9,14431,2299,16730
2,21,6,2,2014,10,14690,2694,17384
2,21,6,2,2014,11,14681,2947,17628
2,21,6,2,2014,12,14733,3041,17774
2,21,6,2,2014,13,14393,3046,17439
2,21,6,2,2014,14,14035,2938,16973
2,21,6,2,2014,15,14446,2940,17386
2,21,6,2,2014,16,14539,2921,17460
2,21,6,2,2014,17,13832,2871,16703
2,21,6,2,2014,18,13542,2762,16304
2,21,6,2,2014,19,13147,2697,15844
2,21,6,2,2014,20,13966,2725,16691
2,21,6,2,2014,21,14305,2717,17022
2,21,6,2,2014,22,13905,2621,16526
2,21,6,2,2014,23,13747,2555,16302
2,21,6,2,2014,24,14065,2560,16625
2,22,6,2,2014,1,14195,2450,16645
2,22,6,2,2014,2,13713,2288,16001
2,22,6,2,2014,3,13422,2154,15576
2,22,6,2,2014,4,13823,2049,15872
2,22,6,2,2014,5,13133,1990,15123
2,22,6,2,2014,6,13599,1999,15598
2,22,6,2,2014,7,14260,1938,16198
2,22,6,2,2014,8,14467,1942,16409
2,22,6,2,2014,9,14104,2008,16112
2,22,6,2,2014,10,14434,2113,16547
2,22,6,2,2014,11,14497,2222,16719
2,22,6,2,2014,12,14749,2281,17030
2,22,6,2,2014,13,14355,2304,16659
2,22,6,2,2014,14,13764,2283,16047
2,22,6,2,2014,15,14350,2289,16639
2,22,6,2,2014,16,14012,2275,16287
2,22,6,2,2014,17,13925,2252,16177
2,22,6,2,2014,18,13176,2196,15372
2,22,6,2,2014,19,12286,2173,14459
2,22,6,2,2014,20,13499,2324,15823
2,22,6,2,2014,21,13655,2427,16082
2,22,6,2,2014,22,13525,2484,16009
2,22,6,2,2014,23,14001,2535,16536
2,22,6,2,2014,24,13462,2571,16033
1,24,6,2,2014,1,14435,2515,16950
1,24,6,2,2014,2,14131,2297,16428
1,24,6,2,2014,3,14094,2181,16275
1,24,6,2,2014,4,13852,2095,15947
1,24,6,2,2014,5,13761,2044,15805
1,24,6,2,2014,6,14468,2075,16543
1,24,6,2,2014,7,14817,2107,16924
1,24,6,2,2014,8,15269,2192,17461
1,24,6,2,2014,9,15205,2495,17700
1,24,6,2,2014,10,15355,2876,18231
1,24,6,2,2014,11,15518,3147,18665
1,24,6,2,2014,12,15614,3224,18838
1,24,6,2,2014,13,15315,3215,18530
1,24,6,2,2014,14,15081,3163,18244
1,24,6,2,2014,15,15325,3215,18540
1,24,6,2,2014,16,15529,3231,18760
1,24,6,2,2014,17,14811,3175,17986
1,24,6,2,2014,18,13806,3105,16911
1,24,6,2,2014,19,13274,2954,16228
1,24,6,2,2014,20,14372,2909,17281
1,24,6,2,2014,21,14461,2828,17289
1,24,6,2,2014,22,14045,2757,16802
1,24,6,2,2014,23,14669,2710,17379
1,24,6,2,2014,24,14628,2696,17324
1,25,6,2,2014,1,14594,2544,17138
1,25,6,2,2014,2,14245,2327,16572
1,25,6,2,2014,3,14119,2181,16300
1,25,6,2,2014,4,14303,2077,16380
1,25,6,2,2014,5,14198,2031,16229
1,25,6,2,2014,6,14800,2070,16870
1,25,6,2,2014,7,15263,2105,17368
1,25,6,2,2014,8,15223,2204,17427
1,25,6,2,2014,9,15364,2511,17875
1,25,6,2,2014,10,15636,2835,18471
1,25,6,2,2014,11,15913,3144,19057
1,25,6,2,2014,12,15607,3229,18836
1,25,6,2,2014,13,15392,3223,18615
1,25,6,2,2014,14,15477,3133,18610
1,25,6,2,2014,15,15460,3194,18654
1,25,6,2,2014,16,15626,3225,18851
1,25,6,2,2014,17,15397,3194,18591
1,25,6,2,2014,18,14132,3106,17238
1,25,6,2,2014,19,13354,2940,16294
1,25,6,2,2014,20,14333,2918,17251
1,25,6,2,2014,21,14320,2828,17148
1,25,6,2,2014,22,14393,2743,17136
1,25,6,2,2014,23,14257,2714,16971
1,25,6,2,2014,24,14724,2678,17402
1,26,6,2,2014,1,14824,2487,17311
1,26,6,2,2014,2,14498,2283,16781
1,26,6,2,2014,3,14311,2151,16462
1,26,6,2,2014,4,14213,2052,16265
1,26,6,2,2014,5,14377,2016,16393
1,26,6,2,2014,6,14649,2040,16689
1,26,6,2,2014,7,15095,2083,17178
1,26,6,2,2014,8,15305,2178,17483
1,26,6,2,2014,9,15604,2469,18073
1,26,6,2,2014,10,15506,2892,18398
1,26,6,2,2014,11,15838,3185,19023
1,26,6,2,2014,12,15982,3215,19197
1,26,6,2,2014,13,15911,3220,19131
1,26,6,2,2014,14,15751,3151,18902
1,26,6,2,2014,15,15532,3219,18751
1,26,6,2,2014,16,15531,3223,18754
1,26,6,2,2014,17,15401,3216,18617
1,26,6,2,2014,18,14289,3104,17393
1,26,6,2,2014,19,13410,2963,16373
1,26,6,2,2014,20,14264,2944,17208
1,26,6,2,2014,21,14240,2930,17170
1,26,6,2,2014,22,14126,2825,16951
1,26,6,2,2014,23,14337,2727,17064
1,26,6,2,2014,24,13757,2716,16473
1,27,6,2,2014,1,14028,2543,16571
1,27,6,2,2014,2,14078,2317,16395
1,27,6,2,2014,3,13961,2186,16147
1,27,6,2,2014,4,14044,2155,16199
1,27,6,2,2014,5,14197,2061,16258
1,27,6,2,2014,6,14688,2066,16754
1,27,6,2,2014,7,14668,2095,16763
1,27,6,2,2014,8,14863,2203,17066
1,27,6,2,2014,9,15285,2518,17803
1,27,6,2,2014,10,15553,2896,18449
1,27,6,2,2014,11,15528,3062,18590
1,27,6,2,2014,12,15288,3246,18534
1,27,6,2,2014,13,15064,3245,18309
1,27,6,2,2014,14,14267,3166,17433
1,27,6,2,2014,15,14333,3213,17546
1,27,6,2,2014,16,15000,3241,18241
1,27,6,2,2014,17,14871,3237,18108
1,27,6,2,2014,18,13867,3131,16998
1,27,6,2,2014,19,13241,2948,16189
1,27,6,2,2014,20,13377,2914,16291
1,27,6,2,2014,21,14124,2886,17010
1,27,6,2,2014,22,13818,2805,16623
1,27,6,2,2014,23,13881,2761,16642
1,27,6,2,2014,24,13518,2688,16206
2,28,6,2,2014,1,14238,2548,16786
2,28,6,2,2014,2,14090,2340,16430
2,28,6,2,2014,3,14030,2207,16237
2,28,6,2,2014,4,14638,2104,16742
2,28,6,2,2014,5,14204,2052,16256
2,28,6,2,2014,6,14963,2080,17043
2,28,6,2,2014,7,15047,2058,17105
2,28,6,2,2014,8,15049,2121,17170
2,28,6,2,2014,9,15167,2341,17508
2,28,6,2,2014,10,15739,2657,18396
2,28,6,2,2014,11,15573,2949,18522
2,28,6,2,2014,12,15641,3010,18651
2,28,6,2,2014,13,15331,3017,18348
2,28,6,2,2014,14,15421,2952,18373
2,28,6,2,2014,15,15686,2991,18677
2,28,6,2,2014,16,15632,2989,18621
2,28,6,2,2014,17,15321,2913,18234
2,28,6,2,2014,18,14287,2823,17110
2,28,6,2,2014,19,13729,2718,16447
2,28,6,2,2014,20,14295,2755,17050
2,28,6,2,2014,21,14553,2772,17325
2,28,6,2,2014,22,13970,2710,16680
2,28,6,2,2014,23,14088,2672,16760
2,28,6,2,2014,24,13739,2665,16404
2,29,6,2,2014,1,14361,2522,16883
2,29,6,2,2014,2,14912,2368,17280
2,29,6,2,2014,3,14932,2228,17160
2,29,6,2,2014,4,14585,2131,16716
2,29,6,2,2014,5,14656,2071,16727
2,29,6,2,2014,6,15269,2073,17342
2,29,6,2,2014,7,15572,2010,17582
2,29,6,2,2014,8,15576,2008,17584
2,29,6,2,2014,9,15207,2076,17283
2,29,6,2,2014,10,15684,2167,17851
2,29,6,2,2014,11,15628,2278,17906
2,29,6,2,2014,12,16063,2328,18391
2,29,6,2,2014,13,15534,2367,17901
2,29,6,2,2014,14,15462,2368,17830
2,29,6,2,2014,15,15961,2351,18312
2,29,6,2,2014,16,15394,2336,17730
2,29,6,2,2014,17,15117,2314,17431
2,29,6,2,2014,18,13942,2258,16200
2,29,6,2,2014,19,13024,2227,15251
2,29,6,2,2014,20,13987,2417,16404
2,29,6,2,2014,21,14213,2506,16719
2,29,6,2,2014,22,14032,2554,16586
2,29,6,2,2014,23,13986,2607,16593
2,29,6,2,2014,24,14592,2608,17200
1,30,6,2,2014,1,14887,2530,17417
1,30,6,2,2014,2,14833,2328,17161
1,30,6,2,2014,3,14740,2200,16940
1,30,6,2,2014,4,14647,2102,16749
1,30,6,2,2014,5,14751,2081,16832
1,30,6,2,2014,6,15017,2107,17124
1,30,6,2,2014,7,15487,2112,17599
1,30,6,2,2014,8,15447,2215,17662
1,30,6,2,2014,9,15578,2515,18093
1,30,6,2,2014,10,15645,2915,18560
1,30,6,2,2014,11,16087,3178,19265
1,30,6,2,2014,12,16089,3251,19340
1,30,6,2,2014,13,16156,3249,19405
1,30,6,2,2014,14,15876,3177,19053
1,30,6,2,2014,15,16290,3247,19537
1,30,6,2,2014,16,16267,3248,19515
1,30,6,2,2014,17,15888,3251,19139
1,30,6,2,2014,18,14945,3144,18089
1,30,6,2,2014,19,13732,2928,16660
1,30,6,2,2014,20,14241,2816,17057
1,30,6,2,2014,21,14843,2844,17687
1,30,6,2,2014,22,14514,2792,17306
1,30,6,2,2014,23,14638,2803,17441
1,30,6,2,2014,24,14895,2770,17665
1,1,7,3,2014,1,15273,2586,17859
1,1,7,3,2014,2,15080,2364,17444
1,1,7,3,2014,3,14839,2223,17062
1,1,7,3,2014,4,14541,2111,16652
1,1,7,3,2014,5,14703,2072,16775
1,1,7,3,2014,6,14180,2106,16286
1,1,7,3,2014,7,15599,2122,17721
1,1,7,3,2014,8,15792,2220,18012
1,1,7,3,2014,9,15847,2598,18445
1,1,7,3,2014,10,15976,2886,18862
1,1,7,3,2014,11,16162,3073,19235
1,1,7,3,2014,12,15966,3249,19215
1,1,7,3,2014,13,16102,3239,19341
1,1,7,3,2014,14,15653,3168,18821
1,1,7,3,2014,15,15422,3251,18673
1,1,7,3,2014,16,16088,3257,19345
1,1,7,3,2014,17,15643,3236,18879
1,1,7,3,2014,18,14418,3131,17549
1,1,7,3,2014,19,13130,2933,16063
1,1,7,3,2014,20,14425,2875,17300
1,1,7,3,2014,21,14567,2840,17407
1,1,7,3,2014,22,14119,2790,16909
1,1,7,3,2014,23,14824,2788,17612
1,1,7,3,2014,24,14870,2770,17640
1,2,7,3,2014,1,15019,2583,17602
1,2,7,3,2014,2,14784,2397,17181
1,2,7,3,2014,3,14711,2257,16968
1,2,7,3,2014,4,14901,2153,17054
1,2,7,3,2014,5,14748,2102,16850
1,2,7,3,2014,6,15031,2096,17127
1,2,7,3,2014,7,15405,2096,17501
1,2,7,3,2014,8,15628,2185,17813
1,2,7,3,2014,9,15005,2451,17456
1,2,7,3,2014,10,15556,2886,18442
1,2,7,3,2014,11,15898,2926,18824
1,2,7,3,2014,12,15982,2912,18894
1,2,7,3,2014,13,15869,2869,18738
1,2,7,3,2014,14,15443,2802,18245
1,2,7,3,2014,15,15399,2814,18213
1,2,7,3,2014,16,15426,2784,18210
1,2,7,3,2014,17,15348,2772,18120
1,2,7,3,2014,18,13989,2734,16723
1,2,7,3,2014,19,13349,2637,15986
1,2,7,3,2014,20,13949,2665,16614
1,2,7,3,2014,21,14113,2527,16640
1,2,7,3,2014,22,14020,2405,16425
1,2,7,3,2014,23,14017,2292,16309
1,2,7,3,2014,24,14456,2228,16684
1,3,7,3,2014,1,14312,2045,16357
1,3,7,3,2014,2,14262,1923,16185
1,3,7,3,2014,3,14234,1719,15953
1,3,7,3,2014,4,14042,1685,15727
1,3,7,3,2014,5,14041,1728,15769
1,3,7,3,2014,6,14515,1759,16274
1,3,7,3,2014,7,14623,1873,16496
1,3,7,3,2014,8,14877,2048,16925
1,3,7,3,2014,9,14473,2319,16792
1,3,7,3,2014,10,15182,2618,17800
1,3,7,3,2014,11,15787,2823,18610
1,3,7,3,2014,12,15619,2864,18483
1,3,7,3,2014,13,15628,2852,18480
1,3,7,3,2014,14,15370,2750,18120
1,3,7,3,2014,15,14937,2724,17661
1,3,7,3,2014,16,15055,2715,17770
1,3,7,3,2014,17,14560,2755,17315
1,3,7,3,2014,18,13567,2719,16286
1,3,7,3,2014,19,12297,2665,14962
1,3,7,3,2014,20,13076,2609,15685
1,3,7,3,2014,21,13638,2537,16175
1,3,7,3,2014,22,13260,2413,15673
1,3,7,3,2014,23,13256,2294,15550
1,3,7,3,2014,24,13387,2128,15515
1,4,7,3,2014,1,14024,1919,15943
1,4,7,3,2014,2,13833,1764,15597
1,4,7,3,2014,3,13843,1686,15529
1,4,7,3,2014,4,13838,1643,15481
1,4,7,3,2014,5,13734,1643,15377
1,4,7,3,2014,6,14048,1718,15766
1,4,7,3,2014,7,15014,1826,16840
1,4,7,3,2014,8,14601,1967,16568
1,4,7,3,2014,9,15111,2260,17371
1,4,7,3,2014,10,14722,2627,17349
1,4,7,3,2014,11,14808,2859,17667
1,4,7,3,2014,12,14721,2938,17659
1,4,7,3,2014,13,14533,2944,17477
1,4,7,3,2014,14,14595,2930,17525
1,4,7,3,2014,15,14242,2909,17151
1,4,7,3,2014,16,14117,2932,17049
1,4,7,3,2014,17,13924,2941,16865
1,4,7,3,2014,18,13605,2873,16478
1,4,7,3,2014,19,13556,2772,16328
1,4,7,3,2014,20,13768,2722,16490
1,4,7,3,2014,21,13754,2670,16424
1,4,7,3,2014,22,13860,2591,16451
1,4,7,3,2014,23,13662,2452,16114
1,4,7,3,2014,24,13978,2336,16314
2,5,7,3,2014,1,14206,2172,16378
2,5,7,3,2014,2,13952,1982,15934
2,5,7,3,2014,3,14081,1880,15961
2,5,7,3,2014,4,14084,1815,15899
2,5,7,3,2014,5,13911,1792,15703
2,5,7,3,2014,6,14445,1849,16294
2,5,7,3,2014,7,14876,1878,16754
2,5,7,3,2014,8,15181,1976,17157
2,5,7,3,2014,9,15367,2227,17594
2,5,7,3,2014,10,15347,2548,17895
2,5,7,3,2014,11,15740,2832,18572
2,5,7,3,2014,12,15807,2883,18690
2,5,7,3,2014,13,15933,2873,18806
2,5,7,3,2014,14,15853,2803,18656
2,5,7,3,2014,15,15890,2824,18714
2,5,7,3,2014,16,15685,2813,18498
2,5,7,3,2014,17,15074,2773,17847
2,5,7,3,2014,18,14209,2691,16900
2,5,7,3,2014,19,13610,2610,16220
2,5,7,3,2014,20,14135,2634,16769
2,5,7,3,2014,21,14388,2629,17017
2,5,7,3,2014,22,13710,2581,16291
2,5,7,3,2014,23,13872,2474,16346
2,5,7,3,2014,24,14314,2444,16758
2,6,7,3,2014,1,14329,2253,16582
2,6,7,3,2014,2,14112,2117,16229
2,6,7,3,2014,3,14120,1982,16102
2,6,7,3,2014,4,13930,1908,15838
2,6,7,3,2014,5,14438,1883,16321
2,6,7,3,2014,6,14542,1904,16446
2,6,7,3,2014,7,14607,1850,16457
2,6,7,3,2014,8,15055,1883,16938
2,6,7,3,2014,9,14800,1976,16776
2,6,7,3,2014,10,15252,2103,17355
2,6,7,3,2014,11,15115,2216,17331
2,6,7,3,2014,12,15278,2264,17542
2,6,7,3,2014,13,15255,2238,17493
2,6,7,3,2014,14,15229,2209,17438
2,6,7,3,2014,15,15007,2205,17212
2,6,7,3,2014,16,15230,2197,17427
2,6,7,3,2014,17,14621,2166,16787
2,6,7,3,2014,18,13609,2135,15744
2,6,7,3,2014,19,12915,2138,15053
2,6,7,3,2014,20,13618,2265,15883
2,6,7,3,2014,21,14031,2357,16388
2,6,7,3,2014,22,13734,2415,16149
2,6,7,3,2014,23,13846,2425,16271
2,6,7,3,2014,24,13284,2439,15723
1,7,7,3,2014,1,14069,2293,16362
1,7,7,3,2014,2,13287,2082,15369
1,7,7,3,2014,3,13132,1967,15099
1,7,7,3,2014,4,13052,1910,14962
1,7,7,3,2014,5,13059,1883,14942
1,7,7,3,2014,6,13486,1952,15438
1,7,7,3,2014,7,14273,2016,16289
1,7,7,3,2014,8,14219,2148,16367
1,7,7,3,2014,9,14275,2476,16751
1,7,7,3,2014,10,14857,2774,17631
1,7,7,3,2014,11,14756,3061,17817
1,7,7,3,2014,12,14331,3099,17430
1,7,7,3,2014,13,14681,3048,17729
1,7,7,3,2014,14,14705,2943,17648
1,7,7,3,2014,15,14608,2894,17502
1,7,7,3,2014,16,14236,2904,17140
1,7,7,3,2014,17,14204,2809,17013
1,7,7,3,2014,18,13463,2761,16224
1,7,7,3,2014,19,13133,2686,15819
1,7,7,3,2014,20,13703,2651,16354
1,7,7,3,2014,21,13808,2577,16385
1,7,7,3,2014,22,13554,2519,16073
1,7,7,3,2014,23,13512,2421,15933
1,7,7,3,2014,24,13536,2324,15860
1,8,7,3,2014,1,13791,2086,15877
1,8,7,3,2014,2,13210,1911,15121
1,8,7,3,2014,3,13323,1795,15118
1,8,7,3,2014,4,13321,1748,15069
1,8,7,3,2014,5,13277,1739,15016
1,8,7,3,2014,6,13671,1809,15480
1,8,7,3,2014,7,14293,1852,16145
1,8,7,3,2014,8,14333,2019,16352
1,8,7,3,2014,9,14730,2348,17078
1,8,7,3,2014,10,14504,2691,17195
1,8,7,3,2014,11,14652,2896,17548
1,8,7,3,2014,12,15077,2989,18066
1,8,7,3,2014,13,15133,2990,18123
1,8,7,3,2014,14,14674,2915,17589
1,8,7,3,2014,15,15076,2926,18002
1,8,7,3,2014,16,14647,2867,17514
1,8,7,3,2014,17,14861,2877,17738
1,8,7,3,2014,18,13622,2851,16473
1,8,7,3,2014,19,13796,2741,16537
1,8,7,3,2014,20,13384,2704,16088
1,8,7,3,2014,21,14326,2692,17018
1,8,7,3,2014,22,12873,2596,15469
1,8,7,3,2014,23,13076,2494,15570
1,8,7,3,2014,24,13173,2368,15541
1,10,7,3,2014,1,12788,1978,14766
1,10,7,3,2014,2,12553,1823,14376
1,10,7,3,2014,3,12348,1754,14102
1,10,7,3,2014,4,12419,1706,14125
1,10,7,3,2014,5,12457,1706,14163
1,10,7,3,2014,6,12913,1774,14687
1,10,7,3,2014,7,13443,1878,15321
1,10,7,3,2014,8,13126,2033,15159
1,10,7,3,2014,9,13587,2302,15889
1,10,7,3,2014,10,14132,2597,16729
1,10,7,3,2014,11,14144,2843,16987
1,10,7,3,2014,12,14068,2890,16958
1,10,7,3,2014,13,14097,2848,16945
1,10,7,3,2014,14,13645,2781,16426
1,10,7,3,2014,15,13993,2767,16760
1,10,7,3,2014,16,14099,2769,16868
1,10,7,3,2014,17,13281,2717,15998
1,10,7,3,2014,18,12626,2692,15318
1,10,7,3,2014,19,12400,2606,15006
1,10,7,3,2014,20,13012,2596,15608
1,10,7,3,2014,21,13423,2525,15948
1,10,7,3,2014,22,13130,2412,15542
1,10,7,3,2014,23,12618,2255,14873
1,10,7,3,2014,24,12845,2115,14960
1,11,7,3,2014,1,12875,1903,14778
1,11,7,3,2014,2,12907,1763,14670
1,11,7,3,2014,3,12738,1682,14420
1,11,7,3,2014,4,12581,1646,14227
1,11,7,3,2014,5,13021,1644,14665
1,11,7,3,2014,6,12780,1719,14499
1,11,7,3,2014,7,13846,1823,15669
1,11,7,3,2014,8,14109,1957,16066
1,11,7,3,2014,9,13758,2238,15996
1,11,7,3,2014,10,13542,2544,16086
1,11,7,3,2014,11,13575,2730,16305
1,11,7,3,2014,12,13933,2783,16716
1,11,7,3,2014,13,13570,2802,16372
1,11,7,3,2014,14,13127,2659,15786
1,11,7,3,2014,15,13322,2676,15998
1,11,7,3,2014,16,13257,2648,15905
1,11,7,3,2014,17,12789,2635,15424
1,11,7,3,2014,18,12089,2628,14717
1,11,7,3,2014,19,11968,2548,14516
1,11,7,3,2014,20,13076,2496,15572
1,11,7,3,2014,21,12934,2404,15338
1,11,7,3,2014,22,12390,2263,14653
1,11,7,3,2014,23,12271,2137,14408
1,11,7,3,2014,24,12032,1906,13938
2,12,7,3,2014,1,11711,1755,13466
2,12,7,3,2014,2,11715,1632,13347
2,12,7,3,2014,3,11468,1562,13030
2,12,7,3,2014,4,11504,1524,13028
2,12,7,3,2014,5,11491,1540,13031
2,12,7,3,2014,6,12103,1618,13721
2,12,7,3,2014,7,12934,1690,14624
2,12,7,3,2014,8,12872,1791,14663
2,12,7,3,2014,9,13225,1994,15219
2,12,7,3,2014,10,13598,2280,15878
2,12,7,3,2014,11,13396,2476,15872
2,12,7,3,2014,12,13678,2519,16197
2,12,7,3,2014,13,13579,2513,16092
2,12,7,3,2014,14,13474,2396,15870
2,12,7,3,2014,15,13410,2363,15773
2,12,7,3,2014,16,13246,2334,15580
2,12,7,3,2014,17,13280,2352,15632
2,12,7,3,2014,18,12326,2361,14687
2,12,7,3,2014,19,12581,2368,14949
2,12,7,3,2014,20,13188,2376,15564
2,12,7,3,2014,21,13104,2380,15484
2,12,7,3,2014,22,13123,2251,15374
2,12,7,3,2014,23,12930,2089,15019
2,12,7,3,2014,24,13140,1924,15064
2,13,7,3,2014,1,12951,1763,14714
2,13,7,3,2014,2,12352,1634,13986
2,13,7,3,2014,3,12560,1569,14129
2,13,7,3,2014,4,12613,1540,14153
2,13,7,3,2014,5,12594,1539,14133
2,13,7,3,2014,6,13019,1575,14594
2,13,7,3,2014,7,13465,1601,15066
2,13,7,3,2014,8,13563,1671,15234
2,13,7,3,2014,9,13763,1786,15549
2,13,7,3,2014,10,14027,1922,15949
2,13,7,3,2014,11,13962,2047,16009
2,13,7,3,2014,12,14508,2110,16618
2,13,7,3,2014,13,14318,2129,16447
2,13,7,3,2014,14,13612,2059,15671
2,13,7,3,2014,15,13513,2006,15519
2,13,7,3,2014,16,13807,1962,15769
2,13,7,3,2014,17,13501,1955,15456
2,13,7,3,2014,18,12563,1985,14548
2,13,7,3,2014,19,12338,1999,14337
2,13,7,3,2014,20,13365,2129,15494
2,13,7,3,2014,21,13300,2198,15498
2,13,7,3,2014,22,12930,2158,15088
2,13,7,3,2014,23,12785,2097,14882
2,13,7,3,2014,24,12561,1965,14526
1,14,7,3,2014,1,12936,1839,14775
1,14,7,3,2014,2,12589,1707,14296
1,14,7,3,2014,3,12289,1638,13927
1,14,7,3,2014,4,12520,1608,14128
1,14,7,3,2014,5,12255,1605,13860
1,14,7,3,2014,6,12758,1701,14459
1,14,7,3,2014,7,13573,1830,15403
1,14,7,3,2014,8,13417,1996,15413
1,14,7,3,2014,9,14366,2298,16664
1,14,7,3,2014,10,13701,2635,16336
1,14,7,3,2014,11,13905,2879,16784
1,14,7,3,2014,12,13629,2921,16550
1,14,7,3,2014,13,14006,2908,16914
1,14,7,3,2014,14,13535,2815,16350
1,14,7,3,2014,15,13471,2829,16300
1,14,7,3,2014,16,13619,2849,16468
1,14,7,3,2014,17,12833,2788,15621
1,14,7,3,2014,18,12931,2754,15685
1,14,7,3,2014,19,12537,2654,15191
1,14,7,3,2014,20,13289,2610,15899
1,14,7,3,2014,21,13389,2504,15893
1,14,7,3,2014,22,12982,2402,15384
1,14,7,3,2014,23,13052,2253,15305
1,14,7,3,2014,24,12655,2101,14756
1,15,7,3,2014,1,12578,1886,14464
1,15,7,3,2014,2,12228,1744,13972
1,15,7,3,2014,3,12023,1664,13687
1,15,7,3,2014,4,12140,1628,13768
1,15,7,3,2014,5,12320,1629,13949
1,15,7,3,2014,6,12862,1732,14594
1,15,7,3,2014,7,13348,1858,15206
1,15,7,3,2014,8,14010,2015,16025
1,15,7,3,2014,9,13619,2299,15918
1,15,7,3,2014,10,13410,2621,16031
1,15,7,3,2014,11,13556,2855,16411
1,15,7,3,2014,12,13777,2881,16658
1,15,7,3,2014,13,13216,2847,16063
1,15,7,3,2014,14,12890,2699,15589
1,15,7,3,2014,15,12975,2698,15673
1,15,7,3,2014,16,12892,2671,15563
1,15,7,3,2014,17,12742,2651,15393
1,15,7,3,2014,18,12168,2646,14814
1,15,7,3,2014,19,12426,2583,15009
1,15,7,3,2014,20,12674,2538,15212
1,15,7,3,2014,21,13019,2465,15484
1,15,7,3,2014,22,12154,2324,14478
1,15,7,3,2014,23,11730,2182,13912
1,15,7,3,2014,24,11924,1979,13903
1,16,7,3,2014,1,11731,1808,13539
1,16,7,3,2014,2,10840,1660,12500
1,16,7,3,2014,3,11093,1601,12694
1,16,7,3,2014,4,11285,1582,12867
1,16,7,3,2014,5,11312,1595,12907
1,16,7,3,2014,6,11976,1691,13667
1,16,7,3,2014,7,12391,1811,14202
1,16,7,3,2014,8,12958,1987,14945
1,16,7,3,2014,9,12536,2339,14875
1,16,7,3,2014,10,12982,2612,15594
1,16,7,3,2014,11,13130,2788,15918
1,16,7,3,2014,12,12006,2812,14818
1,16,7,3,2014,13,12616,2794,15410
1,16,7,3,2014,14,11348,2696,14044
1,16,7,3,2014,15,12338,2711,15049
1,16,7,3,2014,16,12005,2713,14718
1,16,7,3,2014,17,12052,2727,14779
1,16,7,3,2014,18,11927,2697,14624
1,16,7,3,2014,19,12355,2649,15004
1,16,7,3,2014,20,12983,2607,15590
1,16,7,3,2014,21,13392,2520,15912
1,16,7,3,2014,22,12615,2391,15006
1,16,7,3,2014,23,12267,2232,14499
1,16,7,3,2014,24,11704,2078,13782
1,17,7,3,2014,1,11588,1900,13488
1,17,7,3,2014,2,11457,1726,13183
1,17,7,3,2014,3,11399,1656,13055
1,17,7,3,2014,4,11110,1629,12739
1,17,7,3,2014,5,11379,1637,13016
1,17,7,3,2014,6,12144,1729,13873
1,17,7,3,2014,7,12839,1861,14700
1,17,7,3,2014,8,13130,2042,15172
1,17,7,3,2014,9,13024,2336,15360
1,17,7,3,2014,10,12895,2646,15541
1,17,7,3,2014,11,12864,2857,15721
1,17,7,3,2014,12,12498,2885,15383
1,17,7,3,2014,13,12300,2880,15180
1,17,7,3,2014,14,11902,2808,14710
1,17,7,3,2014,15,12004,2831,14835
1,17,7,3,2014,16,12382,2826,15208
1,17,7,3,2014,17,12253,2787,15040
1,17,7,3,2014,18,11855,2729,14584
1,17,7,3,2014,19,12267,2683,14950
1,17,7,3,2014,20,12553,2630,15183
1,17,7,3,2014,21,13400,2532,15932
1,17,7,3,2014,22,12763,2432,15195
1,17,7,3,2014,23,12250,2287,14537
1,17,7,3,2014,24,12452,2116,14568
1,18,7,3,2014,1,12169,1917,14086
1,18,7,3,2014,2,12315,1762,14077
1,18,7,3,2014,3,11962,1680,13642
1,18,7,3,2014,4,12080,1647,13727
1,18,7,3,2014,5,12293,1656,13949
1,18,7,3,2014,6,12673,1751,14424
1,18,7,3,2014,7,13300,1880,15180
1,18,7,3,2014,8,13549,2047,15596
1,18,7,3,2014,9,13631,2349,15980
1,18,7,3,2014,10,13169,2677,15846
1,18,7,3,2014,11,13082,2898,15980
1,18,7,3,2014,12,12548,2944,15492
1,18,7,3,2014,13,12293,2933,15226
1,18,7,3,2014,14,11969,2823,14792
1,18,7,3,2014,15,11979,2806,14785
1,18,7,3,2014,16,11978,2794,14772
1,18,7,3,2014,17,11821,2793,14614
1,18,7,3,2014,18,11646,2766,14412
1,18,7,3,2014,19,12144,2704,14848
1,18,7,3,2014,20,12623,2690,15313
1,18,7,3,2014,21,12918,2618,15536
1,18,7,3,2014,22,12565,2470,15035
1,18,7,3,2014,23,12056,2345,14401
1,18,7,3,2014,24,12381,2186,14567
2,19,7,3,2014,1,12312,1966,14278
2,19,7,3,2014,2,11841,1824,13665
2,19,7,3,2014,3,11702,1739,13441
2,19,7,3,2014,4,11819,1689,13508
2,19,7,3,2014,5,11952,1693,13645
2,19,7,3,2014,6,12101,1780,13881
2,19,7,3,2014,7,13088,1851,14939
2,19,7,3,2014,8,13050,1969,15019
2,19,7,3,2014,9,13237,2216,15453
2,19,7,3,2014,10,13355,2572,15927
2,19,7,3,2014,11,13101,2763,15864
2,19,7,3,2014,12,12931,2798,15729
2,19,7,3,2014,13,12568,2803,15371
2,19,7,3,2014,14,12036,2734,14770
2,19,7,3,2014,15,12056,2659,14715
2,19,7,3,2014,16,12141,2659,14800
2,19,7,3,2014,17,12149,2608,14757
2,19,7,3,2014,18,12098,2559,14657
2,19,7,3,2014,19,11865,2523,14388
2,19,7,3,2014,20,12760,2608,15368
2,19,7,3,2014,21,12902,2569,15471
2,19,7,3,2014,22,12502,2386,14888
2,19,7,3,2014,23,12307,2313,14620
2,19,7,3,2014,24,11856,2180,14036
2,20,7,3,2014,1,11881,2006,13887
2,20,7,3,2014,2,11322,1842,13164
2,20,7,3,2014,3,11760,1754,13514
2,20,7,3,2014,4,11590,1708,13298
2,20,7,3,2014,5,11623,1706,13329
2,20,7,3,2014,6,12170,1753,13923
2,20,7,3,2014,7,12452,1764,14216
2,20,7,3,2014,8,12995,1809,14804
2,20,7,3,2014,9,13034,1901,14935
2,20,7,3,2014,10,13262,2040,15302
2,20,7,3,2014,11,12993,2160,15153
2,20,7,3,2014,12,12765,2187,14952
2,20,7,3,2014,13,12750,2175,14925
2,20,7,3,2014,14,11970,2133,14103
2,20,7,3,2014,15,12037,2096,14133
2,20,7,3,2014,16,12060,2046,14106
2,20,7,3,2014,17,11783,2034,13817
2,20,7,3,2014,18,11516,2046,13562
2,20,7,3,2014,19,11449,2073,13522
2,20,7,3,2014,20,12480,2221,14701
2,20,7,3,2014,21,12574,2267,14841
2,20,7,3,2014,22,12217,2264,14481
2,20,7,3,2014,23,11837,2256,14093
2,20,7,3,2014,24,11983,2208,14191
1,21,7,3,2014,1,11730,1981,13711
1,21,7,3,2014,2,11395,1839,13234
1,21,7,3,2014,3,11721,1766,13487
1,21,7,3,2014,4,11291,1727,13018
1,21,7,3,2014,5,11718,1731,13449
1,21,7,3,2014,6,12236,1808,14044
1,21,7,3,2014,7,12759,1881,14640
1,21,7,3,2014,8,13410,2008,15418
1,21,7,3,2014,9,13634,2350,15984
1,21,7,3,2014,10,13271,2681,15952
1,21,7,3,2014,11,13037,2888,15925
1,21,7,3,2014,12,12794,2947,15741
1,21,7,3,2014,13,12658,2942,15600
1,21,7,3,2014,14,12336,2906,15242
1,21,7,3,2014,15,12113,2940,15053
1,21,7,3,2014,16,12180,2931,15111
1,21,7,3,2014,17,11997,2919,14916
1,21,7,3,2014,18,11684,2840,14524
1,21,7,3,2014,19,11820,2750,14570
1,21,7,3,2014,20,12781,2718,15499
1,21,7,3,2014,21,12886,2615,15501
1,21,7,3,2014,22,12339,2471,14810
1,21,7,3,2014,23,12062,2397,14459
1,21,7,3,2014,24,11860,2243,14103
1,22,7,3,2014,1,11581,2039,13620
1,22,7,3,2014,2,11534,1876,13410
1,22,7,3,2014,3,11424,1802,13226
1,22,7,3,2014,4,11431,1755,13186
1,22,7,3,2014,5,11922,1751,13673
1,22,7,3,2014,6,12065,1843,13908
1,22,7,3,2014,7,12673,1936,14609
1,22,7,3,2014,8,12747,2116,14863
1,22,7,3,2014,9,13348,2385,15733
1,22,7,3,2014,10,12335,2766,15101
1,22,7,3,2014,11,12770,2930,15700
1,22,7,3,2014,12,12446,2985,15431
1,22,7,3,2014,13,11945,2926,14871
1,22,7,3,2014,14,11883,2893,14776
1,22,7,3,2014,15,11909,2845,14754
1,22,7,3,2014,16,11314,2869,14183
1,22,7,3,2014,17,11796,2812,14608
1,22,7,3,2014,18,11799,2795,14594
1,22,7,3,2014,19,11840,2742,14582
1,22,7,3,2014,20,12308,2705,15013
1,22,7,3,2014,21,12405,2613,15018
1,22,7,3,2014,22,11880,2448,14328
1,22,7,3,2014,23,11813,2415,14228
1,22,7,3,2014,24,11397,2237,13634
1,23,7,3,2014,1,11566,2050,13616
1,23,7,3,2014,2,10280,1886,12166
1,23,7,3,2014,3,10467,1811,12278
1,23,7,3,2014,4,10500,1765,12265
1,23,7,3,2014,5,10291,1760,12051
1,23,7,3,2014,6,10489,1853,12342
1,23,7,3,2014,7,11227,1945,13172
1,23,7,3,2014,8,11347,2127,13474
1,23,7,3,2014,9,11392,2394,13786
1,23,7,3,2014,10,11720,2694,14414
1,23,7,3,2014,11,11681,2908,14589
1,23,7,3,2014,12,11201,2961,14162
1,23,7,3,2014,13,11024,2941,13965
1,23,7,3,2014,14,10682,2817,13499
1,23,7,3,2014,15,10617,2836,13453
1,23,7,3,2014,16,10722,2830,13552
1,23,7,3,2014,17,10950,2818,13768
1,23,7,3,2014,18,11073,2772,13845
1,23,7,3,2014,19,11366,2736,14102
1,23,7,3,2014,20,12170,2693,14863
1,23,7,3,2014,21,12216,2604,14820
1,23,7,3,2014,22,11674,2467,14141
1,23,7,3,2014,23,11166,2333,13499
1,23,7,3,2014,24,10600,2202,12802
1,24,7,3,2014,1,10629,1969,12598
1,24,7,3,2014,2,10593,1824,12417
1,24,7,3,2014,3,10577,1746,12323
1,24,7,3,2014,4,10647,1692,12339
1,24,7,3,2014,5,10449,1682,12131
1,24,7,3,2014,6,10999,1774,12773
1,24,7,3,2014,7,11672,1933,13605
1,24,7,3,2014,8,12129,2093,14222
1,24,7,3,2014,9,12374,2389,14763
1,24,7,3,2014,10,12101,2728,14829
1,24,7,3,2014,11,11807,2996,14803
1,24,7,3,2014,12,11599,2989,14588
1,24,7,3,2014,13,11352,2982,14334
1,24,7,3,2014,14,11354,2884,14238
1,24,7,3,2014,15,11196,2922,14118
1,24,7,3,2014,16,11105,2927,14032
1,24,7,3,2014,17,11401,2924,14325
1,24,7,3,2014,18,10972,2874,13846
1,24,7,3,2014,19,11457,2731,14188
1,24,7,3,2014,20,12537,2691,15228
1,24,7,3,2014,21,12916,2604,15520
1,24,7,3,2014,22,12574,2502,15076
1,24,7,3,2014,23,12083,2421,14504
1,24,7,3,2014,24,11642,2327,13969
1,25,7,3,2014,1,11411,2032,13443
1,25,7,3,2014,2,11272,1868,13140
1,25,7,3,2014,3,11165,1793,12958
1,25,7,3,2014,4,11247,1747,12994
1,25,7,3,2014,5,11608,1742,13350
1,25,7,3,2014,6,11747,1835,13582
1,25,7,3,2014,7,12757,1928,14685
1,25,7,3,2014,8,12750,2108,14858
1,25,7,3,2014,9,12760,2497,15257
1,25,7,3,2014,10,12497,2767,15264
1,25,7,3,2014,11,12016,3000,15016
1,25,7,3,2014,12,12155,3012,15167
1,25,7,3,2014,13,11957,3005,14962
1,25,7,3,2014,14,11720,2922,14642
1,25,7,3,2014,15,11233,2952,14185
1,25,7,3,2014,16,11701,2988,14689
1,25,7,3,2014,17,11480,2976,14456
1,25,7,3,2014,18,11429,2872,14301
1,25,7,3,2014,19,11408,2762,14170
1,25,7,3,2014,20,12581,2764,15345
1,25,7,3,2014,21,12869,2703,15572
1,25,7,3,2014,22,12218,2515,14733
1,25,7,3,2014,23,12089,2396,14485
1,25,7,3,2014,24,11689,2254,13943
2,26,7,3,2014,1,11534,2124,13658
2,26,7,3,2014,2,11485,1966,13451
2,26,7,3,2014,3,11122,1872,12994
2,26,7,3,2014,4,11015,1810,12825
2,26,7,3,2014,5,11562,1810,13372
2,26,7,3,2014,6,11631,1846,13477
2,26,7,3,2014,7,12507,1945,14452
2,26,7,3,2014,8,12799,1996,14795
2,26,7,3,2014,9,13161,2162,15323
2,26,7,3,2014,10,12943,2508,15451
2,26,7,3,2014,11,13429,2769,16198
2,26,7,3,2014,12,12709,2814,15523
2,26,7,3,2014,13,12778,2810,15588
2,26,7,3,2014,14,12360,2709,15069
2,26,7,3,2014,15,12386,2713,15099
2,26,7,3,2014,16,12272,2685,14957
2,26,7,3,2014,17,12573,2638,15211
2,26,7,3,2014,18,11739,2600,14339
2,26,7,3,2014,19,12054,2542,14596
2,26,7,3,2014,20,12816,2593,15409
2,26,7,3,2014,21,13227,2575,15802
2,26,7,3,2014,22,12558,2496,15054
2,26,7,3,2014,23,12202,2360,14562
2,26,7,3,2014,24,12233,2290,14523
2,27,7,3,2014,1,11979,2056,14035
2,27,7,3,2014,2,12070,1946,14016
2,27,7,3,2014,3,11492,1846,13338
2,27,7,3,2014,4,11772,1792,13564
2,27,7,3,2014,5,11634,1758,13392
2,27,7,3,2014,6,12196,1802,13998
2,27,7,3,2014,7,12462,1796,14258
2,27,7,3,2014,8,12890,1841,14731
2,27,7,3,2014,9,13469,1954,15423
2,27,7,3,2014,10,13301,2076,15377
2,27,7,3,2014,11,13093,2170,15263
2,27,7,3,2014,12,12882,2217,15099
2,27,7,3,2014,13,12473,2207,14680
2,27,7,3,2014,14,12524,2099,14623
2,27,7,3,2014,15,12265,2028,14293
2,27,7,3,2014,16,12251,1986,14237
2,27,7,3,2014,17,11851,1976,13827
2,27,7,3,2014,18,11523,2035,13558
2,27,7,3,2014,19,11849,2102,13951
2,27,7,3,2014,20,12136,2217,14353
2,27,7,3,2014,21,11957,2224,14181
2,27,7,3,2014,22,11888,2231,14119
2,27,7,3,2014,23,11783,2193,13976
2,27,7,3,2014,24,11176,2061,13237
1,28,7,3,2014,1,10848,1871,12719
1,28,7,3,2014,2,11216,1745,12961
1,28,7,3,2014,3,11107,1667,12774
1,28,7,3,2014,4,11231,1626,12857
1,28,7,3,2014,5,11240,1649,12889
1,28,7,3,2014,6,11757,1735,13492
1,28,7,3,2014,7,12581,1878,14459
1,28,7,3,2014,8,12823,2044,14867
1,28,7,3,2014,9,12865,2333,15198
1,28,7,3,2014,10,12564,2663,15227
1,28,7,3,2014,11,12692,2884,15576
1,28,7,3,2014,12,12209,2936,15145
1,28,7,3,2014,13,11773,2862,14635
1,28,7,3,2014,14,11996,2762,14758
1,28,7,3,2014,15,11873,2778,14651
1,28,7,3,2014,16,12074,2769,14843
1,28,7,3,2014,17,11698,2717,14415
1,28,7,3,2014,18,11459,2695,14154
1,28,7,3,2014,19,11747,2618,14365
1,28,7,3,2014,20,12367,2628,14995
1,28,7,3,2014,21,12316,2547,14863
1,28,7,3,2014,22,12009,2385,14394
1,28,7,3,2014,23,11428,2285,13713
1,28,7,3,2014,24,11510,2081,13591
3,29,7,3,2014,1,11089,1895,12984
3,29,7,3,2014,2,10989,1770,12759
3,29,7,3,2014,3,10792,1707,12499
3,29,7,3,2014,4,10660,1642,12302
3,29,7,3,2014,5,11157,1630,12787
3,29,7,3,2014,6,11646,1716,13362
3,29,7,3,2014,7,12098,1786,13884
3,29,7,3,2014,8,12559,1887,14446
3,29,7,3,2014,9,12660,2115,14775
3,29,7,3,2014,10,12557,2412,14969
3,29,7,3,2014,11,12035,2582,14617
3,29,7,3,2014,12,11759,2611,14370
3,29,7,3,2014,13,11544,2603,14147
3,29,7,3,2014,14,11282,2484,13766
3,29,7,3,2014,15,11318,2429,13747
3,29,7,3,2014,16,11229,2380,13609
3,29,7,3,2014,17,11509,2362,13871
3,29,7,3,2014,18,11030,2385,13415
3,29,7,3,2014,19,11926,2374,14300
3,29,7,3,2014,20,12307,2450,14757
3,29,7,3,2014,21,12027,2430,14457
3,29,7,3,2014,22,11919,2253,14172
3,29,7,3,2014,23,11357,2156,13513
3,29,7,3,2014,24,10884,2029,12913
1,30,7,3,2014,1,10480,1891,12371
1,30,7,3,2014,2,10689,1731,12420
1,30,7,3,2014,3,10651,1647,12298
1,30,7,3,2014,4,10389,1613,12002
1,30,7,3,2014,5,10317,1619,11936
1,30,7,3,2014,6,11102,1711,12813
1,30,7,3,2014,7,11883,1860,13743
1,30,7,3,2014,8,11780,2085,13865
1,30,7,3,2014,9,12035,2309,14344
1,30,7,3,2014,10,11746,2679,14425
1,30,7,3,2014,11,11956,2836,14792
1,30,7,3,2014,12,11507,2877,14384
1,30,7,3,2014,13,11517,2858,14375
1,30,7,3,2014,14,11054,2760,13814
1,30,7,3,2014,15,11436,2775,14211
1,30,7,3,2014,16,11245,2770,14015
1,30,7,3,2014,17,11140,2740,13880
1,30,7,3,2014,18,11308,2706,14014
1,30,7,3,2014,19,11816,2652,14468
1,30,7,3,2014,20,12745,2661,15406
1,30,7,3,2014,21,12461,2612,15073
1,30,7,3,2014,22,12085,2333,14418
1,30,7,3,2014,23,11642,2285,13927
1,30,7,3,2014,24,11385,2101,13486
1,31,7,3,2014,1,11440,1915,13355
1,31,7,3,2014,2,11044,1767,12811
1,31,7,3,2014,3,11136,1683,12819
1,31,7,3,2014,4,10917,1644,12561
1,31,7,3,2014,5,10811,1643,12454
1,31,7,3,2014,6,11352,1737,13089
1,31,7,3,2014,7,12123,1921,14044
1,31,7,3,2014,8,12348,2090,14438
1,31,7,3,2014,9,12323,2366,14689
1,31,7,3,2014,10,12165,2636,14801
1,31,7,3,2014,11,12044,2821,14865
1,31,7,3,2014,12,12015,2852,14867
1,31,7,3,2014,13,11791,2838,14629
1,31,7,3,2014,14,11219,2704,13923
1,31,7,3,2014,15,11114,2714,13828
1,31,7,3,2014,16,11362,2679,14041
1,31,7,3,2014,17,11365,2652,14017
1,31,7,3,2014,18,10943,2619,13562
1,31,7,3,2014,19,11517,2574,14091
1,31,7,3,2014,20,12557,2526,15083
1,31,7,3,2014,21,12651,2434,15085
1,31,7,3,2014,22,11923,2337,14260
1,31,7,3,2014,23,11568,2202,13770
1,31,7,3,2014,24,11438,2046,13484
1,1,8,3,2014,1,11135,1844,12979
1,1,8,3,2014,2,11168,1693,12861
1,1,8,3,2014,3,10817,1626,12443
1,1,8,3,2014,4,10962,1591,12553
1,1,8,3,2014,5,11164,1609,12773
1,1,8,3,2014,6,11589,1726,13315
1,1,8,3,2014,7,12269,1916,14185
1,1,8,3,2014,8,12415,2066,14481
1,1,8,3,2014,9,12266,2319,14585
1,1,8,3,2014,10,12340,2692,15032
1,1,8,3,2014,11,12087,2897,14984
1,1,8,3,2014,12,12054,2948,15002
1,1,8,3,2014,13,11520,2940,14460
1,1,8,3,2014,14,11264,2836,14100
1,1,8,3,2014,15,11077,2835,13912
1,1,8,3,2014,16,11140,2829,13969
1,1,8,3,2014,17,10948,2794,13742
1,1,8,3,2014,18,10609,2772,13381
1,1,8,3,2014,19,10600,2673,13273
1,1,8,3,2014,20,11843,2673,14516
1,1,8,3,2014,21,12239,2551,14790
1,1,8,3,2014,22,11455,2399,13854
1,1,8,3,2014,23,11510,2241,13751
1,1,8,3,2014,24,11539,2135,13674
2,2,8,3,2014,1,11279,1854,13133
2,2,8,3,2014,2,11031,1721,12752
2,2,8,3,2014,3,10794,1669,12463
2,2,8,3,2014,4,11158,1617,12775
2,2,8,3,2014,5,10966,1623,12589
2,2,8,3,2014,6,11754,1701,13455
2,2,8,3,2014,7,12037,1837,13874
2,2,8,3,2014,8,12280,2010,14290
2,2,8,3,2014,9,12493,2233,14726
2,2,8,3,2014,10,12486,2547,15033
2,2,8,3,2014,11,12108,2768,14876
2,2,8,3,2014,12,12290,2771,15061
2,2,8,3,2014,13,12182,2767,14949
2,2,8,3,2014,14,11705,2610,14315
2,2,8,3,2014,15,11721,2583,14304
2,2,8,3,2014,16,11780,2514,14294
2,2,8,3,2014,17,11728,2483,14211
2,2,8,3,2014,18,11255,2479,13734
2,2,8,3,2014,19,11464,2476,13940
2,2,8,3,2014,20,12668,2529,15197
2,2,8,3,2014,21,12590,2463,15053
2,2,8,3,2014,22,12350,2346,14696
2,2,8,3,2014,23,11638,2166,13804
2,2,8,3,2014,24,11768,2018,13786
2,3,8,3,2014,1,11414,1848,13262
2,3,8,3,2014,2,11169,1715,12884
2,3,8,3,2014,3,11222,1639,12861
2,3,8,3,2014,4,11156,1583,12739
2,3,8,3,2014,5,11331,1575,12906
2,3,8,3,2014,6,11947,1645,13592
2,3,8,3,2014,7,12323,1676,13999
2,3,8,3,2014,8,12690,1752,14442
2,3,8,3,2014,9,13033,1868,14901
2,3,8,3,2014,10,12670,2012,14682
2,3,8,3,2014,11,12769,2125,14894
2,3,8,3,2014,12,12574,2154,14728
2,3,8,3,2014,13,12161,2155,14316
2,3,8,3,2014,14,11909,2087,13996
2,3,8,3,2014,15,12075,2038,14113
2,3,8,3,2014,16,11655,1979,13634
2,3,8,3,2014,17,11726,1959,13685
2,3,8,3,2014,18,11121,1984,13105
2,3,8,3,2014,19,11538,2018,13556
2,3,8,3,2014,20,12416,2118,14534
2,3,8,3,2014,21,12447,2173,14620
2,3,8,3,2014,22,12199,2176,14375
2,3,8,3,2014,23,11953,2095,14048
2,3,8,3,2014,24,11656,1972,13628
1,4,8,3,2014,1,11722,1814,13536
1,4,8,3,2014,2,11637,1672,13309
1,4,8,3,2014,3,11482,1597,13079
1,4,8,3,2014,4,11458,1559,13017
1,4,8,3,2014,5,11743,1571,13314
1,4,8,3,2014,6,12016,1681,13697
1,4,8,3,2014,7,12601,1851,14452
1,4,8,3,2014,8,12802,2030,14832
1,4,8,3,2014,9,13191,2329,15520
1,4,8,3,2014,10,13086,2661,15747
1,4,8,3,2014,11,12883,2839,15722
1,4,8,3,2014,12,12677,2881,15558
1,4,8,3,2014,13,12543,2876,15419
1,4,8,3,2014,14,12067,2785,14852
1,4,8,3,2014,15,12154,2780,14934
1,4,8,3,2014,16,11937,2747,14684
1,4,8,3,2014,17,11818,2725,14543
1,4,8,3,2014,18,11353,2706,14059
1,4,8,3,2014,19,11852,2634,14486
1,4,8,3,2014,20,12250,2607,14857
1,4,8,3,2014,21,12384,2505,14889
1,4,8,3,2014,22,12167,2367,14534
1,4,8,3,2014,23,11859,2171,14030
1,4,8,3,2014,24,11600,2021,13621
1,5,8,3,2014,1,11147,1864,13011
1,5,8,3,2014,2,10907,1734,12641
1,5,8,3,2014,3,10895,1665,12560
1,5,8,3,2014,4,10772,1629,12401
1,5,8,3,2014,5,11249,1641,12890
1,5,8,3,2014,6,11340,1745,13085
1,5,8,3,2014,7,12320,1906,14226
1,5,8,3,2014,8,12324,2053,14377
1,5,8,3,2014,9,12658,2367,15025
1,5,8,3,2014,10,12197,2621,14818
1,5,8,3,2014,11,12153,2871,15024
1,5,8,3,2014,12,12004,2906,14910
1,5,8,3,2014,13,11690,2903,14593
1,5,8,3,2014,14,11297,2833,14130
1,5,8,3,2014,15,11361,2823,14184
1,5,8,3,2014,16,11298,2855,14153
1,5,8,3,2014,17,11324,2835,14159
1,5,8,3,2014,18,11482,2783,14265
1,5,8,3,2014,19,11847,2702,14549
1,5,8,3,2014,20,12654,2737,15391
1,5,8,3,2014,21,12615,2636,15251
1,5,8,3,2014,22,12260,2424,14684
1,5,8,3,2014,23,12042,2273,14315
1,5,8,3,2014,24,11629,2104,13733
1,6,8,3,2014,1,11167,1902,13069
1,6,8,3,2014,2,11141,1761,12902
1,6,8,3,2014,3,11115,1680,12795
1,6,8,3,2014,4,11095,1643,12738
1,6,8,3,2014,5,11186,1641,12827
1,6,8,3,2014,6,11925,1751,13676
1,6,8,3,2014,7,12510,1915,14425
1,6,8,3,2014,8,12798,2083,14881
1,6,8,3,2014,9,12923,2372,15295
1,6,8,3,2014,10,12560,2693,15253
1,6,8,3,2014,11,12626,2904,15530
1,6,8,3,2014,12,11800,2933,14733
1,6,8,3,2014,13,11910,2900,14810
1,6,8,3,2014,14,11557,2838,14395
1,6,8,3,2014,15,11682,2864,14546
1,6,8,3,2014,16,11655,2848,14503
1,6,8,3,2014,17,11040,2820,13860
1,6,8,3,2014,18,11488,2801,14289
1,6,8,3,2014,19,11638,2699,14337
1,6,8,3,2014,20,12706,2711,15417
1,6,8,3,2014,21,12637,2597,15234
1,6,8,3,2014,22,12463,2429,14892
1,6,8,3,2014,23,12042,2306,14348
1,6,8,3,2014,24,11539,2145,13684
1,7,8,3,2014,1,11408,1886,13294
1,7,8,3,2014,2,11110,1747,12857
1,7,8,3,2014,3,11262,1694,12956
1,7,8,3,2014,4,11419,1649,13068
1,7,8,3,2014,5,11249,1618,12867
1,7,8,3,2014,6,12016,1714,13730
1,7,8,3,2014,7,12526,1943,14469
1,7,8,3,2014,8,12745,2093,14838
1,7,8,3,2014,9,12716,2360,15076
1,7,8,3,2014,10,12980,2695,15675
1,7,8,3,2014,11,12599,2935,15534
1,7,8,3,2014,12,12525,3009,15534
1,7,8,3,2014,13,12133,2945,15078
1,7,8,3,2014,14,11797,2869,14666
1,7,8,3,2014,15,11793,2776,14569
1,7,8,3,2014,16,11799,2864,14663
1,7,8,3,2014,17,11441,2816,14257
1,7,8,3,2014,18,11456,2763,14219
1,7,8,3,2014,19,11510,2700,14210
1,7,8,3,2014,20,12928,2724,15652
1,7,8,3,2014,21,12718,2623,15341
1,7,8,3,2014,22,12052,2428,14480
1,7,8,3,2014,23,11993,2287,14280
1,7,8,3,2014,24,11740,2125,13865
1,8,8,3,2014,1,11754,1921,13675
1,8,8,3,2014,2,11318,1763,13081
1,8,8,3,2014,3,11640,1667,13307
1,8,8,3,2014,4,11398,1632,13030
1,8,8,3,2014,5,11510,1635,13145
1,8,8,3,2014,6,12185,1749,13934
1,8,8,3,2014,7,12446,1920,14366
1,8,8,3,2014,8,12977,2097,15074
1,8,8,3,2014,9,12928,2371,15299
1,8,8,3,2014,10,12473,2739,15212
1,8,8,3,2014,11,12593,2957,15550
1,8,8,3,2014,12,12049,2965,15014
1,8,8,3,2014,13,12136,2965,15101
1,8,8,3,2014,14,11749,2858,14607
1,8,8,3,2014,15,11694,2865,14559
1,8,8,3,2014,16,11684,2887,14571
1,8,8,3,2014,17,11477,2859,14336
1,8,8,3,2014,18,11102,2802,13904
1,8,8,3,2014,19,11257,2714,13971
1,8,8,3,2014,20,12698,2734,15432
1,8,8,3,2014,21,12731,2641,15372
1,8,8,3,2014,22,12316,2505,14821
1,8,8,3,2014,23,12085,2305,14390
1,8,8,3,2014,24,12112,2165,14277
2,9,8,3,2014,1,11672,1963,13635
2,9,8,3,2014,2,11743,1794,13537
2,9,8,3,2014,3,11417,1711,13128
2,9,8,3,2014,4,11427,1655,13082
2,9,8,3,2014,5,11496,1652,13148
2,9,8,3,2014,6,12167,1739,13906
2,9,8,3,2014,7,12719,1836,14555
2,9,8,3,2014,8,13108,1960,15068
2,9,8,3,2014,9,13214,2176,15390
2,9,8,3,2014,10,13575,2481,16056
2,9,8,3,2014,11,13802,2706,16508
2,9,8,3,2014,12,13440,2737,16177
2,9,8,3,2014,13,13270,2734,16004
2,9,8,3,2014,14,13114,2643,15757
2,9,8,3,2014,15,12759,2611,15370
2,9,8,3,2014,16,12872,2592,15464
2,9,8,3,2014,17,12675,2595,15270
2,9,8,3,2014,18,11782,2571,14353
2,9,8,3,2014,19,11663,2547,14210
2,9,8,3,2014,20,12567,2629,15196
2,9,8,3,2014,21,12879,2550,15429
2,9,8,3,2014,22,12766,2426,15192
2,9,8,3,2014,23,12697,2294,14991
2,9,8,3,2014,24,12373,2145,14518
2,10,8,3,2014,1,12334,1987,14321
2,10,8,3,2014,2,12012,1811,13823
2,10,8,3,2014,3,11925,1724,13649
2,10,8,3,2014,4,11698,1651,13349
2,10,8,3,2014,5,11741,1652,13393
2,10,8,3,2014,6,12237,1700,13937
2,10,8,3,2014,7,12604,1735,14339
2,10,8,3,2014,8,12908,1811,14719
2,10,8,3,2014,9,13223,1945,15168
2,10,8,3,2014,10,13767,2061,15828
2,10,8,3,2014,11,13688,2143,15831
2,10,8,3,2014,12,13247,2144,15391
2,10,8,3,2014,13,12955,2152,15107
2,10,8,3,2014,14,12875,2074,14949
2,10,8,3,2014,15,12554,2021,14575
2,10,8,3,2014,16,12549,1972,14521
2,10,8,3,2014,17,12269,1957,14226
2,10,8,3,2014,18,11590,1956,13546
2,10,8,3,2014,19,11394,2017,13411
2,10,8,3,2014,20,12257,2179,14436
2,10,8,3,2014,21,12579,2215,14794
2,10,8,3,2014,22,11961,2205,14166
2,10,8,3,2014,23,11947,2159,14106
2,10,8,3,2014,24,12002,2071,14073
1,11,8,3,2014,1,11846,1927,13773
1,11,8,3,2014,2,11793,1773,13566
1,11,8,3,2014,3,11648,1697,13345
1,11,8,3,2014,4,11714,1644,13358
1,11,8,3,2014,5,12004,1634,13638
1,11,8,3,2014,6,12159,1747,13906
1,11,8,3,2014,7,13143,1900,15043
1,11,8,3,2014,8,13411,2065,15476
1,11,8,3,2014,9,13525,2336,15861
1,11,8,3,2014,10,13768,2735,16503
1,11,8,3,2014,11,13446,2956,16402
1,11,8,3,2014,12,13830,2989,16819
1,11,8,3,2014,13,13475,2982,16457
1,11,8,3,2014,14,13259,2879,16138
1,11,8,3,2014,15,13406,2895,16301
1,11,8,3,2014,16,13591,2864,16455
1,11,8,3,2014,17,13340,2880,16220
1,11,8,3,2014,18,12017,2822,14839
1,11,8,3,2014,19,12389,2720,15109
1,11,8,3,2014,20,13392,2715,16107
1,11,8,3,2014,21,13197,2629,15826
1,11,8,3,2014,22,13051,2467,15518
1,11,8,3,2014,23,12819,2326,15145
1,11,8,3,2014,24,12418,2193,14611
1,12,8,3,2014,1,12267,1991,14258
1,12,8,3,2014,2,12330,1828,14158
1,12,8,3,2014,3,12428,1750,14178
1,12,8,3,2014,4,12328,1696,14024
1,12,8,3,2014,5,12377,1696,14073
1,12,8,3,2014,6,12814,1797,14611
1,12,8,3,2014,7,13512,1961,15473
1,12,8,3,2014,8,14088,2104,16192
1,12,8,3,2014,9,13994,2414,16408
1,12,8,3,2014,10,14044,2740,16784
1,12,8,3,2014,11,13901,2987,16888
1,12,8,3,2014,12,14020,3008,17028
1,12,8,3,2014,13,13860,3003,16863
1,12,8,3,2014,14,13514,2855,16369
1,12,8,3,2014,15,13479,2881,16360
1,12,8,3,2014,16,13427,2875,16302
1,12,8,3,2014,17,13239,2830,16069
1,12,8,3,2014,18,12193,2771,14964
1,12,8,3,2014,19,12263,2715,14978
1,12,8,3,2014,20,13400,2792,16192
1,12,8,3,2014,21,13358,2626,15984
1,12,8,3,2014,22,12976,2505,15481
1,12,8,3,2014,23,12689,2372,15061
1,12,8,3,2014,24,12658,2139,14797
1,13,8,3,2014,1,12737,1979,14716
1,13,8,3,2014,2,12510,1823,14333
1,13,8,3,2014,3,12613,1745,14358
1,13,8,3,2014,4,12159,1702,13861
1,13,8,3,2014,5,12336,1708,14044
1,13,8,3,2014,6,13057,1808,14865
1,13,8,3,2014,7,13795,1967,15762
1,13,8,3,2014,8,14064,2127,16191
1,13,8,3,2014,9,14442,2443,16885
1,13,8,3,2014,10,14483,2768,17251
1,13,8,3,2014,11,14326,2975,17301
1,13,8,3,2014,12,14115,3023,17138
1,13,8,3,2014,13,13899,3010,16909
1,13,8,3,2014,14,13907,2901,16808
1,13,8,3,2014,15,13718,2930,16648
1,13,8,3,2014,16,13693,2935,16628
1,13,8,3,2014,17,13581,2901,16482
1,13,8,3,2014,18,12687,2847,15534
1,13,8,3,2014,19,12680,2767,15447
1,13,8,3,2014,20,13676,2790,16466
1,13,8,3,2014,21,13202,2692,15894
1,13,8,3,2014,22,12730,2529,15259
1,13,8,3,2014,23,12294,2375,14669
1,13,8,3,2014,24,12307,2235,14542
1,14,8,3,2014,1,12776,2027,14803
1,14,8,3,2014,2,12457,1855,14312
1,14,8,3,2014,3,12517,1763,14280
1,14,8,3,2014,4,12171,1715,13886
1,14,8,3,2014,5,12261,1714,13975
1,14,8,3,2014,6,13093,1823,14916
1,14,8,3,2014,7,13834,1973,15807
1,14,8,3,2014,8,14070,2144,16214
1,14,8,3,2014,9,14252,2444,16696
1,14,8,3,2014,10,14336,2818,17154
1,14,8,3,2014,11,14031,3010,17041
1,14,8,3,2014,12,13911,3042,16953
1,14,8,3,2014,13,13682,3033,16715
1,14,8,3,2014,14,13368,2924,16292
1,14,8,3,2014,15,13655,2896,16551
1,14,8,3,2014,16,13408,2859,16267
1,14,8,3,2014,17,13246,2839,16085
1,14,8,3,2014,18,12265,2776,15041
1,14,8,3,2014,19,12697,2716,15413
1,14,8,3,2014,20,13593,2729,16322
1,14,8,3,2014,21,13551,2629,16180
1,14,8,3,2014,22,13152,2500,15652
1,14,8,3,2014,23,12897,2317,15214
1,14,8,3,2014,24,13007,2181,15188
3,15,8,3,2014,1,12737,1986,14723
3,15,8,3,2014,2,12396,1820,14216
3,15,8,3,2014,3,12480,1719,14199
3,15,8,3,2014,4,12345,1662,14007
3,15,8,3,2014,5,12726,1662,14388
3,15,8,3,2014,6,13438,1731,15169
3,15,8,3,2014,7,14168,1794,15962
3,15,8,3,2014,8,13609,1849,15458
3,15,8,3,2014,9,13201,1966,15167
3,15,8,3,2014,10,12603,2063,14666
3,15,8,3,2014,11,12773,2136,14909
3,15,8,3,2014,12,12707,2173,14880
3,15,8,3,2014,13,12591,2198,14789
3,15,8,3,2014,14,12106,2112,14218
3,15,8,3,2014,15,12193,2056,14249
3,15,8,3,2014,16,12372,2036,14408
3,15,8,3,2014,17,11603,2015,13618
3,15,8,3,2014,18,10737,2034,12771
3,15,8,3,2014,19,10746,2115,12861
3,15,8,3,2014,20,11877,2217,14094
3,15,8,3,2014,21,11955,2281,14236
3,15,8,3,2014,22,11485,2241,13726
3,15,8,3,2014,23,11678,2118,13796
3,15,8,3,2014,24,11750,2028,13778
2,16,8,3,2014,1,11443,1899,13342
2,16,8,3,2014,2,11604,1746,13350
2,16,8,3,2014,3,11488,1665,13153
2,16,8,3,2014,4,11471,1612,13083
2,16,8,3,2014,5,11498,1611,13109
2,16,8,3,2014,6,12091,1709,13800
2,16,8,3,2014,7,12743,1789,14532
2,16,8,3,2014,8,13260,1918,15178
2,16,8,3,2014,9,13835,2164,15999
2,16,8,3,2014,10,14143,2496,16639
2,16,8,3,2014,11,13974,2719,16693
2,16,8,3,2014,12,13920,2767,16687
2,16,8,3,2014,13,14159,2746,16905
2,16,8,3,2014,14,13802,2634,16436
2,16,8,3,2014,15,13798,2606,16404
2,16,8,3,2014,16,13723,2595,16318
2,16,8,3,2014,17,13430,2559,15989
2,16,8,3,2014,18,12691,2508,15199
2,16,8,3,2014,19,12034,2491,14525
2,16,8,3,2014,20,13133,2571,15704
2,16,8,3,2014,21,13415,2528,15943
2,16,8,3,2014,22,12888,2406,15294
2,16,8,3,2014,23,13056,2236,15292
2,16,8,3,2014,24,12703,2172,14875
2,17,8,3,2014,1,13217,1996,15213
2,17,8,3,2014,2,12670,1823,14493
2,17,8,3,2014,3,12766,1727,14493
2,17,8,3,2014,4,12423,1662,14085
2,17,8,3,2014,5,12505,1650,14155
2,17,8,3,2014,6,13019,1713,14732
2,17,8,3,2014,7,13943,1741,15684
2,17,8,3,2014,8,14666,1821,16487
2,17,8,3,2014,9,14940,1938,16878
2,17,8,3,2014,10,14692,2087,16779
2,17,8,3,2014,11,15247,2222,17469
2,17,8,3,2014,12,15351,2237,17588
2,17,8,3,2014,13,14609,2226,16835
2,17,8,3,2014,14,14822,2141,16963
2,17,8,3,2014,15,14680,2123,16803
2,17,8,3,2014,16,14644,2092,16736
2,17,8,3,2014,17,14457,2043,16500
2,17,8,3,2014,18,12789,2037,14826
2,17,8,3,2014,19,12306,2066,14372
2,17,8,3,2014,20,13444,2251,15695
2,17,8,3,2014,21,14025,2307,16332
2,17,8,3,2014,22,12916,2294,15210
2,17,8,3,2014,23,13112,2218,15330
2,17,8,3,2014,24,12917,2150,15067
3,18,8,3,2014,1,13185,2006,15191
3,18,8,3,2014,2,12796,1869,14665
3,18,8,3,2014,3,12848,1757,14605
3,18,8,3,2014,4,12683,1703,14386
3,18,8,3,2014,5,12725,1683,14408
3,18,8,3,2014,6,13184,1749,14933
3,18,8,3,2014,7,14046,1806,15852
3,18,8,3,2014,8,14433,1948,16381
3,18,8,3,2014,9,14676,2207,16883
3,18,8,3,2014,10,14883,2461,17344
3,18,8,3,2014,11,14768,2658,17426
3,18,8,3,2014,12,14958,2657,17615
3,18,8,3,2014,13,14677,2652,17329
3,18,8,3,2014,14,14655,2562,17217
3,18,8,3,2014,15,14404,2519,16923
3,18,8,3,2014,16,14801,2479,17280
3,18,8,3,2014,17,14329,2431,16760
3,18,8,3,2014,18,13110,2375,15485
3,18,8,3,2014,19,12696,2332,15028
3,18,8,3,2014,20,13331,2438,15769
3,18,8,3,2014,21,13617,2430,16047
3,18,8,3,2014,22,13158,2372,15530
3,18,8,3,2014,23,13183,2296,15479
3,18,8,3,2014,24,13062,2190,15252
1,19,8,3,2014,1,13297,1996,15293
1,19,8,3,2014,2,13018,1836,14854
1,19,8,3,2014,3,12967,1742,14709
1,19,8,3,2014,4,12830,1697,14527
1,19,8,3,2014,5,13250,1693,14943
1,19,8,3,2014,6,13468,1795,15263
1,19,8,3,2014,7,14274,1962,16236
1,19,8,3,2014,8,14503,2113,16616
1,19,8,3,2014,9,14897,2385,17282
1,19,8,3,2014,10,14698,2790,17488
1,19,8,3,2014,11,14412,3015,17427
1,19,8,3,2014,12,14852,3039,17891
1,19,8,3,2014,13,14958,3022,17980
1,19,8,3,2014,14,14696,2910,17606
1,19,8,3,2014,15,14829,2938,17767
1,19,8,3,2014,16,15124,2942,18066
1,19,8,3,2014,17,14845,2939,17784
1,19,8,3,2014,18,13538,2884,16422
1,19,8,3,2014,19,13285,2804,16089
1,19,8,3,2014,20,14150,2800,16950
1,19,8,3,2014,21,13895,2682,16577
1,19,8,3,2014,22,13837,2579,16416
1,19,8,3,2014,23,13733,2410,16143
1,19,8,3,2014,24,13341,2260,15601
1,20,8,3,2014,1,13086,2095,15181
1,20,8,3,2014,2,12930,1919,14849
1,20,8,3,2014,3,12905,1823,14728
1,20,8,3,2014,4,12814,1778,14592
1,20,8,3,2014,5,12762,1756,14518
1,20,8,3,2014,6,13339,1842,15181
1,20,8,3,2014,7,13769,1971,15740
1,20,8,3,2014,8,14216,2198,16414
1,20,8,3,2014,9,14317,2479,16796
1,20,8,3,2014,10,14801,2792,17593
1,20,8,3,2014,11,14534,3037,17571
1,20,8,3,2014,12,14276,3046,17322
1,20,8,3,2014,13,14055,3013,17068
1,20,8,3,2014,14,14247,2918,17165
1,20,8,3,2014,15,14235,2914,17149
1,20,8,3,2014,16,14459,2937,17396
1,20,8,3,2014,17,14106,2925,17031
1,20,8,3,2014,18,13552,2887,16439
1,20,8,3,2014,19,13387,2801,16188
1,20,8,3,2014,20,13954,2824,16778
1,20,8,3,2014,21,13860,2746,16606
1,20,8,3,2014,22,13654,2599,16253
1,20,8,3,2014,23,13201,2456,15657
1,20,8,3,2014,24,13090,2301,15391
1,21,8,3,2014,1,12952,2146,15098
1,21,8,3,2014,2,12938,1970,14908
1,21,8,3,2014,3,12973,1855,14828
1,21,8,3,2014,4,12784,1798,14582
1,21,8,3,2014,5,13094,1772,14866
1,21,8,3,2014,6,13215,1866,15081
1,21,8,3,2014,7,13500,1960,15460
1,21,8,3,2014,8,13754,2072,15826
1,21,8,3,2014,9,14566,2429,16995
1,21,8,3,2014,10,14940,2756,17696
1,21,8,3,2014,11,14896,3003,17899
1,21,8,3,2014,12,15218,3069,18287
1,21,8,3,2014,13,14863,3056,17919
1,21,8,3,2014,14,14259,2944,17203
1,21,8,3,2014,15,14329,2975,17304
1,21,8,3,2014,16,13957,2982,16939
1,21,8,3,2014,17,13528,2965,16493
1,21,8,3,2014,18,13054,2924,15978
1,21,8,3,2014,19,13339,2846,16185
1,21,8,3,2014,20,13474,2833,16307
1,21,8,3,2014,21,13178,2707,15885
1,21,8,3,2014,22,13296,2590,15886
1,21,8,3,2014,23,12829,2457,15286
1,21,8,3,2014,24,12213,2325,14538
1,22,8,3,2014,1,12449,2102,14551
1,22,8,3,2014,2,12376,1919,14295
1,22,8,3,2014,3,12265,1825,14090
1,22,8,3,2014,4,11899,1772,13671
1,22,8,3,2014,5,11929,1772,13701
1,22,8,3,2014,6,12554,1862,14416
1,22,8,3,2014,7,12574,2010,14584
1,22,8,3,2014,8,12829,2164,14993
1,22,8,3,2014,9,13203,2447,15650
1,22,8,3,2014,10,13369,2798,16167
1,22,8,3,2014,11,13208,3002,16210
1,22,8,3,2014,12,13063,3070,16133
1,22,8,3,2014,13,12614,3031,15645
1,22,8,3,2014,14,12477,2896,15373
1,22,8,3,2014,15,12424,2901,15325
1,22,8,3,2014,16,12638,2898,15536
1,22,8,3,2014,17,12362,2887,15249
1,22,8,3,2014,18,12069,2865,14934
1,22,8,3,2014,19,12249,2815,15064
1,22,8,3,2014,20,13179,2811,15990
1,22,8,3,2014,21,13364,2599,15963
1,22,8,3,2014,22,12955,2543,15498
1,22,8,3,2014,23,12460,2452,14912
1,22,8,3,2014,24,12183,2231,14414
2,23,8,3,2014,1,12021,2052,14073
2,23,8,3,2014,2,11973,1876,13849
2,23,8,3,2014,3,11656,1779,13435
2,23,8,3,2014,4,11849,1724,13573
2,23,8,3,2014,5,12041,1750,13791
2,23,8,3,2014,6,12416,1835,14251
2,23,8,3,2014,7,12718,1897,14615
2,23,8,3,2014,8,12834,2013,14847
2,23,8,3,2014,9,12882,2257,15139
2,23,8,3,2014,10,13492,2559,16051
2,23,8,3,2014,11,13379,2809,16188
2,23,8,3,2014,12,13447,2892,16339
2,23,8,3,2014,13,13297,2887,16184
2,23,8,3,2014,14,13288,2789,16077
2,23,8,3,2014,15,13104,2804,15908
2,23,8,3,2014,16,13285,2783,16068
2,23,8,3,2014,17,13115,2732,15847
2,23,8,3,2014,18,12037,2728,14765
2,23,8,3,2014,19,12515,2741,15256
2,23,8,3,2014,20,13335,2740,16075
2,23,8,3,2014,21,13553,2584,16137
2,23,8,3,2014,22,12916,2397,15313
2,23,8,3,2014,23,12729,2335,15064
2,23,8,3,2014,24,11760,2255,14015
2,24,8,3,2014,1,12004,2040,14044
2,24,8,3,2014,2,11697,1880,13577
2,24,8,3,2014,3,11620,1785,13405
2,24,8,3,2014,4,11424,1720,13144
2,24,8,3,2014,5,11641,1708,13349
2,24,8,3,2014,6,11981,1770,13751
2,24,8,3,2014,7,12370,1763,14133
2,24,8,3,2014,8,12379,1842,14221
2,24,8,3,2014,9,12684,1958,14642
2,24,8,3,2014,10,13272,2109,15381
2,24,8,3,2014,11,13232,2236,15468
2,24,8,3,2014,12,13701,2238,15939
2,24,8,3,2014,13,13524,2325,15849
2,24,8,3,2014,14,13053,2251,15304
2,24,8,3,2014,15,13172,2209,15381
2,24,8,3,2014,16,13292,2178,15470
2,24,8,3,2014,17,13203,2129,15332
2,24,8,3,2014,18,12606,2128,14734
2,24,8,3,2014,19,12403,2170,14573
2,24,8,3,2014,20,13131,2325,15456
2,24,8,3,2014,21,12962,2366,15328
2,24,8,3,2014,22,12725,2376,15101
2,24,8,3,2014,23,12416,2334,14750
2,24,8,3,2014,24,12076,2250,14326
1,25,8,3,2014,1,11925,2031,13956
1,25,8,3,2014,2,11858,1860,13718
1,25,8,3,2014,3,11637,1758,13395
1,25,8,3,2014,4,11577,1694,13271
1,25,8,3,2014,5,11576,1687,13263
1,25,8,3,2014,6,12283,1776,14059
1,25,8,3,2014,7,12330,1976,14306
1,25,8,3,2014,8,12700,2130,14830
1,25,8,3,2014,9,13063,2437,15500
1,25,8,3,2014,10,13454,2776,16230
1,25,8,3,2014,11,13659,3007,16666
1,25,8,3,2014,12,13778,3052,16830
1,25,8,3,2014,13,13707,3049,16756
1,25,8,3,2014,14,13583,2930,16513
1,25,8,3,2014,15,13357,2944,16301
1,25,8,3,2014,16,13147,2940,16087
1,25,8,3,2014,17,12933,2916,15849
1,25,8,3,2014,18,12416,2851,15267
1,25,8,3,2014,19,12583,2803,15386
1,25,8,3,2014,20,12669,2798,15467
1,25,8,3,2014,21,12876,2674,15550
1,25,8,3,2014,22,12549,2538,15087
1,25,8,3,2014,23,12000,2418,14418
1,25,8,3,2014,24,12096,2257,14353
1,27,8,3,2014,1,11854,1924,13778
1,27,8,3,2014,2,11178,1776,12954
1,27,8,3,2014,3,11100,1690,12790
1,27,8,3,2014,4,10971,1637,12608
1,27,8,3,2014,5,11226,1648,12874
1,27,8,3,2014,6,11694,1752,13446
1,27,8,3,2014,7,12241,1908,14149
1,27,8,3,2014,8,12233,2053,14286
1,27,8,3,2014,9,12428,2310,14738
1,27,8,3,2014,10,12435,2644,15079
1,27,8,3,2014,11,12078,2857,14935
1,27,8,3,2014,12,12330,2908,15238
1,27,8,3,2014,13,11762,2905,14667
1,27,8,3,2014,14,11768,2748,14516
1,27,8,3,2014,15,11591,2726,14317
1,27,8,3,2014,16,11749,2759,14508
1,27,8,3,2014,17,11945,2742,14687
1,27,8,3,2014,18,11703,2718,14421
1,27,8,3,2014,19,12495,2669,15164
1,27,8,3,2014,20,13062,2717,15779
1,27,8,3,2014,21,12776,2611,15387
1,27,8,3,2014,22,12245,2460,14705
1,27,8,3,2014,23,12080,2316,14396
1,27,8,3,2014,24,11778,2154,13932
1,28,8,3,2014,1,11355,1971,13326
1,28,8,3,2014,2,11091,1815,12906
1,28,8,3,2014,3,10963,1709,12672
1,28,8,3,2014,4,10609,1658,12267
1,28,8,3,2014,5,10600,1655,12255
1,28,8,3,2014,6,10867,1747,12614
1,28,8,3,2014,7,11929,1897,13826
1,28,8,3,2014,8,11730,2067,13797
1,28,8,3,2014,9,11969,2366,14335
1,28,8,3,2014,10,12187,2666,14853
1,28,8,3,2014,11,11549,2853,14402
1,28,8,3,2014,12,11427,2888,14315
1,28,8,3,2014,13,11343,2807,14150
1,28,8,3,2014,14,10956,2744,13700
1,28,8,3,2014,15,10993,2751,13744
1,28,8,3,2014,16,11394,2753,14147
1,28,8,3,2014,17,11549,2719,14268
1,28,8,3,2014,18,11660,2677,14337
1,28,8,3,2014,19,12126,2639,14765
1,28,8,3,2014,20,12865,2692,15557
1,28,8,3,2014,21,12754,2585,15339
1,28,8,3,2014,22,12412,2485,14897
1,28,8,3,2014,23,12139,2360,14499
1,28,8,3,2014,24,11569,2224,13793
3,29,8,3,2014,1,11220,1968,13188
3,29,8,3,2014,2,11080,1814,12894
3,29,8,3,2014,3,10817,1689,12506
3,29,8,3,2014,4,10794,1657,12451
3,29,8,3,2014,5,10667,1677,12344
3,29,8,3,2014,6,10925,1764,12689
3,29,8,3,2014,7,11074,1801,12875
3,29,8,3,2014,8,11338,1867,13205
3,29,8,3,2014,9,11152,1996,13148
3,29,8,3,2014,10,11258,2137,13395
3,29,8,3,2014,11,11183,2255,13438
3,29,8,3,2014,12,11293,2257,13550
3,29,8,3,2014,13,10979,2265,13244
3,29,8,3,2014,14,10586,2158,12744
3,29,8,3,2014,15,10025,2139,12164
3,29,8,3,2014,16,10218,2142,12360
3,29,8,3,2014,17,10140,2132,12272
3,29,8,3,2014,18,9987,2209,12196
3,29,8,3,2014,19,11165,2306,13471
3,29,8,3,2014,20,11773,2411,14184
3,29,8,3,2014,21,11993,2418,14411
3,29,8,3,2014,22,11676,2387,14063
3,29,8,3,2014,23,11162,2298,13460
3,29,8,3,2014,24,10970,2185,13155
2,30,8,3,2014,1,10518,2015,12533
2,30,8,3,2014,2,10347,1860,12207
2,30,8,3,2014,3,10360,1731,12091
2,30,8,3,2014,4,10406,1681,12087
2,30,8,3,2014,5,10570,1688,12258
2,30,8,3,2014,6,10717,1751,12468
2,30,8,3,2014,7,11381,1823,13204
2,30,8,3,2014,8,11450,1954,13404
2,30,8,3,2014,9,11780,2185,13965
2,30,8,3,2014,10,11742,2499,14241
2,30,8,3,2014,11,11541,2712,14253
2,30,8,3,2014,12,11584,2749,14333
2,30,8,3,2014,13,11390,2731,14121
2,30,8,3,2014,14,10877,2592,13469
2,30,8,3,2014,15,11231,2604,13835
2,30,8,3,2014,16,11014,2592,13606
2,30,8,3,2014,17,11318,2526,13844
2,30,8,3,2014,18,11566,2478,14044
2,30,8,3,2014,19,12137,2502,14639
2,30,8,3,2014,20,12813,2622,15435
2,30,8,3,2014,21,12797,2560,15357
2,30,8,3,2014,22,12219,2448,14667
2,30,8,3,2014,23,11601,2310,13911
2,30,8,3,2014,24,10876,2176,13052
2,31,8,3,2014,1,10984,2009,12993
2,31,8,3,2014,2,10809,1853,12662
2,31,8,3,2014,3,10856,1763,12619
2,31,8,3,2014,4,10874,1709,12583
2,31,8,3,2014,5,11052,1683,12735
2,31,8,3,2014,6,11271,1750,13021
2,31,8,3,2014,7,11566,1767,13333
2,31,8,3,2014,8,11793,1805,13598
2,31,8,3,2014,9,12291,1927,14218
2,31,8,3,2014,10,11761,2079,13840
2,31,8,3,2014,11,11820,2203,14023
2,31,8,3,2014,12,11516,2239,13755
2,31,8,3,2014,13,11280,2237,13517
2,31,8,3,2014,14,11029,2125,13154
2,31,8,3,2014,15,10932,2071,13003
2,31,8,3,2014,16,10924,2002,12926
2,31,8,3,2014,17,10772,1997,12769
2,31,8,3,2014,18,10954,2051,13005
2,31,8,3,2014,19,11755,2123,13878
2,31,8,3,2014,20,12517,2248,14765
2,31,8,3,2014,21,12296,2267,14563
2,31,8,3,2014,22,11907,2227,14134
2,31,8,3,2014,23,11043,2178,13221
2,31,8,3,2014,24,10757,2052,12809
1,1,9,3,2014,1,10109,1849,11958
1,1,9,3,2014,2,9955,1740,11695
1,1,9,3,2014,3,10089,1676,11765
1,1,9,3,2014,4,9649,1627,11276
1,1,9,3,2014,5,10147,1636,11783
1,1,9,3,2014,6,10733,1721,12454
1,1,9,3,2014,7,11325,1842,13167
1,1,9,3,2014,8,11848,1991,13839
1,1,9,3,2014,9,12151,2228,14379
1,1,9,3,2014,10,11723,2581,14304
1,1,9,3,2014,11,11482,2780,14262
1,1,9,3,2014,12,10926,2851,13777
1,1,9,3,2014,13,10877,2833,13710
1,1,9,3,2014,14,10853,2715,13568
1,1,9,3,2014,15,10618,2684,13302
1,1,9,3,2014,16,10786,2647,13433
1,1,9,3,2014,17,10877,2659,13536
1,1,9,3,2014,18,10754,2665,13419
1,1,9,3,2014,19,12051,2648,14699
1,1,9,3,2014,20,12263,2690,14953
1,1,9,3,2014,21,12264,2557,14821
1,1,9,3,2014,22,11732,2407,14139
1,1,9,3,2014,23,11516,2228,13744
1,1,9,3,2014,24,10817,2081,12898
1,2,9,3,2014,1,10855,1923,12778
1,2,9,3,2014,2,10383,1765,12148
1,2,9,3,2014,3,10334,1678,12012
1,2,9,3,2014,4,10150,1624,11774
1,2,9,3,2014,5,10297,1633,11930
1,2,9,3,2014,6,11171,1705,12876
1,2,9,3,2014,7,12084,1815,13899
1,2,9,3,2014,8,12145,2003,14148
1,2,9,3,2014,9,12571,2294,14865
1,2,9,3,2014,10,12103,2623,14726
1,2,9,3,2014,11,12140,2573,14713
1,2,9,3,2014,12,11638,2621,14259
1,2,9,3,2014,13,11372,2618,13990
1,2,9,3,2014,14,11024,2532,13556
1,2,9,3,2014,15,10791,2558,13349
1,2,9,3,2014,16,11004,2555,13559
1,2,9,3,2014,17,11329,2538,13867
1,2,9,3,2014,18,11466,2547,14013
1,2,9,3,2014,19,12131,2503,14634
1,2,9,3,2014,20,13100,2578,15678
1,2,9,3,2014,21,13000,2482,15482
1,2,9,3,2014,22,12499,2442,14941
1,2,9,3,2014,23,12020,2311,14331
1,2,9,3,2014,24,11455,2138,13593
1,3,9,3,2014,1,10856,1943,12799
1,3,9,3,2014,2,10734,1775,12509
1,3,9,3,2014,3,10458,1696,12154
1,3,9,3,2014,4,10469,1629,12098
1,3,9,3,2014,5,10955,1614,12569
1,3,9,3,2014,6,11555,1729,13284
1,3,9,3,2014,7,12216,1888,14104
1,3,9,3,2014,8,12386,2053,14439
1,3,9,3,2014,9,12576,2378,14954
1,3,9,3,2014,10,12525,2651,15176
1,3,9,3,2014,11,12682,2926,15608
1,3,9,3,2014,12,11947,2946,14893
1,3,9,3,2014,13,11794,2931,14725
1,3,9,3,2014,14,11544,2794,14338
1,3,9,3,2014,15,11703,2808,14511
1,3,9,3,2014,16,11614,2800,14414
1,3,9,3,2014,17,11544,2757,14301
1,3,9,3,2014,18,11546,2722,14268
1,3,9,3,2014,19,12187,2727,14914
1,3,9,3,2014,20,13034,2777,15811
1,3,9,3,2014,21,12852,2633,15485
1,3,9,3,2014,22,12358,2505,14863
1,3,9,3,2014,23,12017,2335,14352
1,3,9,3,2014,24,11682,2179,13861
1,4,9,3,2014,1,11197,2008,13205
1,4,9,3,2014,2,10842,1831,12673
1,4,9,3,2014,3,10942,1735,12677
1,4,9,3,2014,4,10734,1686,12420
1,4,9,3,2014,5,11228,1685,12913
1,4,9,3,2014,6,11500,1783,13283
1,4,9,3,2014,7,12310,1923,14233
1,4,9,3,2014,8,12578,2075,14653
1,4,9,3,2014,9,12882,2374,15256
1,4,9,3,2014,10,12874,2693,15567
1,4,9,3,2014,11,12427,2951,15378
1,4,9,3,2014,12,12115,3002,15117
1,4,9,3,2014,13,11750,2973,14723
1,4,9,3,2014,14,11493,2833,14326
1,4,9,3,2014,15,11484,2854,14338
1,4,9,3,2014,16,11464,2847,14311
1,4,9,3,2014,17,11233,2790,14023
1,4,9,3,2014,18,10988,2751,13739
1,4,9,3,2014,19,11716,2695,14411
1,4,9,3,2014,20,12946,2733,15679
1,4,9,3,2014,21,12789,2623,15412
1,4,9,3,2014,22,12415,2465,14880
1,4,9,3,2014,23,12169,2329,14498
1,4,9,3,2014,24,11544,2180,13724
1,5,9,3,2014,1,11185,2001,13186
1,5,9,3,2014,2,11351,1841,13192
1,5,9,3,2014,3,10849,1748,12597
1,5,9,3,2014,4,10899,1694,12593
1,5,9,3,2014,5,11058,1685,12743
1,5,9,3,2014,6,11866,1787,13653
1,5,9,3,2014,7,12616,1904,14520
1,5,9,3,2014,8,12871,2075,14946
1,5,9,3,2014,9,12707,2332,15039
1,5,9,3,2014,10,12452,2733,15185
1,5,9,3,2014,11,11904,2947,14851
1,5,9,3,2014,12,12070,3017,15087
1,5,9,3,2014,13,11566,2963,14529
1,5,9,3,2014,14,11453,2824,14277
1,5,9,3,2014,15,11275,2823,14098
1,5,9,3,2014,16,11243,2786,14029
1,5,9,3,2014,17,11267,2806,14073
1,5,9,3,2014,18,10913,2786,13699
1,5,9,3,2014,19,11749,2803,14552
1,5,9,3,2014,20,12970,2779,15749
1,5,9,3,2014,21,12719,2654,15373
1,5,9,3,2014,22,12333,2488,14821
1,5,9,3,2014,23,11538,2347,13885
1,5,9,3,2014,24,11092,2160,13252
2,6,9,3,2014,1,10944,2004,12948
2,6,9,3,2014,2,10785,1828,12613
2,6,9,3,2014,3,10736,1736,12472
2,6,9,3,2014,4,10508,1684,12192
2,6,9,3,2014,5,10701,1684,12385
2,6,9,3,2014,6,11338,1775,13113
2,6,9,3,2014,7,11996,1872,13868
2,6,9,3,2014,8,12234,1995,14229
2,6,9,3,2014,9,12408,2255,14663
2,6,9,3,2014,10,12319,2560,14879
2,6,9,3,2014,11,12076,2798,14874
2,6,9,3,2014,12,12026,2849,14875
2,6,9,3,2014,13,11828,2848,14676
2,6,9,3,2014,14,11531,2738,14269
2,6,9,3,2014,15,11588,2713,14301
2,6,9,3,2014,16,11642,2688,14330
2,6,9,3,2014,17,11356,2648,14004
2,6,9,3,2014,18,11303,2603,13906
2,6,9,3,2014,19,11731,2653,14384
2,6,9,3,2014,20,13065,2717,15782
2,6,9,3,2014,21,12741,2621,15362
2,6,9,3,2014,22,12491,2469,14960
2,6,9,3,2014,23,11582,2322,13904
2,6,9,3,2014,24,11557,2205,13762
2,7,9,3,2014,1,10908,2061,12969
2,7,9,3,2014,2,10498,1889,12387
2,7,9,3,2014,3,10710,1788,12498
2,7,9,3,2014,4,10556,1718,12274
2,7,9,3,2014,5,10976,1709,12685
2,7,9,3,2014,6,11434,1770,13204
2,7,9,3,2014,7,12008,1793,13801
2,7,9,3,2014,8,12041,1841,13882
2,7,9,3,2014,9,12789,1964,14753
2,7,9,3,2014,10,12515,2116,14631
2,7,9,3,2014,11,12271,2255,14526
2,7,9,3,2014,12,11876,2289,14165
2,7,9,3,2014,13,11675,2327,14002
2,7,9,3,2014,14,11210,2233,13443
2,7,9,3,2014,15,10860,2198,13058
2,7,9,3,2014,16,10762,2153,12915
2,7,9,3,2014,17,10988,2102,13090
2,7,9,3,2014,18,10617,2109,12726
2,7,9,3,2014,19,11641,2201,13842
2,7,9,3,2014,20,11817,2363,14180
2,7,9,3,2014,21,11813,2356,14169
2,7,9,3,2014,22,11390,2347,13737
2,7,9,3,2014,23,11268,2293,13561
2,7,9,3,2014,24,10887,2198,13085
1,8,9,3,2014,1,10504,2046,12550
1,8,9,3,2014,2,10251,1915,12166
1,8,9,3,2014,3,10220,1821,12041
1,8,9,3,2014,4,10162,1737,11899
1,8,9,3,2014,5,10398,1717,12115
1,8,9,3,2014,6,10858,1787,12645
1,8,9,3,2014,7,11683,1870,13553
1,8,9,3,2014,8,11854,2033,13887
1,8,9,3,2014,9,12091,2317,14408
1,8,9,3,2014,10,11947,2590,14537
1,8,9,3,2014,11,11356,2764,14120
1,8,9,3,2014,12,11128,2770,13898
1,8,9,3,2014,13,10796,2766,13562
1,8,9,3,2014,14,10219,2581,12800
1,8,9,3,2014,15,10188,2492,12680
1,8,9,3,2014,16,9944,2381,12325
1,8,9,3,2014,17,10086,2238,12324
1,8,9,3,2014,18,9765,2174,11939
1,8,9,3,2014,19,10571,2172,12743
1,8,9,3,2014,20,11456,2239,13695
1,8,9,3,2014,21,11193,2201,13394
1,8,9,3,2014,22,10729,2198,12927
1,8,9,3,2014,23,10497,2170,12667
1,8,9,3,2014,24,10211,2089,12300
1,9,9,3,2014,1,10066,1971,12037
1,9,9,3,2014,2,9859,1854,11713
1,9,9,3,2014,3,9496,1750,11246
1,9,9,3,2014,4,9400,1696,11096
1,9,9,3,2014,5,9569,1694,11263
1,9,9,3,2014,6,10518,1790,12308
1,9,9,3,2014,7,11396,1935,13331
1,9,9,3,2014,8,11710,2055,13765
1,9,9,3,2014,9,12192,2368,14560
1,9,9,3,2014,10,12048,2659,14707
1,9,9,3,2014,11,11869,2899,14768
1,9,9,3,2014,12,11688,2908,14596
1,9,9,3,2014,13,11223,2875,14098
1,9,9,3,2014,14,10729,2745,13474
1,9,9,3,2014,15,10995,2786,13781
1,9,9,3,2014,16,11007,2782,13789
1,9,9,3,2014,17,11043,2766,13809
1,9,9,3,2014,18,10825,2764,13589
1,9,9,3,2014,19,11700,2723,14423
1,9,9,3,2014,20,12868,2764,15632
1,9,9,3,2014,21,12404,2623,15027
1,9,9,3,2014,22,11804,2428,14232
1,9,9,3,2014,23,11494,2278,13772
1,9,9,3,2014,24,11360,2147,13507
1,10,9,3,2014,1,10983,1942,12925
1,10,9,3,2014,2,10708,1787,12495
1,10,9,3,2014,3,10599,1705,12304
1,10,9,3,2014,4,10646,1654,12300
1,10,9,3,2014,5,10704,1659,12363
1,10,9,3,2014,6,11476,1769,13245
1,10,9,3,2014,7,12562,1930,14492
1,10,9,3,2014,8,12374,2101,14475
1,10,9,3,2014,9,12962,2360,15322
1,10,9,3,2014,10,12668,2743,15411
1,10,9,3,2014,11,11945,2942,14887
1,10,9,3,2014,12,11366,3004,14370
1,10,9,3,2014,13,11658,2999,14657
1,10,9,3,2014,14,10923,2856,13779
1,10,9,3,2014,15,11288,2843,14131
1,10,9,3,2014,16,11416,2819,14235
1,10,9,3,2014,17,11297,2826,14123
1,10,9,3,2014,18,11377,2800,14177
1,10,9,3,2014,19,12232,2774,15006
1,10,9,3,2014,20,13089,2793,15882
1,10,9,3,2014,21,12891,2692,15583
1,10,9,3,2014,22,12181,2461,14642
1,10,9,3,2014,23,11954,2301,14255
1,10,9,3,2014,24,11581,2168,13749
1,11,9,3,2014,1,11062,1953,13015
1,11,9,3,2014,2,10912,1787,12699
1,11,9,3,2014,3,10960,1694,12654
1,11,9,3,2014,4,11161,1635,12796
1,11,9,3,2014,5,11265,1638,12903
1,11,9,3,2014,6,11725,1746,13471
1,11,9,3,2014,7,12333,1918,14251
1,11,9,3,2014,8,12636,2106,14742
1,11,9,3,2014,9,12574,2396,14970
1,11,9,3,2014,10,12637,2726,15363
1,11,9,3,2014,11,12297,2989,15286
1,11,9,3,2014,12,12038,2999,15037
1,11,9,3,2014,13,11694,2994,14688
1,11,9,3,2014,14,11657,2886,14543
1,11,9,3,2014,15,11700,2886,14586
1,11,9,3,2014,16,11861,2875,14736
1,11,9,3,2014,17,11682,2847,14529
1,11,9,3,2014,18,11484,2788,14272
1,11,9,3,2014,19,12211,2760,14971
1,11,9,3,2014,20,13190,2796,15986
1,11,9,3,2014,21,12870,2668,15538
1,11,9,3,2014,22,12388,2521,14909
1,11,9,3,2014,23,12044,2337,14381
1,11,9,3,2014,24,11599,2199,13798
1,12,9,3,2014,1,11429,1979,13408
1,12,9,3,2014,2,11168,1813,12981
1,12,9,3,2014,3,11205,1725,12930
1,12,9,3,2014,4,11136,1670,12806
1,12,9,3,2014,5,11373,1679,13052
1,12,9,3,2014,6,12332,1792,14124
1,12,9,3,2014,7,12642,1937,14579
1,12,9,3,2014,8,12800,2105,14905
1,12,9,3,2014,9,12979,2456,15435
1,12,9,3,2014,10,12965,2745,15710
1,12,9,3,2014,11,12449,2999,15448
1,12,9,3,2014,12,12300,3042,15342
1,12,9,3,2014,13,12129,3019,15148
1,12,9,3,2014,14,11797,2876,14673
1,12,9,3,2014,15,11824,2889,14713
1,12,9,3,2014,16,11889,2864,14753
1,12,9,3,2014,17,11618,2873,14491
1,12,9,3,2014,18,11048,2805,13853
1,12,9,3,2014,19,11852,2735,14587
1,12,9,3,2014,20,13404,2774,16178
1,12,9,3,2014,21,12813,2687,15500
1,12,9,3,2014,22,12352,2486,14838
1,12,9,3,2014,23,12012,2318,14330
1,12,9,3,2014,24,11900,2182,14082
2,13,9,3,2014,1,11421,2014,13435
2,13,9,3,2014,2,11344,1859,13203
2,13,9,3,2014,3,11263,1754,13017
2,13,9,3,2014,4,11359,1696,13055
2,13,9,3,2014,5,11370,1691,13061
2,13,9,3,2014,6,12105,1776,13881
2,13,9,3,2014,7,12840,1863,14703
2,13,9,3,2014,8,12918,1909,14827
2,13,9,3,2014,9,13242,2264,15506
2,13,9,3,2014,10,13064,2526,15590
2,13,9,3,2014,11,13204,2765,15969
2,13,9,3,2014,12,13120,2787,15907
2,13,9,3,2014,13,12878,2785,15663
2,13,9,3,2014,14,12972,2705,15677
2,13,9,3,2014,15,12746,2684,15430
2,13,9,3,2014,16,12751,2672,15423
2,13,9,3,2014,17,12593,2609,15202
2,13,9,3,2014,18,12029,2587,14616
2,13,9,3,2014,19,12551,2586,15137
2,13,9,3,2014,20,13360,2663,16023
2,13,9,3,2014,21,13105,2618,15723
2,13,9,3,2014,22,12621,2467,15088
2,13,9,3,2014,23,12187,2299,14486
2,13,9,3,2014,24,12039,2135,14174
2,14,9,3,2014,1,11802,2032,13834
2,14,9,3,2014,2,11398,1859,13257
2,14,9,3,2014,3,11220,1762,12982
2,14,9,3,2014,4,11169,1708,12877
2,14,9,3,2014,5,11559,1695,13254
2,14,9,3,2014,6,11760,1751,13511
2,14,9,3,2014,7,12487,1771,14258
2,14,9,3,2014,8,12856,1824,14680
2,14,9,3,2014,9,13181,1940,15121
2,14,9,3,2014,10,13458,2079,15537
2,14,9,3,2014,11,13722,2226,15948
2,14,9,3,2014,12,13440,2260,15700
2,14,9,3,2014,13,13433,2248,15681
2,14,9,3,2014,14,13005,2185,15190
2,14,9,3,2014,15,12966,2135,15101
2,14,9,3,2014,16,13040,2121,15161
2,14,9,3,2014,17,12536,2092,14628
2,14,9,3,2014,18,11945,2048,13993
2,14,9,3,2014,19,12451,2123,14574
2,14,9,3,2014,20,13120,2269,15389
2,14,9,3,2014,21,13039,2342,15381
2,14,9,3,2014,22,12292,2239,14531
2,14,9,3,2014,23,12230,2243,14473
2,14,9,3,2014,24,11977,2126,14103
1,15,9,3,2014,1,11688,1960,13648
1,15,9,3,2014,2,11601,1824,13425
1,15,9,3,2014,3,11686,1740,13426
1,15,9,3,2014,4,11557,1689,13246
1,15,9,3,2014,5,11793,1651,13444
1,15,9,3,2014,6,12220,1759,13979
1,15,9,3,2014,7,12992,1925,14917
1,15,9,3,2014,8,13495,2098,15593
1,15,9,3,2014,9,13574,2403,15977
1,15,9,3,2014,10,13854,2749,16603
1,15,9,3,2014,11,13798,2964,16762
1,15,9,3,2014,12,13612,3016,16628
1,15,9,3,2014,13,13693,3008,16701
1,15,9,3,2014,14,13447,2917,16364
1,15,9,3,2014,15,13510,2937,16447
1,15,9,3,2014,16,13677,2953,16630
1,15,9,3,2014,17,13294,2923,16217
1,15,9,3,2014,18,12078,2892,14970
1,15,9,3,2014,19,12741,2798,15539
1,15,9,3,2014,20,13581,2820,16401
1,15,9,3,2014,21,13271,2748,16019
1,15,9,3,2014,22,12799,2569,15368
1,15,9,3,2014,23,12519,2379,14898
1,15,9,3,2014,24,12443,2199,14642
1,16,9,3,2014,1,12444,2046,14490
1,16,9,3,2014,2,12046,1900,13946
1,16,9,3,2014,3,12112,1803,13915
1,16,9,3,2014,4,11882,1717,13599
1,16,9,3,2014,5,12346,1718,14064
1,16,9,3,2014,6,12775,1830,14605
1,16,9,3,2014,7,13672,1969,15641
1,16,9,3,2014,8,13761,2131,15892
1,16,9,3,2014,9,13716,2451,16167
1,16,9,3,2014,10,14130,2743,16873
1,16,9,3,2014,11,14109,3007,17116
1,16,9,3,2014,12,14544,3016,17560
1,16,9,3,2014,13,14139,3010,17149
1,16,9,3,2014,14,14132,2908,17040
1,16,9,3,2014,15,14002,2920,16922
1,16,9,3,2014,16,13875,2941,16816
1,16,9,3,2014,17,13308,2920,16228
1,16,9,3,2014,18,12448,2870,15318
1,16,9,3,2014,19,12914,2798,15712
1,16,9,3,2014,20,13958,2847,16805
1,16,9,3,2014,21,13416,2694,16110
1,16,9,3,2014,22,12861,2512,15373
1,16,9,3,2014,23,12679,2390,15069
1,16,9,3,2014,24,12282,2268,14550
1,17,9,3,2014,1,12385,2080,14465
1,17,9,3,2014,2,12320,1900,14220
1,17,9,3,2014,3,11945,1787,13732
1,17,9,3,2014,4,11937,1739,13676
1,17,9,3,2014,5,11935,1729,13664
1,17,9,3,2014,6,12528,1834,14362
1,17,9,3,2014,7,13324,1971,15295
1,17,9,3,2014,8,13612,2132,15744
1,17,9,3,2014,9,13767,2418,16185
1,17,9,3,2014,10,14040,2741,16781
1,17,9,3,2014,11,13986,2932,16918
1,17,9,3,2014,12,13731,2962,16693
1,17,9,3,2014,13,13836,2960,16796
1,17,9,3,2014,14,13493,2870,16363
1,17,9,3,2014,15,13651,2898,16549
1,17,9,3,2014,16,13728,2904,16632
1,17,9,3,2014,17,13697,2881,16578
1,17,9,3,2014,18,12661,2812,15473
1,17,9,3,2014,19,12985,2771,15756
1,17,9,3,2014,20,13980,2796,16776
1,17,9,3,2014,21,13353,2673,16026
1,17,9,3,2014,22,13196,2516,15712
1,17,9,3,2014,23,12745,2397,15142
1,17,9,3,2014,24,12453,2258,14711
1,18,9,3,2014,1,12601,2066,14667
1,18,9,3,2014,2,12310,1898,14208
1,18,9,3,2014,3,12245,1782,14027
1,18,9,3,2014,4,11952,1741,13693
1,18,9,3,2014,5,12063,1728,13791
1,18,9,3,2014,6,12501,1830,14331
1,18,9,3,2014,7,13353,1964,15317
1,18,9,3,2014,8,13543,2112,15655
1,18,9,3,2014,9,13817,2399,16216
1,18,9,3,2014,10,13929,2807,16736
1,18,9,3,2014,11,14136,2982,17118
1,18,9,3,2014,12,14222,2992,17214
1,18,9,3,2014,13,13775,2988,16763
1,18,9,3,2014,14,13550,2841,16391
1,18,9,3,2014,15,13692,2858,16550
1,18,9,3,2014,16,13545,2827,16372
1,18,9,3,2014,17,13374,2825,16199
1,18,9,3,2014,18,12577,2826,15403
1,18,9,3,2014,19,13146,2811,15957
1,18,9,3,2014,20,13750,2798,16548
1,18,9,3,2014,21,13727,2649,16376
1,18,9,3,2014,22,13110,2530,15640
1,18,9,3,2014,23,12680,2360,15040
1,18,9,3,2014,24,12648,2226,14874
1,19,9,3,2014,1,12662,2046,14708
1,19,9,3,2014,2,12257,1849,14106
1,19,9,3,2014,3,12283,1759,14042
1,19,9,3,2014,4,12366,1706,14072
1,19,9,3,2014,5,12373,1696,14069
1,19,9,3,2014,6,12824,1807,14631
1,19,9,3,2014,7,13882,1899,15781
1,19,9,3,2014,8,14027,2108,16135
1,19,9,3,2014,9,14044,2438,16482
1,19,9,3,2014,10,13934,2738,16672
1,19,9,3,2014,11,14026,2959,16985
1,19,9,3,2014,12,13785,2971,16756
1,19,9,3,2014,13,13736,2896,16632
1,19,9,3,2014,14,13676,2825,16501
1,19,9,3,2014,15,13450,2822,16272
1,19,9,3,2014,16,13369,2849,16218
1,19,9,3,2014,17,13260,2794,16054
1,19,9,3,2014,18,12190,2782,14972
1,19,9,3,2014,19,13023,2701,15724
1,19,9,3,2014,20,14012,2780,16792
1,19,9,3,2014,21,13345,2644,15989
1,19,9,3,2014,22,12868,2511,15379
1,19,9,3,2014,23,12466,2325,14791
1,19,9,3,2014,24,12210,2194,14404
2,20,9,3,2014,1,12184,2017,14201
2,20,9,3,2014,2,12021,1845,13866
2,20,9,3,2014,3,12216,1770,13986
2,20,9,3,2014,4,12146,1701,13847
2,20,9,3,2014,5,12470,1688,14158
2,20,9,3,2014,6,12977,1776,14753
2,20,9,3,2014,7,13617,1875,15492
2,20,9,3,2014,8,13780,1985,15765
2,20,9,3,2014,9,14137,2252,16389
2,20,9,3,2014,10,13952,2587,16539
2,20,9,3,2014,11,14256,2803,17059
2,20,9,3,2014,12,14136,2830,16966
2,20,9,3,2014,13,14045,2816,16861
2,20,9,3,2014,14,13891,2686,16577
2,20,9,3,2014,15,13837,2679,16516
2,20,9,3,2014,16,13974,2668,16642
2,20,9,3,2014,17,13715,2630,16345
2,20,9,3,2014,18,12856,2585,15441
2,20,9,3,2014,19,13460,2588,16048
2,20,9,3,2014,20,13862,2662,16524
2,20,9,3,2014,21,13391,2573,15964
2,20,9,3,2014,22,12583,2426,15009
2,20,9,3,2014,23,12381,2281,14662
2,20,9,3,2014,24,12463,2159,14622
2,21,9,3,2014,1,12696,2000,14696
2,21,9,3,2014,2,12321,1856,14177
2,21,9,3,2014,3,12158,1759,13917
2,21,9,3,2014,4,12228,1663,13891
2,21,9,3,2014,5,12592,1642,14234
2,21,9,3,2014,6,12796,1709,14505
2,21,9,3,2014,7,13409,1714,15123
2,21,9,3,2014,8,13957,1771,15728
2,21,9,3,2014,9,14308,1881,16189
2,21,9,3,2014,10,14215,2039,16254
2,21,9,3,2014,11,14611,2153,16764
2,21,9,3,2014,12,15083,2212,17295
2,21,9,3,2014,13,14148,2231,16379
2,21,9,3,2014,14,14281,2151,16432
2,21,9,3,2014,15,14752,2104,16856
2,21,9,3,2014,16,14584,2086,16670
2,21,9,3,2014,17,14113,2029,16142
2,21,9,3,2014,18,12805,2027,14832
2,21,9,3,2014,19,13319,2081,15400
2,21,9,3,2014,20,14100,2330,16430
2,21,9,3,2014,21,13462,2348,15810
2,21,9,3,2014,22,13149,2334,15483
2,21,9,3,2014,23,12862,2201,15063
2,21,9,3,2014,24,12793,2014,14807
1,22,9,3,2014,1,13129,1979,15108
1,22,9,3,2014,2,12770,1822,14592
1,22,9,3,2014,3,12938,1706,14644
1,22,9,3,2014,4,12867,1665,14532
1,22,9,3,2014,5,12937,1652,14589
1,22,9,3,2014,6,13479,1754,15233
1,22,9,3,2014,7,14080,1935,16015
1,22,9,3,2014,8,14985,2089,17074
1,22,9,3,2014,9,14762,2377,17139
1,22,9,3,2014,10,15024,2785,17809
1,22,9,3,2014,11,15130,2970,18100
1,22,9,3,2014,12,15097,2993,18090
1,22,9,3,2014,13,15038,2995,18033
1,22,9,3,2014,14,14903,2883,17786
1,22,9,3,2014,15,14992,2919,17911
1,22,9,3,2014,16,14957,2972,17929
1,22,9,3,2014,17,14685,2916,17601
1,22,9,3,2014,18,13826,2913,16739
1,22,9,3,2014,19,13646,2799,16445
1,22,9,3,2014,20,14584,2830,17414
1,22,9,3,2014,21,14140,2750,16890
1,22,9,3,2014,22,13579,2572,16151
1,22,9,3,2014,23,13417,2513,15930
1,22,9,3,2014,24,13429,2246,15675
1,23,9,3,2014,1,13284,2138,15422
1,23,9,3,2014,2,13029,1922,14951
1,23,9,3,2014,3,13138,1802,14940
1,23,9,3,2014,4,12904,1739,14643
1,23,9,3,2014,5,12859,1736,14595
1,23,9,3,2014,6,13733,1827,15560
1,23,9,3,2014,7,14497,1943,16440
1,23,9,3,2014,8,15191,2142,17333
1,23,9,3,2014,9,15322,2442,17764
1,23,9,3,2014,10,15391,2812,18203
1,23,9,3,2014,11,15433,2970,18403
1,23,9,3,2014,12,15676,3021,18697
1,23,9,3,2014,13,15536,3001,18537
1,23,9,3,2014,14,15384,2975,18359
1,23,9,3,2014,15,15559,2997,18556
1,23,9,3,2014,16,15641,2996,18637
1,23,9,3,2014,17,15193,2979,18172
1,23,9,3,2014,18,14127,2922,17049
1,23,9,3,2014,19,14056,2881,16937
1,23,9,3,2014,20,14947,2903,17850
1,23,9,3,2014,21,14610,2709,17319
1,23,9,3,2014,22,14129,2582,16711
1,23,9,3,2014,23,13748,2306,16054
1,23,9,3,2014,24,13778,2371,16149
1,24,9,3,2014,1,13810,2185,15995
1,24,9,3,2014,2,13641,1961,15602
1,24,9,3,2014,3,13454,1844,15298
1,24,9,3,2014,4,13523,1784,15307
1,24,9,3,2014,5,13613,1790,15403
1,24,9,3,2014,6,14258,1872,16130
1,24,9,3,2014,7,15069,2028,17097
1,24,9,3,2014,8,15501,2184,17685
1,24,9,3,2014,9,15692,2430,18122
1,24,9,3,2014,10,15655,2761,18416
1,24,9,3,2014,11,15800,3014,18814
1,24,9,3,2014,12,15796,3038,18834
1,24,9,3,2014,13,15782,3076,18858
1,24,9,3,2014,14,15561,2973,18534
1,24,9,3,2014,15,15916,3050,18966
1,24,9,3,2014,16,15670,3050,18720
1,24,9,3,2014,17,15386,3007,18393
1,24,9,3,2014,18,14012,2997,17009
1,24,9,3,2014,19,14271,2940,17211
1,24,9,3,2014,20,14813,2966,17779
1,24,9,3,2014,21,14843,2769,17612
1,24,9,3,2014,22,14078,2637,16715
1,24,9,3,2014,23,13880,2547,16427
1,24,9,3,2014,24,14053,2389,16442
1,25,9,3,2014,1,14175,2167,16342
1,25,9,3,2014,2,14128,1980,16108
1,25,9,3,2014,3,13724,1874,15598
1,25,9,3,2014,4,13687,1836,15523
1,25,9,3,2014,5,13779,1832,15611
1,25,9,3,2014,6,14500,1932,16432
1,25,9,3,2014,7,14996,2070,17066
1,25,9,3,2014,8,15416,2214,17630
1,25,9,3,2014,9,15720,2496,18216
1,25,9,3,2014,10,15848,2849,18697
1,25,9,3,2014,11,15873,3084,18957
1,25,9,3,2014,12,16103,3150,19253
1,25,9,3,2014,13,15994,3130,19124
1,25,9,3,2014,14,15605,3011,18616
1,25,9,3,2014,15,15737,3058,18795
1,25,9,3,2014,16,15862,3070,18932
1,25,9,3,2014,17,15713,3045,18758
1,25,9,3,2014,18,15105,2969,18074
1,25,9,3,2014,19,14182,2931,17113
1,25,9,3,2014,20,15236,2989,18225
1,25,9,3,2014,21,14629,2882,17511
1,25,9,3,2014,22,14261,2707,16968
1,25,9,3,2014,23,14016,2592,16608
1,25,9,3,2014,24,13947,2491,16438
1,26,9,3,2014,1,14019,2240,16259
1,26,9,3,2014,2,13809,2024,15833
1,26,9,3,2014,3,13782,1906,15688
1,26,9,3,2014,4,13765,1840,15605
1,26,9,3,2014,5,13988,1828,15816
1,26,9,3,2014,6,14743,1917,16660
1,26,9,3,2014,7,15291,2038,17329
1,26,9,3,2014,8,14945,2173,17118
1,26,9,3,2014,9,15152,2485,17637
1,26,9,3,2014,10,15173,2781,17954
1,26,9,3,2014,11,15399,3030,18429
1,26,9,3,2014,12,15493,3046,18539
1,26,9,3,2014,13,15469,3023,18492
1,26,9,3,2014,14,15412,2878,18290
1,26,9,3,2014,15,15400,2933,18333
1,26,9,3,2014,16,15490,2960,18450
1,26,9,3,2014,17,14891,2970,17861
1,26,9,3,2014,18,13717,2940,16657
1,26,9,3,2014,19,14221,2964,17185
1,26,9,3,2014,20,15036,3023,18059
1,26,9,3,2014,21,14572,2861,17433
1,26,9,3,2014,22,14287,2693,16980
1,26,9,3,2014,23,14126,2565,16691
1,26,9,3,2014,24,14324,2459,16783
2,27,9,3,2014,1,14339,2241,16580
2,27,9,3,2014,2,14296,2031,16327
2,27,9,3,2014,3,14100,1909,16009
2,27,9,3,2014,4,13872,1836,15708
2,27,9,3,2014,5,14281,1825,16106
2,27,9,3,2014,6,14975,1905,16880
2,27,9,3,2014,7,15604,1988,17592
2,27,9,3,2014,8,15889,2096,17985
2,27,9,3,2014,9,16212,2316,18528
2,27,9,3,2014,10,15977,2703,18680
2,27,9,3,2014,11,15891,2938,18829
2,27,9,3,2014,12,15992,3020,19012
2,27,9,3,2014,13,16414,3001,19415
2,27,9,3,2014,14,15847,2901,18748
2,27,9,3,2014,15,16703,2929,19632
2,27,9,3,2014,16,16183,2946,19129
2,27,9,3,2014,17,15143,2936,18079
2,27,9,3,2014,18,14024,2899,16923
2,27,9,3,2014,19,14425,2893,17318
2,27,9,3,2014,20,15283,2989,18272
2,27,9,3,2014,21,14640,2936,17576
2,27,9,3,2014,22,14256,2753,17009
2,27,9,3,2014,23,14117,2642,16759
2,27,9,3,2014,24,14416,2587,17003
2,28,9,3,2014,1,14682,2400,17082
2,28,9,3,2014,2,14607,2177,16784
2,28,9,3,2014,3,14367,2031,16398
2,28,9,3,2014,4,14345,1932,16277
2,28,9,3,2014,5,14704,1901,16605
2,28,9,3,2014,6,14915,1926,16841
2,28,9,3,2014,7,15660,1933,17593
2,28,9,3,2014,8,15555,1951,17506
2,28,9,3,2014,9,16097,2066,18163
2,28,9,3,2014,10,16098,2240,18338
2,28,9,3,2014,11,16472,2370,18842
2,28,9,3,2014,12,16553,2411,18964
2,28,9,3,2014,13,16392,2410,18802
2,28,9,3,2014,14,16322,2366,18688
2,28,9,3,2014,15,16163,2377,18540
2,28,9,3,2014,16,15827,2395,18222
2,28,9,3,2014,17,15535,2360,17895
2,28,9,3,2014,18,14336,2324,16660
2,28,9,3,2014,19,14435,2461,16896
2,28,9,3,2014,20,15023,2613,17636
2,28,9,3,2014,21,14674,2658,17332
2,28,9,3,2014,22,14206,2635,16841
2,28,9,3,2014,23,14140,2612,16752
2,28,9,3,2014,24,14627,2611,17238
1,29,9,3,2014,1,14824,2420,17244
1,29,9,3,2014,2,14361,2161,16522
1,29,9,3,2014,3,14259,2024,16283
1,29,9,3,2014,4,14829,1948,16777
1,29,9,3,2014,5,14756,1930,16686
1,29,9,3,2014,6,15322,1989,17311
1,29,9,3,2014,7,16251,2106,18357
1,29,9,3,2014,8,16194,2220,18414
1,29,9,3,2014,9,16573,2532,19105
1,29,9,3,2014,10,16378,2946,19324
1,29,9,3,2014,11,16629,3170,19799
1,29,9,3,2014,12,16365,3273,19638
1,29,9,3,2014,13,16735,3272,20007
1,29,9,3,2014,14,16858,3186,20044
1,29,9,3,2014,15,16693,3266,19959
1,29,9,3,2014,16,16734,3271,20005
1,29,9,3,2014,17,16016,3263,19279
1,29,9,3,2014,18,14969,3171,18140
1,29,9,3,2014,19,14891,3143,18034
1,29,9,3,2014,20,15690,3187,18877
1,29,9,3,2014,21,15371,3069,18440
1,29,9,3,2014,22,14899,2940,17839
1,29,9,3,2014,23,14716,2773,17489
1,29,9,3,2014,24,14746,2672,17418
1,30,9,3,2014,1,15245,2530,17775
1,30,9,3,2014,2,15113,2329,17442
1,30,9,3,2014,3,15236,2168,17404
1,30,9,3,2014,4,15308,2069,17377
1,30,9,3,2014,5,14752,2059,16811
1,30,9,3,2014,6,15457,2131,17588
1,30,9,3,2014,7,15716,2213,17929
1,30,9,3,2014,8,15879,2325,18204
1,30,9,3,2014,9,16187,2627,18814
1,30,9,3,2014,10,16048,3002,19050
1,30,9,3,2014,11,16232,3256,19488
1,30,9,3,2014,12,16197,3328,19525
1,30,9,3,2014,13,16768,3330,20098
1,30,9,3,2014,14,16731,3234,19965
1,30,9,3,2014,15,17140,3338,20478
1,30,9,3,2014,16,17424,3361,20785
1,30,9,3,2014,17,16437,3336,19773
1,30,9,3,2014,18,15385,3242,18627
1,30,9,3,2014,19,15092,3099,18191
1,30,9,3,2014,20,15231,2868,18099
1,30,9,3,2014,21,14657,2832,17489
1,30,9,3,2014,22,14045,2652,16697
1,30,9,3,2014,23,13934,2471,16405
1,30,9,3,2014,24,13804,2403,16207
1,1,10,1,2014,1,14370,2219,16589
1,1,10,1,2014,2,14735,2030,16765
1,1,10,1,2014,3,14353,1914,16267
1,1,10,1,2014,4,14661,1848,16509
1,1,10,1,2014,5,15140,1821,16961
1,1,10,1,2014,6,15938,1904,17842
1,1,10,1,2014,7,16215,2020,18235
1,1,10,1,2014,8,16038,2151,18189
1,1,10,1,2014,9,15468,2438,17906
1,1,10,1,2014,10,16107,2777,18884
1,1,10,1,2014,11,15626,3012,18638
1,1,10,1,2014,12,16464,3120,19584
1,1,10,1,2014,13,16813,3145,19958
1,1,10,1,2014,14,16251,3031,19282
1,1,10,1,2014,15,16622,3069,19691
1,1,10,1,2014,16,15735,3144,18879
1,1,10,1,2014,17,15365,3151,18516
1,1,10,1,2014,18,14776,3054,17830
1,1,10,1,2014,19,14318,2850,17168
1,1,10,1,2014,20,14704,2883,17587
1,1,10,1,2014,21,14857,2650,17507
1,1,10,1,2014,22,14298,2531,16829
1,1,10,1,2014,23,14086,2372,16458
1,1,10,1,2014,24,14000,2437,16437
3,2,10,1,2014,1,14836,2206,17042
3,2,10,1,2014,2,14407,2083,16490
3,2,10,1,2014,3,14510,2030,16540
3,2,10,1,2014,4,14261,2026,16287
3,2,10,1,2014,5,14451,1906,16357
3,2,10,1,2014,6,15226,1823,17049
3,2,10,1,2014,7,15481,1845,17326
3,2,10,1,2014,8,14984,1987,16971
3,2,10,1,2014,9,15115,2194,17309
3,2,10,1,2014,10,15382,2392,17774
3,2,10,1,2014,11,15460,2506,17966
3,2,10,1,2014,12,16204,2571,18775
3,2,10,1,2014,13,16089,2652,18741
3,2,10,1,2014,14,15999,2581,18580
3,2,10,1,2014,15,15920,2638,18558
3,2,10,1,2014,16,15576,2693,18269
3,2,10,1,2014,17,14717,2669,17386
3,2,10,1,2014,18,13811,2630,16441
3,2,10,1,2014,19,13990,2702,16692
3,2,10,1,2014,20,14912,2809,17721
3,2,10,1,2014,21,14874,2757,17631
3,2,10,1,2014,22,14363,2547,16910
3,2,10,1,2014,23,13948,2443,16391
3,2,10,1,2014,24,14034,2362,16396
3,3,10,1,2014,1,14423,2249,16672
3,3,10,1,2014,2,14339,2109,16448
3,3,10,1,2014,3,14438,1981,16419
3,3,10,1,2014,4,14440,1887,16327
3,3,10,1,2014,5,14684,1845,16529
3,3,10,1,2014,6,15083,1893,16976
3,3,10,1,2014,7,15031,1901,16932
3,3,10,1,2014,8,14379,1929,16308
3,3,10,1,2014,9,13897,2034,15931
3,3,10,1,2014,10,13964,2172,16136
3,3,10,1,2014,11,14261,2315,16576
3,3,10,1,2014,12,14791,2395,17186
3,3,10,1,2014,13,15159,2405,17564
3,3,10,1,2014,14,14651,2334,16985
3,3,10,1,2014,15,14485,2375,16860
3,3,10,1,2014,16,14068,2409,16477
3,3,10,1,2014,17,13152,2372,15524
3,3,10,1,2014,18,12514,2325,14839
3,3,10,1,2014,19,12908,2493,15401
3,3,10,1,2014,20,13603,2628,16231
3,3,10,1,2014,21,13505,2607,16112
3,3,10,1,2014,22,13083,2587,15670
3,3,10,1,2014,23,12963,2561,15524
3,3,10,1,2014,24,13167,2504,15671
2,4,10,1,2014,1,13711,2389,16100
2,4,10,1,2014,2,13714,2185,15899
2,4,10,1,2014,3,13452,2048,15500
2,4,10,1,2014,4,13739,1960,15699
2,4,10,1,2014,5,13824,1915,15739
2,4,10,1,2014,6,14110,1975,16085
2,4,10,1,2014,7,14713,2004,16717
2,4,10,1,2014,8,14745,2088,16833
2,4,10,1,2014,9,14645,2314,16959
2,4,10,1,2014,10,15712,2654,18366
2,4,10,1,2014,11,15969,2972,18941
2,4,10,1,2014,12,17065,3075,20140
2,4,10,1,2014,13,17694,3101,20795
2,4,10,1,2014,14,16865,3107,19972
2,4,10,1,2014,15,16133,3041,19174
2,4,10,1,2014,16,15786,3033,18819
2,4,10,1,2014,17,15051,2957,18008
2,4,10,1,2014,18,14315,2846,17161
2,4,10,1,2014,19,14723,2866,17589
2,4,10,1,2014,20,15316,2890,18206
2,4,10,1,2014,21,14627,2740,17367
2,4,10,1,2014,22,14176,2591,16767
2,4,10,1,2014,23,14205,2469,16674
2,4,10,1,2014,24,14182,2474,16656
2,5,10,1,2014,1,14806,2317,17123
2,5,10,1,2014,2,14964,2131,17095
2,5,10,1,2014,3,15205,2001,17206
2,5,10,1,2014,4,14750,1922,16672
2,5,10,1,2014,5,15141,1886,17027
2,5,10,1,2014,6,15331,1922,17253
2,5,10,1,2014,7,15789,1907,17696
2,5,10,1,2014,8,15206,1919,17125
2,5,10,1,2014,9,14843,2018,16861
2,5,10,1,2014,10,15870,2171,18041
2,5,10,1,2014,11,16273,2317,18590
2,5,10,1,2014,12,17130,2381,19511
2,5,10,1,2014,13,16775,2415,19190
2,5,10,1,2014,14,17123,2392,19515
2,5,10,1,2014,15,16981,2454,19435
2,5,10,1,2014,16,16291,2482,18773
2,5,10,1,2014,17,15213,2413,17626
2,5,10,1,2014,18,14704,2325,17029
2,5,10,1,2014,19,14712,2350,17062
2,5,10,1,2014,20,15136,2511,17647
2,5,10,1,2014,21,14877,2531,17408
2,5,10,1,2014,22,14325,2532,16857
2,5,10,1,2014,23,13933,2516,16449
2,5,10,1,2014,24,14111,2497,16608
3,6,10,1,2014,1,14985,2354,17339
3,6,10,1,2014,2,14759,2143,16902
3,6,10,1,2014,3,15002,2017,17019
3,6,10,1,2014,4,14917,1945,16862
3,6,10,1,2014,5,15187,1926,17113
3,6,10,1,2014,6,15645,2009,17654
3,6,10,1,2014,7,16303,2066,18369
3,6,10,1,2014,8,15656,2157,17813
3,6,10,1,2014,9,15251,2410,17661
3,6,10,1,2014,10,15836,2701,18537
3,6,10,1,2014,11,16479,2939,19418
3,6,10,1,2014,12,17297,3033,20330
3,6,10,1,2014,13,17427,3063,20490
3,6,10,1,2014,14,17227,3032,20259
3,6,10,1,2014,15,17005,3058,20063
3,6,10,1,2014,16,16362,3055,19417
3,6,10,1,2014,17,15308,3007,18315
3,6,10,1,2014,18,14245,2897,17142
3,6,10,1,2014,19,14414,2883,17297
3,6,10,1,2014,20,14675,2829,17504
3,6,10,1,2014,21,14374,2709,17083
3,6,10,1,2014,22,14188,2601,16789
3,6,10,1,2014,23,13925,2569,16494
3,6,10,1,2014,24,14152,2521,16673
1,7,10,1,2014,1,14529,2335,16864
1,7,10,1,2014,2,14717,2140,16857
1,7,10,1,2014,3,14811,2024,16835
1,7,10,1,2014,4,14916,1960,16876
1,7,10,1,2014,5,14684,1937,16621
1,7,10,1,2014,6,15346,2003,17349
1,7,10,1,2014,7,15722,2107,17829
1,7,10,1,2014,8,15402,2235,17637
1,7,10,1,2014,9,15025,2514,17539
1,7,10,1,2014,10,15633,2874,18507
1,7,10,1,2014,11,16320,3138,19458
1,7,10,1,2014,12,17008,3228,20236
1,7,10,1,2014,13,17054,3225,20279
1,7,10,1,2014,14,17228,3131,20359
1,7,10,1,2014,15,16229,3170,19399
1,7,10,1,2014,16,15532,3200,18732
1,7,10,1,2014,17,14788,3159,17947
1,7,10,1,2014,18,14056,3037,17093
1,7,10,1,2014,19,14285,2925,17210
1,7,10,1,2014,20,14457,2835,17292
1,7,10,1,2014,21,14192,2706,16898
1,7,10,1,2014,22,13996,2491,16487
1,7,10,1,2014,23,14033,2409,16442
1,7,10,1,2014,24,13843,2305,16148
1,8,10,1,2014,1,14277,2181,16458
1,8,10,1,2014,2,14271,1987,16258
1,8,10,1,2014,3,14373,1883,16256
1,8,10,1,2014,4,14229,1820,16049
1,8,10,1,2014,5,14345,1803,16148
1,8,10,1,2014,6,14924,1882,16806
1,8,10,1,2014,7,15418,1999,17417
1,8,10,1,2014,8,15017,2141,17158
1,8,10,1,2014,9,14401,2458,16859
1,8,10,1,2014,10,15132,2769,17901
1,8,10,1,2014,11,15624,2936,18560
1,8,10,1,2014,12,16524,3045,19569
1,8,10,1,2014,13,16305,3059,19364
1,8,10,1,2014,14,15897,3006,18903
1,8,10,1,2014,15,16161,3047,19208
1,8,10,1,2014,16,15958,3061,19019
1,8,10,1,2014,17,14768,3052,17820
1,8,10,1,2014,18,14020,2987,17007
1,8,10,1,2014,19,15126,2955,18081
1,8,10,1,2014,20,14750,2930,17680
1,8,10,1,2014,21,14914,2771,17685
1,8,10,1,2014,22,13998,2618,16616
1,8,10,1,2014,23,13740,2534,16274
1,8,10,1,2014,24,13602,2452,16054
1,9,10,1,2014,1,13877,2276,16153
1,9,10,1,2014,2,14117,2081,16198
1,9,10,1,2014,3,14024,1961,15985
1,9,10,1,2014,4,14034,1884,15918
1,9,10,1,2014,5,14179,1855,16034
1,9,10,1,2014,6,14719,1925,16644
1,9,10,1,2014,7,15354,2046,17400
1,9,10,1,2014,8,14568,2191,16759
1,9,10,1,2014,9,14220,2486,16706
1,9,10,1,2014,10,15068,2848,17916
1,9,10,1,2014,11,15447,3102,18549
1,9,10,1,2014,12,16416,3138,19554
1,9,10,1,2014,13,16547,3151,19698
1,9,10,1,2014,14,16414,3080,19494
1,9,10,1,2014,15,16604,3142,19746
1,9,10,1,2014,16,16095,3155,19250
1,9,10,1,2014,17,14908,3142,18050
1,9,10,1,2014,18,14456,3099,17555
1,9,10,1,2014,19,14772,3034,17806
1,9,10,1,2014,20,15030,3004,18034
1,9,10,1,2014,21,14707,2805,17512
1,9,10,1,2014,22,14258,2649,16907
1,9,10,1,2014,23,13596,2622,16218
1,9,10,1,2014,24,13651,2425,16076
1,10,10,1,2014,1,14122,2283,16405
1,10,10,1,2014,2,14291,2099,16390
1,10,10,1,2014,3,14244,1981,16225
1,10,10,1,2014,4,14474,1903,16377
1,10,10,1,2014,5,14425,1885,16310
1,10,10,1,2014,6,14984,1961,16945
1,10,10,1,2014,7,15538,2062,17600
1,10,10,1,2014,8,14777,2211,16988
1,10,10,1,2014,9,14094,2510,16604
1,10,10,1,2014,10,15074,2870,17944
1,10,10,1,2014,11,15293,3132,18425
1,10,10,1,2014,12,15851,3225,19076
1,10,10,1,2014,13,15820,3226,19046
1,10,10,1,2014,14,15948,3141,19089
1,10,10,1,2014,15,16033,3227,19260
1,10,10,1,2014,16,15893,3246,19139
1,10,10,1,2014,17,14603,3244,17847
1,10,10,1,2014,18,14537,3194,17731
1,10,10,1,2014,19,14509,3148,17657
1,10,10,1,2014,20,14789,3116,17905
1,10,10,1,2014,21,14396,2893,17289
1,10,10,1,2014,22,14074,2703,16777
1,10,10,1,2014,23,13908,2621,16529
1,10,10,1,2014,24,14158,2559,16717
2,11,10,1,2014,1,14484,2388,16872
2,11,10,1,2014,2,14604,2182,16786
2,11,10,1,2014,3,14616,2041,16657
2,11,10,1,2014,4,14544,1962,16506
2,11,10,1,2014,5,14813,1930,16743
2,11,10,1,2014,6,15376,1987,17363
2,11,10,1,2014,7,15992,2040,18032
2,11,10,1,2014,8,15135,2124,17259
2,11,10,1,2014,9,14473,2335,16808
2,11,10,1,2014,10,15679,2672,18351
2,11,10,1,2014,11,15562,2926,18488
2,11,10,1,2014,12,16995,3053,20048
2,11,10,1,2014,13,16885,3065,19950
2,11,10,1,2014,14,16914,2993,19907
2,11,10,1,2014,15,16643,3058,19701
2,11,10,1,2014,16,16215,3077,19292
2,11,10,1,2014,17,15993,3034,19027
2,11,10,1,2014,18,15075,2928,18003
2,11,10,1,2014,19,14943,2919,17862
2,11,10,1,2014,20,15345,2920,18265
2,11,10,1,2014,21,14984,2829,17813
2,11,10,1,2014,22,14370,2685,17055
2,11,10,1,2014,23,13927,2611,16538
2,11,10,1,2014,24,14154,2548,16702
2,12,10,1,2014,1,14649,2384,17033
2,12,10,1,2014,2,14841,2179,17020
2,12,10,1,2014,3,14798,2015,16813
2,12,10,1,2014,4,14723,1940,16663
2,12,10,1,2014,5,14860,1880,16740
2,12,10,1,2014,6,15320,1892,17212
2,12,10,1,2014,7,15946,1893,17839
2,12,10,1,2014,8,14885,1911,16796
2,12,10,1,2014,9,14490,2006,16496
2,12,10,1,2014,10,15326,2154,17480
2,12,10,1,2014,11,15810,2278,18088
2,12,10,1,2014,12,16792,2351,19143
2,12,10,1,2014,13,16525,2367,18892
2,12,10,1,2014,14,16215,2334,18549
2,12,10,1,2014,15,16253,2384,18637
2,12,10,1,2014,16,15749,2432,18181
2,12,10,1,2014,17,14856,2402,17258
2,12,10,1,2014,18,14474,2333,16807
2,12,10,1,2014,19,14129,2436,16565
2,12,10,1,2014,20,14675,2535,17210
2,12,10,1,2014,21,14386,2530,16916
2,12,10,1,2014,22,13941,2550,16491
2,12,10,1,2014,23,13612,2559,16171
2,12,10,1,2014,24,13870,2554,16424
1,13,10,1,2014,1,14565,2325,16890
1,13,10,1,2014,2,14875,2125,17000
1,13,10,1,2014,3,14904,1988,16892
1,13,10,1,2014,4,14800,1925,16725
1,13,10,1,2014,5,14971,1886,16857
1,13,10,1,2014,6,15681,1944,17625
1,13,10,1,2014,7,16038,2019,18057
1,13,10,1,2014,8,15545,2156,17701
1,13,10,1,2014,9,14746,2455,17201
1,13,10,1,2014,10,16005,2835,18840
1,13,10,1,2014,11,16298,3091,19389
1,13,10,1,2014,12,17215,3200,20415
1,13,10,1,2014,13,17482,3200,20682
1,13,10,1,2014,14,17360,3090,20450
1,13,10,1,2014,15,17573,3199,20772
1,13,10,1,2014,16,16752,3202,19954
1,13,10,1,2014,17,15838,3175,19013
1,13,10,1,2014,18,15214,3092,18306
1,13,10,1,2014,19,15382,3074,18456
1,13,10,1,2014,20,15791,3019,18810
1,13,10,1,2014,21,15002,2854,17856
1,13,10,1,2014,22,14881,2712,17593
1,13,10,1,2014,23,14286,2616,16902
1,13,10,1,2014,24,14572,2517,17089
1,14,10,1,2014,1,15182,2346,17528
1,14,10,1,2014,2,15299,2140,17439
1,14,10,1,2014,3,15258,2010,17268
1,14,10,1,2014,4,15411,1923,17334
1,14,10,1,2014,5,15608,1895,17503
1,14,10,1,2014,6,15920,1918,17838
1,14,10,1,2014,7,16115,1949,18064
1,14,10,1,2014,8,14945,1992,16937
1,14,10,1,2014,9,14067,2130,16197
1,14,10,1,2014,10,14698,2328,17026
1,14,10,1,2014,11,15038,2492,17530
1,14,10,1,2014,12,16049,2553,18602
1,14,10,1,2014,13,15981,2583,18564
1,14,10,1,2014,14,15890,2535,18425
1,14,10,1,2014,15,15777,2570,18347
1,14,10,1,2014,16,15375,2582,17957
1,14,10,1,2014,17,13919,2558,16477
1,14,10,1,2014,18,13844,2534,16378
1,14,10,1,2014,19,14288,2643,16931
1,14,10,1,2014,20,14655,2720,17375
1,14,10,1,2014,21,14378,2691,17069
1,14,10,1,2014,22,13710,2693,16403
1,14,10,1,2014,23,13733,2632,16365
1,14,10,1,2014,24,13663,2527,16190
3,15,10,1,2014,1,14218,2389,16607
3,15,10,1,2014,2,14586,2183,16769
3,15,10,1,2014,3,14599,2046,16645
3,15,10,1,2014,4,14276,1964,16240
3,15,10,1,2014,5,14666,1917,16583
3,15,10,1,2014,6,15367,1968,17335
3,15,10,1,2014,7,15502,2066,17568
3,15,10,1,2014,8,14556,2200,16756
3,15,10,1,2014,9,14652,2519,17171
3,15,10,1,2014,10,15511,2901,18412
3,15,10,1,2014,11,15848,3172,19020
3,15,10,1,2014,12,16942,3256,20198
3,15,10,1,2014,13,17086,3296,20382
3,15,10,1,2014,14,16765,3201,19966
3,15,10,1,2014,15,16977,3289,20266
3,15,10,1,2014,16,16517,3316,19833
3,15,10,1,2014,17,15270,3308,18578
3,15,10,1,2014,18,15203,3202,18405
3,15,10,1,2014,19,15119,3179,18298
3,15,10,1,2014,20,15558,3138,18696
3,15,10,1,2014,21,14812,2995,17807
3,15,10,1,2014,22,14496,2782,17278
3,15,10,1,2014,23,14188,2707,16895
3,15,10,1,2014,24,14220,2673,16893
1,16,10,1,2014,1,14505,2510,17015
1,16,10,1,2014,2,14815,2278,17093
1,16,10,1,2014,3,14875,2127,17002
1,16,10,1,2014,4,14747,2032,16779
1,16,10,1,2014,5,15066,1992,17058
1,16,10,1,2014,6,15800,2039,17839
1,16,10,1,2014,7,15425,2128,17553
1,16,10,1,2014,8,15145,2253,17398
1,16,10,1,2014,9,14256,2534,16790
1,16,10,1,2014,10,15728,2922,18650
1,16,10,1,2014,11,15601,3208,18809
1,16,10,1,2014,12,16482,3300,19782
1,16,10,1,2014,13,16776,3332,20108
1,16,10,1,2014,14,16571,3227,19798
1,16,10,1,2014,15,16266,3325,19591
1,16,10,1,2014,16,15743,3352,19095
1,16,10,1,2014,17,14565,3326,17891
1,16,10,1,2014,18,14322,3216,17538
1,16,10,1,2014,19,14637,3179,17816
1,16,10,1,2014,20,14930,3141,18071
1,16,10,1,2014,21,14537,2930,17467
1,16,10,1,2014,22,14214,2809,17023
1,16,10,1,2014,23,13861,2822,16683
1,16,10,1,2014,24,13413,2684,16097
1,17,10,1,2014,1,14023,2540,16563
1,17,10,1,2014,2,13880,2318,16198
1,17,10,1,2014,3,13988,2167,16155
1,17,10,1,2014,4,13920,2048,15968
1,17,10,1,2014,5,14298,1993,16291
1,17,10,1,2014,6,14728,2026,16754
1,17,10,1,2014,7,15055,2062,17117
1,17,10,1,2014,8,14220,2132,16352
1,17,10,1,2014,9,13663,2370,16033
1,17,10,1,2014,10,14655,2705,17360
1,17,10,1,2014,11,15433,3001,18434
1,17,10,1,2014,12,16040,3119,19159
1,17,10,1,2014,13,16688,3129,19817
1,17,10,1,2014,14,16222,3058,19280
1,17,10,1,2014,15,16128,3101,19229
1,17,10,1,2014,16,15815,3102,18917
1,17,10,1,2014,17,14869,3030,17899
1,17,10,1,2014,18,14490,2880,17370
1,17,10,1,2014,19,14529,2855,17384
1,17,10,1,2014,20,15094,2850,17944
1,17,10,1,2014,21,14199,2797,16996
1,17,10,1,2014,22,13510,2702,16212
1,17,10,1,2014,23,13441,2618,16059
1,17,10,1,2014,24,13535,2562,16097
2,18,10,1,2014,1,14485,2396,16881
2,18,10,1,2014,2,14443,2208,16651
2,18,10,1,2014,3,14543,2077,16620
2,18,10,1,2014,4,14120,1973,16093
2,18,10,1,2014,5,14605,1929,16534
2,18,10,1,2014,6,15184,1934,17118
2,18,10,1,2014,7,15486,1917,17403
2,18,10,1,2014,8,14438,1933,16371
2,18,10,1,2014,9,14323,2024,16347
2,18,10,1,2014,10,15380,2180,17560
2,18,10,1,2014,11,15905,2308,18213
2,18,10,1,2014,12,16923,2373,19296
2,18,10,1,2014,13,16751,2402,19153
2,18,10,1,2014,14,16777,2373,19150
2,18,10,1,2014,15,16776,2363,19139
2,18,10,1,2014,16,15434,2379,17813
2,18,10,1,2014,17,15029,2363,17392
2,18,10,1,2014,18,14305,2297,16602
2,18,10,1,2014,19,14699,2429,17128
2,18,10,1,2014,20,14860,2500,17360
2,18,10,1,2014,21,14482,2483,16965
2,18,10,1,2014,22,14417,2510,16927
2,18,10,1,2014,23,14111,2494,16605
2,18,10,1,2014,24,13971,2484,16455
2,19,10,1,2014,1,15055,2158,17213
2,19,10,1,2014,2,14597,2108,16705
2,19,10,1,2014,3,14343,2075,16418
2,19,10,1,2014,4,14499,1977,16476
2,19,10,1,2014,5,14944,1938,16882
2,19,10,1,2014,6,15817,1975,17792
2,19,10,1,2014,7,15504,2022,17526
2,19,10,1,2014,8,14992,2146,17138
2,19,10,1,2014,9,14604,2456,17060
2,19,10,1,2014,10,15358,2821,18179
2,19,10,1,2014,11,15936,3095,19031
2,19,10,1,2014,12,16721,3201,19922
2,19,10,1,2014,13,17027,3215,20242
2,19,10,1,2014,14,16800,3156,19956
2,19,10,1,2014,15,16844,3213,20057
2,19,10,1,2014,16,16175,3219,19394
2,19,10,1,2014,17,15274,3197,18471
2,19,10,1,2014,18,14757,3094,17851
2,19,10,1,2014,19,15088,3094,18182
2,19,10,1,2014,20,15396,3052,18448
2,19,10,1,2014,21,15009,2891,17900
2,19,10,1,2014,22,14664,2770,17434
2,19,10,1,2014,23,14432,2653,17085
2,19,10,1,2014,24,14550,2598,17148
1,20,10,1,2014,1,14795,2479,17274
1,20,10,1,2014,2,14796,2281,17077
1,20,10,1,2014,3,14917,2130,17047
1,20,10,1,2014,4,15375,2036,17411
1,20,10,1,2014,5,14995,1986,16981
1,20,10,1,2014,6,15843,2009,17852
1,20,10,1,2014,7,15614,2110,17724
1,20,10,1,2014,8,15167,2161,17328
1,20,10,1,2014,9,14807,2441,17248
1,20,10,1,2014,10,15644,2816,18460
1,20,10,1,2014,11,15958,3071,19029
1,20,10,1,2014,12,16867,3157,20024
1,20,10,1,2014,13,16963,3171,20134
1,20,10,1,2014,14,16856,3115,19971
1,20,10,1,2014,15,16714,3162,19876
1,20,10,1,2014,16,16342,3171,19513
1,20,10,1,2014,17,15172,3154,18326
1,20,10,1,2014,18,14632,3053,17685
1,20,10,1,2014,19,15310,3075,18385
1,20,10,1,2014,20,15307,3075,18382
1,20,10,1,2014,21,14780,2927,17707
1,20,10,1,2014,22,14646,2801,17447
1,20,10,1,2014,23,14169,2795,16964
1,20,10,1,2014,24,13892,2642,16534
1,21,10,1,2014,1,14374,2524,16898
1,21,10,1,2014,2,14531,2281,16812
1,21,10,1,2014,3,15001,2120,17121
1,21,10,1,2014,4,14555,2027,16582
1,21,10,1,2014,5,15015,1983,16998
1,21,10,1,2014,6,15922,2038,17960
1,21,10,1,2014,7,15951,2091,18042
1,21,10,1,2014,8,15010,2168,17178
1,21,10,1,2014,9,14482,2370,16852
1,21,10,1,2014,10,15120,2754,17874
1,21,10,1,2014,11,15382,2993,18375
1,21,10,1,2014,12,16433,3065,19498
1,21,10,1,2014,13,16441,3080,19521
1,21,10,1,2014,14,16659,3051,19710
1,21,10,1,2014,15,16272,3080,19352
1,21,10,1,2014,16,15524,3078,18602
1,21,10,1,2014,17,14553,3044,17597
1,21,10,1,2014,18,14131,2907,17038
1,21,10,1,2014,19,14954,2976,17930
1,21,10,1,2014,20,14903,2966,17869
1,21,10,1,2014,21,14514,2830,17344
1,21,10,1,2014,22,14454,2711,17165
1,21,10,1,2014,23,13699,2697,16396
1,21,10,1,2014,24,13955,2659,16614
1,22,10,1,2014,1,14145,2510,16655
1,22,10,1,2014,2,14254,2299,16553
1,22,10,1,2014,3,14447,2134,16581
1,22,10,1,2014,4,14238,2026,16264
1,22,10,1,2014,5,14416,1970,16386
1,22,10,1,2014,6,15100,1990,17090
1,22,10,1,2014,7,15261,1971,17232
1,22,10,1,2014,8,13719,1954,15673
1,22,10,1,2014,9,13207,2017,15224
1,22,10,1,2014,10,14047,2135,16182
1,22,10,1,2014,11,14005,2248,16253
1,22,10,1,2014,12,15357,2305,17662
1,22,10,1,2014,13,14841,2314,17155
1,22,10,1,2014,14,14692,2273,16965
1,22,10,1,2014,15,14683,2275,16958
1,22,10,1,2014,16,14130,2306,16436
1,22,10,1,2014,17,12411,2252,14663
1,22,10,1,2014,18,12470,2244,14714
1,22,10,1,2014,19,13001,2526,15527
1,22,10,1,2014,20,13231,2671,15902
1,22,10,1,2014,21,13215,2626,15841
1,22,10,1,2014,22,12513,2601,15114
1,22,10,1,2014,23,12181,2594,14775
1,22,10,1,2014,24,12101,2551,14652
3,23,10,1,2014,1,12530,2431,14961
3,23,10,1,2014,2,12975,2231,15206
3,23,10,1,2014,3,12812,2092,14904
3,23,10,1,2014,4,13084,1994,15078
3,23,10,1,2014,5,13523,1949,15472
3,23,10,1,2014,6,13949,1983,15932
3,23,10,1,2014,7,14227,1982,16209
3,23,10,1,2014,8,13248,1971,15219
3,23,10,1,2014,9,13146,2056,15202
3,23,10,1,2014,10,13453,2187,15640
3,23,10,1,2014,11,13847,2288,16135
3,23,10,1,2014,12,14781,2306,17087
3,23,10,1,2014,13,14646,2280,16926
3,23,10,1,2014,14,14588,2230,16818
3,23,10,1,2014,15,14367,2251,16618
3,23,10,1,2014,16,13719,2267,15986
3,23,10,1,2014,17,12460,2234,14694
3,23,10,1,2014,18,12395,2226,14621
3,23,10,1,2014,19,13100,2424,15524
3,23,10,1,2014,20,13062,2479,15541
3,23,10,1,2014,21,12850,2458,15308
3,23,10,1,2014,22,12493,2447,14940
3,23,10,1,2014,23,12092,2387,14479
3,23,10,1,2014,24,12084,2352,14436
3,24,10,1,2014,1,12421,2234,14655
3,24,10,1,2014,2,12577,2063,14640
3,24,10,1,2014,3,12569,1943,14512
3,24,10,1,2014,4,12874,1860,14734
3,24,10,1,2014,5,12949,1823,14772
3,24,10,1,2014,6,13540,1841,15381
3,24,10,1,2014,7,14066,1833,15899
3,24,10,1,2014,8,13349,1837,15186
3,24,10,1,2014,9,12894,1934,14828
3,24,10,1,2014,10,13146,2074,15220
3,24,10,1,2014,11,13339,2194,15533
3,24,10,1,2014,12,13802,2220,16022
3,24,10,1,2014,13,13764,2180,15944
3,24,10,1,2014,14,13344,2082,15426
3,24,10,1,2014,15,13139,2030,15169
3,24,10,1,2014,16,12879,1995,14874
3,24,10,1,2014,17,12036,1951,13987
3,24,10,1,2014,18,12048,1968,14016
3,24,10,1,2014,19,12409,2203,14612
3,24,10,1,2014,20,12636,2271,14907
3,24,10,1,2014,21,12132,2209,14341
3,24,10,1,2014,22,11297,2187,13484
3,24,10,1,2014,23,10846,2094,12940
3,24,10,1,2014,24,10125,2083,12208
2,25,10,1,2014,1,11107,1890,12997
2,25,10,1,2014,2,11502,1748,13250
2,25,10,1,2014,3,11394,1667,13061
2,25,10,1,2014,4,11238,1607,12845
2,25,10,1,2014,5,11483,1587,13070
2,25,10,1,2014,6,12050,1636,13686
2,25,10,1,2014,7,12556,1633,14189
2,25,10,1,2014,8,12355,1641,13996
2,25,10,1,2014,9,12004,1701,13705
2,25,10,1,2014,10,12180,1797,13977
2,25,10,1,2014,11,12653,1884,14537
2,25,10,1,2014,12,13359,1914,15273
2,25,10,1,2014,13,13528,1917,15445
2,25,10,1,2014,14,13499,1876,15375
2,25,10,1,2014,15,13070,1836,14906
2,25,10,1,2014,16,13336,1820,15156
2,25,10,1,2014,17,12261,1812,14073
2,25,10,1,2014,18,12501,1901,14402
2,25,10,1,2014,19,12965,2120,15085
2,25,10,1,2014,20,12783,2195,14978
2,25,10,1,2014,21,12534,2162,14696
2,25,10,1,2014,22,11670,2154,13824
2,25,10,1,2014,23,11222,2086,13308
2,25,10,1,2014,24,11227,2018,13245
2,26,10,1,2014,1,11596,1888,13484
2,26,10,1,2014,2,11704,1734,13438
2,26,10,1,2014,3,11768,1659,13427
2,26,10,1,2014,4,11599,1614,13213
2,26,10,1,2014,5,11815,1610,13425
2,26,10,1,2014,6,12432,1671,14103
2,26,10,1,2014,7,13094,1751,14845
2,26,10,1,2014,8,13074,1895,14969
2,26,10,1,2014,9,12790,2188,14978
2,26,10,1,2014,10,13363,2537,15900
2,26,10,1,2014,11,13656,2727,16383
2,26,10,1,2014,12,14942,2748,17690
2,26,10,1,2014,13,14758,2722,17480
2,26,10,1,2014,14,14696,2611,17307
2,26,10,1,2014,15,14536,2607,17143
2,26,10,1,2014,16,14358,2599,16957
2,26,10,1,2014,17,13493,2595,16088
2,26,10,1,2014,18,13090,2583,15673
2,26,10,1,2014,19,13709,2632,16341
2,26,10,1,2014,20,13667,2615,16282
2,26,10,1,2014,21,13206,2490,15696
2,26,10,1,2014,22,12662,2352,15014
2,26,10,1,2014,23,12133,2221,14354
2,26,10,1,2014,24,12117,2079,14196
1,27,10,1,2014,1,12410,1921,14331
1,27,10,1,2014,2,12661,1762,14423
1,27,10,1,2014,3,12752,1670,14422
1,27,10,1,2014,4,12663,1623,14286
1,27,10,1,2014,5,12828,1616,14444
1,27,10,1,2014,6,13724,1671,15395
1,27,10,1,2014,7,14347,1809,16156
1,27,10,1,2014,8,14203,1916,16119
1,27,10,1,2014,9,13309,2213,15522
1,27,10,1,2014,10,14200,2579,16779
1,27,10,1,2014,11,14835,2811,17646
1,27,10,1,2014,12,15634,2879,18513
1,27,10,1,2014,13,15746,2870,18616
1,27,10,1,2014,14,15875,2753,18628
1,27,10,1,2014,15,15382,2790,18172
1,27,10,1,2014,16,15430,2799,18229
1,27,10,1,2014,17,14491,2792,17283
1,27,10,1,2014,18,13748,2743,16491
1,27,10,1,2014,19,14229,2777,17006
1,27,10,1,2014,20,14157,2739,16896
1,27,10,1,2014,21,13686,2586,16272
1,27,10,1,2014,22,12988,2442,15430
1,27,10,1,2014,23,12355,2313,14668
1,27,10,1,2014,24,12203,2186,14389
1,28,10,1,2014,1,12761,2002,14763
1,28,10,1,2014,2,13111,1837,14948
1,28,10,1,2014,3,13059,1740,14799
1,28,10,1,2014,4,12966,1672,14638
1,28,10,1,2014,5,13385,1645,15030
1,28,10,1,2014,6,13956,1713,15669
1,28,10,1,2014,7,14502,1789,16291
1,28,10,1,2014,8,14067,1947,16014
1,28,10,1,2014,9,13621,2249,15870
1,28,10,1,2014,10,14845,2597,17442
1,28,10,1,2014,11,14913,2851,17764
1,28,10,1,2014,12,15567,2923,18490
1,28,10,1,2014,13,15895,2898,18793
1,28,10,1,2014,14,15809,2791,18600
1,28,10,1,2014,15,15806,2815,18621
1,28,10,1,2014,16,15013,2839,17852
1,28,10,1,2014,17,14261,2815,17076
1,28,10,1,2014,18,13675,2753,16428
1,28,10,1,2014,19,14211,2788,16999
1,28,10,1,2014,20,14112,2764,16876
1,28,10,1,2014,21,13411,2628,16039
1,28,10,1,2014,22,12997,2443,15440
1,28,10,1,2014,23,12581,2344,14925
1,28,10,1,2014,24,12504,2284,14788
1,29,10,1,2014,1,12795,2057,14852
1,29,10,1,2014,2,13134,1874,15008
1,29,10,1,2014,3,13274,1772,15046
1,29,10,1,2014,4,13051,1706,14757
1,29,10,1,2014,5,13494,1685,15179
1,29,10,1,2014,6,13692,1736,15428
1,29,10,1,2014,7,14425,1810,16235
1,29,10,1,2014,8,13823,1955,15778
1,29,10,1,2014,9,13455,2239,15694
1,29,10,1,2014,10,14633,2613,17246
1,29,10,1,2014,11,14834,2827,17661
1,29,10,1,2014,12,16150,2890,19040
1,29,10,1,2014,13,15897,2854,18751
1,29,10,1,2014,14,15543,2739,18282
1,29,10,1,2014,15,15722,2779,18501
1,29,10,1,2014,16,15106,2784,17890
1,29,10,1,2014,17,14107,2780,16887
1,29,10,1,2014,18,14120,2736,16856
1,29,10,1,2014,19,14297,2790,17087
1,29,10,1,2014,20,14025,2761,16786
1,29,10,1,2014,21,13978,2598,16576
1,29,10,1,2014,22,12542,2449,14991
1,29,10,1,2014,23,12592,2329,14921
1,29,10,1,2014,24,12308,2232,14540
1,30,10,1,2014,1,13070,2045,15115
1,30,10,1,2014,2,13346,1871,15217
1,30,10,1,2014,3,13174,1770,14944
1,30,10,1,2014,4,13394,1702,15096
1,30,10,1,2014,5,13298,1683,14981
1,30,10,1,2014,6,14021,1737,15758
1,30,10,1,2014,7,14529,1798,16327
1,30,10,1,2014,8,14271,1939,16210
1,30,10,1,2014,9,13823,2221,16044
1,30,10,1,2014,10,14588,2631,17219
1,30,10,1,2014,11,15168,2865,18033
1,30,10,1,2014,12,16616,2913,19529
1,30,10,1,2014,13,16329,2881,19210
1,30,10,1,2014,14,16041,2757,18798
1,30,10,1,2014,15,15756,2780,18536
1,30,10,1,2014,16,15407,2798,18205
1,30,10,1,2014,17,14593,2776,17369
1,30,10,1,2014,18,14002,2719,16721
1,30,10,1,2014,19,14080,2773,16853
1,30,10,1,2014,20,13965,2763,16728
1,30,10,1,2014,21,13417,2605,16022
1,30,10,1,2014,22,13310,2481,15791
1,30,10,1,2014,23,12769,2369,15138
1,30,10,1,2014,24,12274,2287,14561
2,1,11,1,2014,1,13097,2062,15159
2,1,11,1,2014,2,13444,1895,15339
2,1,11,1,2014,3,13409,1796,15205
2,1,11,1,2014,4,13471,1740,15211
2,1,11,1,2014,5,13497,1726,15223
2,1,11,1,2014,6,13930,1770,15700
2,1,11,1,2014,7,14859,1798,16657
2,1,11,1,2014,8,14693,1884,16577
2,1,11,1,2014,9,14249,2102,16351
2,1,11,1,2014,10,15331,2442,17773
2,1,11,1,2014,11,15468,2677,18145
2,1,11,1,2014,12,16580,2753,19333
2,1,11,1,2014,13,16755,2738,19493
2,1,11,1,2014,14,16711,2629,19340
2,1,11,1,2014,15,16637,2636,19273
2,1,11,1,2014,16,16063,2637,18700
2,1,11,1,2014,17,14804,2616,17420
2,1,11,1,2014,18,14290,2526,16816
2,1,11,1,2014,19,14051,2658,16709
2,1,11,1,2014,20,14203,2606,16809
2,1,11,1,2014,21,13592,2552,16144
2,1,11,1,2014,22,13177,2464,15641
2,1,11,1,2014,23,12630,2335,14965
2,1,11,1,2014,24,12761,2257,15018
2,2,11,1,2014,1,13284,2087,15371
2,2,11,1,2014,2,13753,1930,15683
2,2,11,1,2014,3,13386,1821,15207
2,2,11,1,2014,4,13537,1756,15293
2,2,11,1,2014,5,13986,1725,15711
2,2,11,1,2014,6,14029,1745,15774
2,2,11,1,2014,7,15023,1764,16787
2,2,11,1,2014,8,13867,1748,15615
2,2,11,1,2014,9,13481,1827,15308
2,2,11,1,2014,10,14496,1951,16447
2,2,11,1,2014,11,15117,2058,17175
2,2,11,1,2014,12,15714,2125,17839
2,2,11,1,2014,13,15681,2145,17826
2,2,11,1,2014,14,15761,2090,17851
2,2,11,1,2014,15,15675,2079,17754
2,2,11,1,2014,16,15215,2055,17270
2,2,11,1,2014,17,13842,2039,15881
2,2,11,1,2014,18,13706,2081,15787
2,2,11,1,2014,19,13935,2191,16126
2,2,11,1,2014,20,13651,2317,15968
2,2,11,1,2014,21,13276,2319,15595
2,2,11,1,2014,22,12858,2234,15092
2,2,11,1,2014,23,12405,2180,14585
2,2,11,1,2014,24,12477,2197,14674
1,3,11,1,2014,1,13143,2040,15183
1,3,11,1,2014,2,13291,1874,15165
1,3,11,1,2014,3,13547,1787,15334
1,3,11,1,2014,4,13321,1719,15040
1,3,11,1,2014,5,13751,1690,15441
1,3,11,1,2014,6,14218,1749,15967
1,3,11,1,2014,7,14910,1816,16726
1,3,11,1,2014,8,14580,1943,16523
1,3,11,1,2014,9,14209,2234,16443
1,3,11,1,2014,10,15575,2629,18204
1,3,11,1,2014,11,15980,2889,18869
1,3,11,1,2014,12,16912,2986,19898
1,3,11,1,2014,13,17035,2963,19998
1,3,11,1,2014,14,16622,2902,19524
1,3,11,1,2014,15,16612,2938,19550
1,3,11,1,2014,16,16105,2944,19049
1,3,11,1,2014,17,15121,2944,18065
1,3,11,1,2014,18,14184,2881,17065
1,3,11,1,2014,19,14592,2910,17502
1,3,11,1,2014,20,14311,2848,17159
1,3,11,1,2014,21,13799,2702,16501
1,3,11,1,2014,22,13481,2561,16042
1,3,11,1,2014,23,12807,2427,15234
1,3,11,1,2014,24,12690,2337,15027
3,4,11,1,2014,1,13268,2167,15435
3,4,11,1,2014,2,13767,1985,15752
3,4,11,1,2014,3,13792,1858,15650
3,4,11,1,2014,4,13571,1790,15361
3,4,11,1,2014,5,13776,1760,15536
3,4,11,1,2014,6,14680,1812,16492
3,4,11,1,2014,7,15359,1854,17213
3,4,11,1,2014,8,14741,1975,16716
3,4,11,1,2014,9,14103,2206,16309
3,4,11,1,2014,10,15583,2553,18136
3,4,11,1,2014,11,15886,2747,18633
3,4,11,1,2014,12,17144,2844,19988
3,4,11,1,2014,13,16967,2839,19806
3,4,11,1,2014,14,16775,2761,19536
3,4,11,1,2014,15,16623,2779,19402
3,4,11,1,2014,16,15904,2803,18707
3,4,11,1,2014,17,14795,2765,17560
3,4,11,1,2014,18,14290,2725,17015
3,4,11,1,2014,19,14409,2770,17179
3,4,11,1,2014,20,14094,2739,16833
3,4,11,1,2014,21,13831,2635,16466
3,4,11,1,2014,22,13236,2533,15769
3,4,11,1,2014,23,12955,2445,15400
3,4,11,1,2014,24,12867,2374,15241
1,5,11,1,2014,1,13771,2079,15850
1,5,11,1,2014,2,13995,1902,15897
1,5,11,1,2014,3,14162,1785,15947
1,5,11,1,2014,4,14113,1724,15837
1,5,11,1,2014,5,14469,1700,16169
1,5,11,1,2014,6,15148,1759,16907
1,5,11,1,2014,7,15461,1836,17297
1,5,11,1,2014,8,15048,1973,17021
1,5,11,1,2014,9,14494,2267,16761
1,5,11,1,2014,10,15376,2606,17982
1,5,11,1,2014,11,15821,2836,18657
1,5,11,1,2014,12,16836,2915,19751
1,5,11,1,2014,13,16407,2978,19385
1,5,11,1,2014,14,16385,2815,19200
1,5,11,1,2014,15,16727,2860,19587
1,5,11,1,2014,16,16408,2880,19288
1,5,11,1,2014,17,15100,2884,17984
1,5,11,1,2014,18,14697,2829,17526
1,5,11,1,2014,19,14859,2865,17724
1,5,11,1,2014,20,14728,2799,17527
1,5,11,1,2014,21,14045,2708,16753
1,5,11,1,2014,22,13643,2553,16196
1,5,11,1,2014,23,13150,2414,15564
1,5,11,1,2014,24,13351,2354,15705
3,6,11,1,2014,1,13724,2179,15903
3,6,11,1,2014,2,14147,1992,16139
3,6,11,1,2014,3,14115,1898,16013
3,6,11,1,2014,4,14092,1842,15934
3,6,11,1,2014,5,14356,1813,16169
3,6,11,1,2014,6,15147,1877,17024
3,6,11,1,2014,7,15303,1925,17228
3,6,11,1,2014,8,14933,2048,16981
3,6,11,1,2014,9,14610,2309,16919
3,6,11,1,2014,10,15466,2611,18077
3,6,11,1,2014,11,16295,2849,19144
3,6,11,1,2014,12,17176,2889,20065
3,6,11,1,2014,13,17427,2886,20313
3,6,11,1,2014,14,16844,2788,19632
3,6,11,1,2014,15,16663,2837,19500
3,6,11,1,2014,16,16114,2875,18989
3,6,11,1,2014,17,14915,2822,17737
3,6,11,1,2014,18,14260,2791,17051
3,6,11,1,2014,19,14987,2848,17835
3,6,11,1,2014,20,14463,2810,17273
3,6,11,1,2014,21,14413,2618,17031
3,6,11,1,2014,22,13435,2515,15950
3,6,11,1,2014,23,13127,2380,15507
3,6,11,1,2014,24,13050,2147,15197
1,7,11,1,2014,1,13857,2045,15902
1,7,11,1,2014,2,13976,1890,15866
1,7,11,1,2014,3,14025,1785,15810
1,7,11,1,2014,4,14019,1724,15743
1,7,11,1,2014,5,14291,1716,16007
1,7,11,1,2014,6,15039,1786,16825
1,7,11,1,2014,7,15509,1894,17403
1,7,11,1,2014,8,14759,2009,16768
1,7,11,1,2014,9,14095,2287,16382
1,7,11,1,2014,10,15431,2656,18087
1,7,11,1,2014,11,15451,2914,18365
1,7,11,1,2014,12,16629,3015,19644
1,7,11,1,2014,13,16661,2985,19646
1,7,11,1,2014,14,16594,2853,19447
1,7,11,1,2014,15,16212,2904,19116
1,7,11,1,2014,16,15502,2939,18441
1,7,11,1,2014,17,14615,2929,17544
1,7,11,1,2014,18,14007,2838,16845
1,7,11,1,2014,19,14324,2859,17183
1,7,11,1,2014,20,14158,2800,16958
1,7,11,1,2014,21,13667,2629,16296
1,7,11,1,2014,22,13289,2402,15691
1,7,11,1,2014,23,13168,2285,15453
1,7,11,1,2014,24,12968,2203,15171
2,8,11,1,2014,1,13714,2019,15733
2,8,11,1,2014,2,13727,1857,15584
2,8,11,1,2014,3,14074,1744,15818
2,8,11,1,2014,4,13923,1693,15616
2,8,11,1,2014,5,14165,1705,15870
2,8,11,1,2014,6,14978,1764,16742
2,8,11,1,2014,7,15527,1834,17361
2,8,11,1,2014,8,14619,1945,16564
2,8,11,1,2014,9,14309,2126,16435
2,8,11,1,2014,10,15241,2446,17687
2,8,11,1,2014,11,15337,2661,17998
2,8,11,1,2014,12,16640,2754,19394
2,8,11,1,2014,13,16320,2756,19076
2,8,11,1,2014,14,16004,2633,18637
2,8,11,1,2014,15,16464,2653,19117
2,8,11,1,2014,16,15732,2653,18385
2,8,11,1,2014,17,14937,2595,17532
2,8,11,1,2014,18,14371,2556,16927
2,8,11,1,2014,19,14674,2673,17347
2,8,11,1,2014,20,14480,2639,17119
2,8,11,1,2014,21,13877,2566,16443
2,8,11,1,2014,22,13344,2430,15774
2,8,11,1,2014,23,12900,2278,15178
2,8,11,1,2014,24,12716,2177,14893
2,9,11,1,2014,1,13698,2093,15791
2,9,11,1,2014,2,13752,1920,15672
2,9,11,1,2014,3,13783,1801,15584
2,9,11,1,2014,4,13868,1725,15593
2,9,11,1,2014,5,14364,1689,16053
2,9,11,1,2014,6,14908,1737,16645
2,9,11,1,2014,7,15140,1756,16896
2,9,11,1,2014,8,14509,1774,16283
2,9,11,1,2014,9,14274,1850,16124
2,9,11,1,2014,10,15205,1973,17178
2,9,11,1,2014,11,15387,2093,17480
2,9,11,1,2014,12,16155,2122,18277
2,9,11,1,2014,13,16222,2116,18338
2,9,11,1,2014,14,16379,2059,18438
2,9,11,1,2014,15,16391,2041,18432
2,9,11,1,2014,16,15630,2027,17657
2,9,11,1,2014,17,14203,2023,16226
2,9,11,1,2014,18,14295,2041,16336
2,9,11,1,2014,19,13981,2288,16269
2,9,11,1,2014,20,13978,2327,16305
2,9,11,1,2014,21,13184,2313,15497
2,9,11,1,2014,22,12994,2286,15280
2,9,11,1,2014,23,12094,2258,14352
2,9,11,1,2014,24,12323,2205,14528
1,10,11,1,2014,1,13642,2059,15701
1,10,11,1,2014,2,13669,1888,15557
1,10,11,1,2014,3,13539,1788,15327
1,10,11,1,2014,4,13684,1722,15406
1,10,11,1,2014,5,13777,1702,15479
1,10,11,1,2014,6,15033,1774,16807
1,10,11,1,2014,7,15593,1898,17491
1,10,11,1,2014,8,15176,2026,17202
1,10,11,1,2014,9,14743,2266,17009
1,10,11,1,2014,10,15721,2579,18300
1,10,11,1,2014,11,16238,2854,19092
1,10,11,1,2014,12,17464,2956,20420
1,10,11,1,2014,13,17208,2936,20144
1,10,11,1,2014,14,17210,2840,20050
1,10,11,1,2014,15,17166,2887,20053
1,10,11,1,2014,16,16399,2925,19324
1,10,11,1,2014,17,15446,2906,18352
1,10,11,1,2014,18,15160,2864,18024
1,10,11,1,2014,19,14482,2877,17359
1,10,11,1,2014,20,14433,2815,17248
1,10,11,1,2014,21,14787,2644,17431
1,10,11,1,2014,22,13461,2515,15976
1,10,11,1,2014,23,13203,2431,15634
1,10,11,1,2014,24,12929,2328,15257
1,11,11,1,2014,1,13830,2143,15973
1,11,11,1,2014,2,14112,1952,16064
1,11,11,1,2014,3,14436,1835,16271
1,11,11,1,2014,4,14296,1773,16069
1,11,11,1,2014,5,14339,1753,16092
1,11,11,1,2014,6,15228,1832,17060
1,11,11,1,2014,7,15849,1963,17812
1,11,11,1,2014,8,14964,2097,17061
1,11,11,1,2014,9,14816,2375,17191
1,11,11,1,2014,10,15869,2767,18636
1,11,11,1,2014,11,16421,3007,19428
1,11,11,1,2014,12,17096,3096,20192
1,11,11,1,2014,13,16947,3092,20039
1,11,11,1,2014,14,17278,2972,20250
1,11,11,1,2014,15,16812,3017,19829
1,11,11,1,2014,16,16748,3058,19806
1,11,11,1,2014,17,15114,3037,18151
1,11,11,1,2014,18,14707,2959,17666
1,11,11,1,2014,19,15321,2990,18311
1,11,11,1,2014,20,14969,2929,17898
1,11,11,1,2014,21,14269,2792,17061
1,11,11,1,2014,22,13788,2661,16449
1,11,11,1,2014,23,13387,2544,15931
1,11,11,1,2014,24,13266,2438,15704
1,12,11,1,2014,1,13837,2266,16103
1,12,11,1,2014,2,14047,2058,16105
1,12,11,1,2014,3,14024,1939,15963
1,12,11,1,2014,4,13878,1861,15739
1,12,11,1,2014,5,14278,1846,16124
1,12,11,1,2014,6,14964,1925,16889
1,12,11,1,2014,7,15240,2050,17290
1,12,11,1,2014,8,14819,2186,17005
1,12,11,1,2014,9,14412,2457,16869
1,12,11,1,2014,10,16200,2790,18990
1,12,11,1,2014,11,16229,3082,19311
1,12,11,1,2014,12,17325,3165,20490
1,12,11,1,2014,13,17293,3135,20428
1,12,11,1,2014,14,17411,3032,20443
1,12,11,1,2014,15,17237,3073,20310
1,12,11,1,2014,16,17213,3093,20306
1,12,11,1,2014,17,15116,3069,18185
1,12,11,1,2014,18,14959,2991,17950
1,12,11,1,2014,19,15074,3036,18110
1,12,11,1,2014,20,14777,2956,17733
1,12,11,1,2014,21,14905,2806,17711
1,12,11,1,2014,22,13722,2702,16424
1,12,11,1,2014,23,13486,2632,16118
1,12,11,1,2014,24,13465,2547,16012
1,13,11,1,2014,1,14010,2340,16350
1,13,11,1,2014,2,14140,2124,16264
1,13,11,1,2014,3,14366,1984,16350
1,13,11,1,2014,4,13926,1894,15820
1,13,11,1,2014,5,14586,1877,16463
1,13,11,1,2014,6,15048,1947,16995
1,13,11,1,2014,7,15490,2064,17554
1,13,11,1,2014,8,15196,2196,17392
1,13,11,1,2014,9,14552,2474,17026
1,13,11,1,2014,10,15263,2821,18084
1,13,11,1,2014,11,15630,3073,18703
1,13,11,1,2014,12,16524,3157,19681
1,13,11,1,2014,13,16309,3139,19448
1,13,11,1,2014,14,16189,3059,19248
1,13,11,1,2014,15,16004,3117,19121
1,13,11,1,2014,16,15672,3121,18793
1,13,11,1,2014,17,14316,3109,17425
1,13,11,1,2014,18,13968,3018,16986
1,13,11,1,2014,19,14381,3065,17446
1,13,11,1,2014,20,13995,2996,16991
1,13,11,1,2014,21,13849,2781,16630
1,13,11,1,2014,22,13150,2784,15934
1,13,11,1,2014,23,12761,2606,15367
1,13,11,1,2014,24,12770,2531,15301
1,14,11,1,2014,1,13225,2332,15557
1,14,11,1,2014,2,13499,2126,15625
1,14,11,1,2014,3,13563,1999,15562
1,14,11,1,2014,4,13602,1922,15524
1,14,11,1,2014,5,13925,1906,15831
1,14,11,1,2014,6,14649,1968,16617
1,14,11,1,2014,7,15147,2069,17216
1,14,11,1,2014,8,14487,2175,16662
1,14,11,1,2014,9,14285,2445,16730
1,14,11,1,2014,10,14613,2824,17437
1,14,11,1,2014,11,14948,3024,17972
1,14,11,1,2014,12,15460,3065,18525
1,14,11,1,2014,13,15369,3065,18434
1,14,11,1,2014,14,14989,2945,17934
1,14,11,1,2014,15,14617,3001,17618
1,14,11,1,2014,16,14070,3030,17100
1,14,11,1,2014,17,13331,2986,16317
1,14,11,1,2014,18,13447,2945,16392
1,14,11,1,2014,19,13635,2989,16624
1,14,11,1,2014,20,13349,2896,16245
1,14,11,1,2014,21,13428,2674,16102
1,14,11,1,2014,22,12188,2518,14706
1,14,11,1,2014,23,12210,2445,14655
1,14,11,1,2014,24,11872,2381,14253
2,15,11,1,2014,1,11792,2234,14026
2,15,11,1,2014,2,11331,2052,13383
2,15,11,1,2014,3,11548,1928,13476
2,15,11,1,2014,4,11682,1843,13525
2,15,11,1,2014,5,11683,1810,13493
2,15,11,1,2014,6,12098,1866,13964
2,15,11,1,2014,7,12787,1925,14712
2,15,11,1,2014,8,12489,2003,14492
2,15,11,1,2014,9,12540,2248,14788
2,15,11,1,2014,10,12734,2583,15317
2,15,11,1,2014,11,13159,2771,15930
2,15,11,1,2014,12,13770,2828,16598
2,15,11,1,2014,13,13629,2779,16408
2,15,11,1,2014,14,14021,2629,16650
2,15,11,1,2014,15,13668,2596,16264
2,15,11,1,2014,16,13569,2584,16153
2,15,11,1,2014,17,13319,2564,15883
2,15,11,1,2014,18,13752,2570,16322
2,15,11,1,2014,19,14005,2681,16686
2,15,11,1,2014,20,13856,2660,16516
2,15,11,1,2014,21,13142,2548,15690
2,15,11,1,2014,22,12528,2394,14922
2,15,11,1,2014,23,12269,2282,14551
2,15,11,1,2014,24,11873,2227,14100
2,16,11,1,2014,1,11682,2070,13752
2,16,11,1,2014,2,11661,1906,13567
2,16,11,1,2014,3,11457,1820,13277
2,16,11,1,2014,4,11557,1744,13301
2,16,11,1,2014,5,11891,1700,13591
2,16,11,1,2014,6,12343,1815,14158
2,16,11,1,2014,7,12872,1775,14647
2,16,11,1,2014,8,12886,1847,14733
2,16,11,1,2014,9,12702,1931,14633
2,16,11,1,2014,10,13403,2006,15409
2,16,11,1,2014,11,13551,2141,15692
2,16,11,1,2014,12,13858,2180,16038
2,16,11,1,2014,13,14085,2162,16247
2,16,11,1,2014,14,13629,2151,15780
2,16,11,1,2014,15,13862,2112,15974
2,16,11,1,2014,16,13231,2043,15274
2,16,11,1,2014,17,12918,2031,14949
2,16,11,1,2014,18,13237,2083,15320
2,16,11,1,2014,19,13804,2203,16007
2,16,11,1,2014,20,13320,2313,15633
2,16,11,1,2014,21,12588,2364,14952
2,16,11,1,2014,22,12279,2315,14594
2,16,11,1,2014,23,11978,2270,14248
2,16,11,1,2014,24,11872,2270,14142
1,17,11,1,2014,1,12114,2093,14207
1,17,11,1,2014,2,11879,1977,13856
1,17,11,1,2014,3,11920,1937,13857
1,17,11,1,2014,4,11231,1912,13143
1,17,11,1,2014,5,11829,1916,13745
1,17,11,1,2014,6,12479,1957,14436
1,17,11,1,2014,7,13327,2031,15358
1,17,11,1,2014,8,13196,2154,15350
1,17,11,1,2014,9,12575,2378,14953
1,17,11,1,2014,10,13520,2727,16247
1,17,11,1,2014,11,13734,2992,16726
1,17,11,1,2014,12,13827,3068,16895
1,17,11,1,2014,13,14027,3038,17065
1,17,11,1,2014,14,14019,2943,16962
1,17,11,1,2014,15,14063,2997,17060
1,17,11,1,2014,16,13750,3008,16758
1,17,11,1,2014,17,13598,2968,16566
1,17,11,1,2014,18,13157,2916,16073
1,17,11,1,2014,19,14301,2938,17239
1,17,11,1,2014,20,13622,2870,16492
1,17,11,1,2014,21,13260,2702,15962
1,17,11,1,2014,22,13024,2569,15593
1,17,11,1,2014,23,12480,2493,14973
1,17,11,1,2014,24,12256,2414,14670
1,18,11,1,2014,1,12366,2216,14582
1,18,11,1,2014,2,12232,2011,14243
1,18,11,1,2014,3,12568,1897,14465
1,18,11,1,2014,4,12515,1820,14335
1,18,11,1,2014,5,12768,1808,14576
1,18,11,1,2014,6,13158,1890,15048
1,18,11,1,2014,7,13529,2027,15556
1,18,11,1,2014,8,13712,2160,15872
1,18,11,1,2014,9,13320,2436,15756
1,18,11,1,2014,10,13422,2789,16211
1,18,11,1,2014,11,14072,3041,17113
1,18,11,1,2014,12,14338,3129,17467
1,18,11,1,2014,13,13967,3091,17058
1,18,11,1,2014,14,14194,3006,17200
1,18,11,1,2014,15,14226,3047,17273
1,18,11,1,2014,16,14290,3072,17362
1,18,11,1,2014,17,13802,3051,16853
1,18,11,1,2014,18,13499,3001,16500
1,18,11,1,2014,19,14570,3026,17596
1,18,11,1,2014,20,13910,2938,16848
1,18,11,1,2014,21,13767,2783,16550
1,18,11,1,2014,22,12927,2647,15574
1,18,11,1,2014,23,12589,2571,15160
1,18,11,1,2014,24,12147,2499,14646
1,19,11,1,2014,1,12441,2291,14732
1,19,11,1,2014,2,12150,2080,14230
1,19,11,1,2014,3,12291,1966,14257
1,19,11,1,2014,4,12254,1883,14137
1,19,11,1,2014,5,12507,1855,14362
1,19,11,1,2014,6,13250,1925,15175
1,19,11,1,2014,7,13977,2050,16027
1,19,11,1,2014,8,13850,2167,16017
1,19,11,1,2014,9,13734,2465,16199
1,19,11,1,2014,10,13864,2805,16669
1,19,11,1,2014,11,13968,3085,17053
1,19,11,1,2014,12,14519,3156,17675
1,19,11,1,2014,13,14473,3145,17618
1,19,11,1,2014,14,14369,3056,17425
1,19,11,1,2014,15,14431,3104,17535
1,19,11,1,2014,16,14355,3111,17466
1,19,11,1,2014,17,13966,3095,17061
1,19,11,1,2014,18,13528,3045,16573
1,19,11,1,2014,19,14420,3076,17496
1,19,11,1,2014,20,14199,2992,17191
1,19,11,1,2014,21,13582,2699,16281
1,19,11,1,2014,22,12877,2633,15510
1,19,11,1,2014,23,12619,2494,15113
1,19,11,1,2014,24,12511,2411,14922
1,20,11,1,2014,1,12421,2270,14691
1,20,11,1,2014,2,12237,2109,14346
1,20,11,1,2014,3,12105,1996,14101
1,20,11,1,2014,4,12208,1920,14128
1,20,11,1,2014,5,12209,1878,14087
1,20,11,1,2014,6,13227,1954,15181
1,20,11,1,2014,7,14127,2030,16157
1,20,11,1,2014,8,14315,2197,16512
1,20,11,1,2014,9,13950,2445,16395
1,20,11,1,2014,10,14150,2795,16945
1,20,11,1,2014,11,14347,3040,17387
1,20,11,1,2014,12,14577,3078,17655
1,20,11,1,2014,13,14389,3024,17413
1,20,11,1,2014,14,14227,2926,17153
1,20,11,1,2014,15,14447,2970,17417
1,20,11,1,2014,16,14451,2994,17445
1,20,11,1,2014,17,14039,2975,17014
1,20,11,1,2014,18,13474,2837,16311
1,20,11,1,2014,19,14209,2897,17106
1,20,11,1,2014,20,13786,2815,16601
1,20,11,1,2014,21,13364,2639,16003
1,20,11,1,2014,22,12753,2499,15252
1,20,11,1,2014,23,12041,2417,14458
1,20,11,1,2014,24,11961,2342,14303
1,21,11,1,2014,1,12193,2145,14338
1,21,11,1,2014,2,12251,1960,14211
1,21,11,1,2014,3,12044,1830,13874
1,21,11,1,2014,4,12269,1747,14016
1,21,11,1,2014,5,12625,1727,14352
1,21,11,1,2014,6,13373,1816,15189
1,21,11,1,2014,7,14027,1936,15963
1,21,11,1,2014,8,14267,2055,16322
1,21,11,1,2014,9,13909,2300,16209
1,21,11,1,2014,10,13979,2689,16668
1,21,11,1,2014,11,14234,2901,17135
1,21,11,1,2014,12,14460,2999,17459
1,21,11,1,2014,13,14154,2949,17103
1,21,11,1,2014,14,14455,2832,17287
1,21,11,1,2014,15,14277,2899,17176
1,21,11,1,2014,16,14312,2909,17221
1,21,11,1,2014,17,13752,2889,16641
1,21,11,1,2014,18,13130,2841,15971
1,21,11,1,2014,19,13725,2888,16613
1,21,11,1,2014,20,13984,2784,16768
1,21,11,1,2014,21,12957,2654,15611
1,21,11,1,2014,22,12419,2474,14893
1,21,11,1,2014,23,12073,2359,14432
1,21,11,1,2014,24,12079,2267,14346
2,22,11,1,2014,1,12371,2104,14475
2,22,11,1,2014,2,12044,1925,13969
2,22,11,1,2014,3,11967,1817,13784
2,22,11,1,2014,4,12479,1733,14212
2,22,11,1,2014,5,12598,1710,14308
2,22,11,1,2014,6,13099,1773,14872
2,22,11,1,2014,7,14207,1837,16044
2,22,11,1,2014,8,14277,1927,16204
2,22,11,1,2014,9,13987,2113,16100
2,22,11,1,2014,10,14666,2418,17084
2,22,11,1,2014,11,14964,2680,17644
2,22,11,1,2014,12,15089,2759,17848
2,22,11,1,2014,13,14933,2727,17660
2,22,11,1,2014,14,15171,2615,17786
2,22,11,1,2014,15,15192,2637,17829
2,22,11,1,2014,16,15160,2631,17791
2,22,11,1,2014,17,14663,2591,17254
2,22,11,1,2014,18,13760,2572,16332
2,22,11,1,2014,19,14329,2706,17035
2,22,11,1,2014,20,13628,2671,16299
2,22,11,1,2014,21,13488,2564,16052
2,22,11,1,2014,22,12627,2446,15073
2,22,11,1,2014,23,12252,2339,14591
2,22,11,1,2014,24,12431,2254,14685
2,23,11,1,2014,1,12396,2113,14509
2,23,11,1,2014,2,12393,1939,14332
2,23,11,1,2014,3,12344,1830,14174
2,23,11,1,2014,4,12245,1749,13994
2,23,11,1,2014,5,12711,1719,14430
2,23,11,1,2014,6,13145,1753,14898
2,23,11,1,2014,7,13859,1761,15620
2,23,11,1,2014,8,14589,1771,16360
2,23,11,1,2014,9,14462,1862,16324
2,23,11,1,2014,10,14580,1982,16562
2,23,11,1,2014,11,14884,2107,16991
2,23,11,1,2014,12,15162,2152,17314
2,23,11,1,2014,13,15241,2140,17381
2,23,11,1,2014,14,15176,2089,17265
2,23,11,1,2014,15,14990,2065,17055
2,23,11,1,2014,16,15082,2055,17137
2,23,11,1,2014,17,14314,2033,16347
2,23,11,1,2014,18,13388,2063,15451
2,23,11,1,2014,19,13931,2252,16183
2,23,11,1,2014,20,13561,2309,15870
2,23,11,1,2014,21,12885,2274,15159
2,23,11,1,2014,22,12394,2257,14651
2,23,11,1,2014,23,12080,2209,14289
2,23,11,1,2014,24,12205,2156,14361
1,24,11,1,2014,1,12252,2020,14272
1,24,11,1,2014,2,12266,1856,14122
1,24,11,1,2014,3,12267,1753,14020
1,24,11,1,2014,4,12399,1689,14088
1,24,11,1,2014,5,12374,1671,14045
1,24,11,1,2014,6,13383,1763,15146
1,24,11,1,2014,7,14006,1903,15909
1,24,11,1,2014,8,14899,2028,16927
1,24,11,1,2014,9,14792,2283,17075
1,24,11,1,2014,10,15000,2641,17641
1,24,11,1,2014,11,15200,2887,18087
1,24,11,1,2014,12,15678,2946,18624
1,24,11,1,2014,13,15360,2934,18294
1,24,11,1,2014,14,15353,2848,18201
1,24,11,1,2014,15,15689,2883,18572
1,24,11,1,2014,16,15258,2893,18151
1,24,11,1,2014,17,14751,2871,17622
1,24,11,1,2014,18,13632,2819,16451
1,24,11,1,2014,19,14145,2871,17016
1,24,11,1,2014,20,13918,2800,16718
1,24,11,1,2014,21,13127,2669,15796
1,24,11,1,2014,22,12651,2437,15088
1,24,11,1,2014,23,12478,2378,14856
1,24,11,1,2014,24,12143,2226,14369
1,25,11,1,2014,1,12652,2092,14744
1,25,11,1,2014,2,12428,1923,14351
1,25,11,1,2014,3,12200,1810,14010
1,25,11,1,2014,4,12397,1733,14130
1,25,11,1,2014,5,12937,1730,14667
1,25,11,1,2014,6,13688,1802,15490
1,25,11,1,2014,7,14851,1930,16781
1,25,11,1,2014,8,15244,2047,17291
1,25,11,1,2014,9,15197,2319,17516
1,25,11,1,2014,10,15255,2641,17896
1,25,11,1,2014,11,15651,2848,18499
1,25,11,1,2014,12,16111,2901,19012
1,25,11,1,2014,13,16135,2914,19049
1,25,11,1,2014,14,15333,2821,18154
1,25,11,1,2014,15,15918,2866,18784
1,25,11,1,2014,16,15402,2883,18285
1,25,11,1,2014,17,15069,2871,17940
1,25,11,1,2014,18,14166,2879,17045
1,25,11,1,2014,19,14722,2911,17633
1,25,11,1,2014,20,14130,2847,16977
1,25,11,1,2014,21,13968,2659,16627
1,25,11,1,2014,22,12859,2510,15369
1,25,11,1,2014,23,12501,2392,14893
1,25,11,1,2014,24,12210,2264,14474
1,26,11,1,2014,1,12573,2108,14681
1,26,11,1,2014,2,12600,1918,14518
1,26,11,1,2014,3,12400,1808,14208
1,26,11,1,2014,4,12491,1740,14231
1,26,11,1,2014,5,12803,1718,14521
1,26,11,1,2014,6,13671,1789,15460
1,26,11,1,2014,7,14899,1934,16833
1,26,11,1,2014,8,15069,2048,17117
1,26,11,1,2014,9,14771,2298,17069
1,26,11,1,2014,10,15381,2622,18003
1,26,11,1,2014,11,15285,2866,18151
1,26,11,1,2014,12,15382,2928,18310
1,26,11,1,2014,13,15801,2900,18701
1,26,11,1,2014,14,15410,2785,18195
1,26,11,1,2014,15,15234,2823,18057
1,26,11,1,2014,16,15210,2845,18055
1,26,11,1,2014,17,14480,2845,17325
1,26,11,1,2014,18,14008,2820,16828
1,26,11,1,2014,19,14558,2879,17437
1,26,11,1,2014,20,13793,2815,16608
1,26,11,1,2014,21,13169,2693,15862
1,26,11,1,2014,22,12685,2431,15116
1,26,11,1,2014,23,12375,2309,14684
1,26,11,1,2014,24,12435,2241,14676
1,27,11,1,2014,1,12702,2012,14714
1,27,11,1,2014,2,12573,1843,14416
1,27,11,1,2014,3,12343,1743,14086
1,27,11,1,2014,4,12371,1695,14066
1,27,11,1,2014,5,12907,1668,14575
1,27,11,1,2014,6,13254,1743,14997
1,27,11,1,2014,7,14194,1896,16090
1,27,11,1,2014,8,15162,2011,17173
1,27,11,1,2014,9,15203,2251,17454
1,27,11,1,2014,10,15051,2591,17642
1,27,11,1,2014,11,15312,2822,18134
1,27,11,1,2014,12,15779,2904,18683
1,27,11,1,2014,13,15614,2893,18507
1,27,11,1,2014,14,15547,2752,18299
1,27,11,1,2014,15,15514,2805,18319
1,27,11,1,2014,16,15343,2817,18160
1,27,11,1,2014,17,14836,2817,17653
1,27,11,1,2014,18,13756,2774,16530
1,27,11,1,2014,19,14183,2839,17022
1,27,11,1,2014,20,13818,2755,16573
1,27,11,1,2014,21,13487,2567,16054
1,27,11,1,2014,22,12280,2394,14674
1,27,11,1,2014,23,12148,2241,14389
1,27,11,1,2014,24,12022,2127,14149
1,28,11,1,2014,1,12420,1975,14395
1,28,11,1,2014,2,12227,1812,14039
1,28,11,1,2014,3,12243,1692,13935
1,28,11,1,2014,4,12309,1636,13945
1,28,11,1,2014,5,12608,1627,14235
1,28,11,1,2014,6,13552,1721,15273
1,28,11,1,2014,7,14401,1850,16251
1,28,11,1,2014,8,15398,1959,17357
1,28,11,1,2014,9,14601,2212,16813
1,28,11,1,2014,10,14796,2564,17360
1,28,11,1,2014,11,14873,2821,17694
1,28,11,1,2014,12,15598,2878,18476
1,28,11,1,2014,13,14816,2879,17695
1,28,11,1,2014,14,15059,2745,17804
1,28,11,1,2014,15,15164,2782,17946
1,28,11,1,2014,16,14884,2814,17698
1,28,11,1,2014,17,14250,2740,16990
1,28,11,1,2014,18,13332,2800,16132
1,28,11,1,2014,19,14103,2847,16950
1,28,11,1,2014,20,13820,2766,16586
1,28,11,1,2014,21,13138,2578,15716
1,28,11,1,2014,22,12407,2407,14814
1,28,11,1,2014,23,12059,2246,14305
1,28,11,1,2014,24,11978,2103,14081
2,29,11,1,2014,1,12395,1937,14332
2,29,11,1,2014,2,12377,1760,14137
2,29,11,1,2014,3,12245,1667,13912
2,29,11,1,2014,4,12170,1609,13779
2,29,11,1,2014,5,12697,1597,14294
2,29,11,1,2014,6,13534,1680,15214
2,29,11,1,2014,7,14645,1770,16415
2,29,11,1,2014,8,15016,1841,16857
2,29,11,1,2014,9,15096,2075,17171
2,29,11,1,2014,10,15495,2372,17867
2,29,11,1,2014,11,15981,2581,18562
2,29,11,1,2014,12,16488,2661,19149
2,29,11,1,2014,13,16340,2678,19018
2,29,11,1,2014,14,16418,2538,18956
2,29,11,1,2014,15,15982,2550,18532
2,29,11,1,2014,16,15918,2496,18414
2,29,11,1,2014,17,15304,2579,17883
2,29,11,1,2014,18,14233,2524,16757
2,29,11,1,2014,19,14264,2671,16935
2,29,11,1,2014,20,13937,2633,16570
2,29,11,1,2014,21,13503,2480,15983
2,29,11,1,2014,22,12316,2316,14632
2,29,11,1,2014,23,12306,2157,14463
2,29,11,1,2014,24,12079,2035,14114
2,30,11,1,2014,1,12592,1910,14502
2,30,11,1,2014,2,12357,1755,14112
2,30,11,1,2014,3,12172,1661,13833
2,30,11,1,2014,4,12333,1596,13929
2,30,11,1,2014,5,12580,1574,14154
2,30,11,1,2014,6,13308,1626,14934
2,30,11,1,2014,7,14021,1644,15665
2,30,11,1,2014,8,15000,1680,16680
2,30,11,1,2014,9,14932,1766,16698
2,30,11,1,2014,10,15145,1903,17048
2,30,11,1,2014,11,15434,2025,17459
2,30,11,1,2014,12,15785,2070,17855
2,30,11,1,2014,13,15871,2064,17935
2,30,11,1,2014,14,15336,1986,17322
2,30,11,1,2014,15,15298,1931,17229
2,30,11,1,2014,16,15051,1904,16955
2,30,11,1,2014,17,14225,1919,16144
2,30,11,1,2014,18,13241,1963,15204
2,30,11,1,2014,19,13774,2158,15932
2,30,11,1,2014,20,13483,2210,15693
2,30,11,1,2014,21,12996,2211,15207
2,30,11,1,2014,22,11782,2164,13946
2,30,11,1,2014,23,11592,2086,13678
2,30,11,1,2014,24,11693,1979,13672
1,1,12,1,2014,1,12145,1803,13948
1,1,12,1,2014,2,11932,1654,13586
1,1,12,1,2014,3,11842,1574,13416
1,1,12,1,2014,4,12008,1530,13538
1,1,12,1,2014,5,12441,1527,13968
1,1,12,1,2014,6,13039,1610,14649
1,1,12,1,2014,7,14597,1744,16341
1,1,12,1,2014,8,15188,1933,17121
1,1,12,1,2014,9,15301,2155,17456
1,1,12,1,2014,10,15186,2464,17650
1,1,12,1,2014,11,15359,2680,18039
1,1,12,1,2014,12,15252,2737,17989
1,1,12,1,2014,13,15586,2731,18317
1,1,12,1,2014,14,15099,2613,17712
1,1,12,1,2014,15,15336,2651,17987
1,1,12,1,2014,16,14886,2670,17556
1,1,12,1,2014,17,14238,2665,16903
1,1,12,1,2014,18,13679,2649,16328
1,1,12,1,2014,19,14042,2646,16688
1,1,12,1,2014,20,13700,2604,16304
1,1,12,1,2014,21,12998,2439,15437
1,1,12,1,2014,22,12127,2276,14403
1,1,12,1,2014,23,11838,2133,13971
1,1,12,1,2014,24,11775,2010,13785
1,2,12,1,2014,1,12050,1813,13863
1,2,12,1,2014,2,12058,1668,13726
1,2,12,1,2014,3,11874,1592,13466
1,2,12,1,2014,4,12215,1547,13762
1,2,12,1,2014,5,12796,1545,14341
1,2,12,1,2014,6,13418,1640,15058
1,2,12,1,2014,7,14859,1797,16656
1,2,12,1,2014,8,15226,1950,17176
1,2,12,1,2014,9,15305,2212,17517
1,2,12,1,2014,10,15599,2521,18120
1,2,12,1,2014,11,15520,2764,18284
1,2,12,1,2014,12,15493,2794,18287
1,2,12,1,2014,13,15834,2779,18613
1,2,12,1,2014,14,15362,2693,18055
1,2,12,1,2014,15,15477,2732,18209
1,2,12,1,2014,16,15270,2761,18031
1,2,12,1,2014,17,14964,2768,17732
1,2,12,1,2014,18,13733,2746,16479
1,2,12,1,2014,19,14097,2809,16906
1,2,12,1,2014,20,13923,2720,16643
1,2,12,1,2014,21,13096,2536,15632
1,2,12,1,2014,22,12722,2373,15095
1,2,12,1,2014,23,12009,2220,14229
1,2,12,1,2014,24,12189,2068,14257
1,3,12,1,2014,1,12582,1870,14452
1,3,12,1,2014,2,12589,1707,14296
1,3,12,1,2014,3,12721,1627,14348
1,3,12,1,2014,4,12525,1566,14091
1,3,12,1,2014,5,12862,1556,14418
1,3,12,1,2014,6,13633,1674,15307
1,3,12,1,2014,7,14419,1828,16247
1,3,12,1,2014,8,15291,1973,17264
1,3,12,1,2014,9,15653,2239,17892
1,3,12,1,2014,10,15596,2577,18173
1,3,12,1,2014,11,15619,2781,18400
1,3,12,1,2014,12,15952,2848,18800
1,3,12,1,2014,13,15520,2834,18354
1,3,12,1,2014,14,15355,2721,18076
1,3,12,1,2014,15,15583,2770,18353
1,3,12,1,2014,16,15780,2772,18552
1,3,12,1,2014,17,14791,2791,17582
1,3,12,1,2014,18,13443,2750,16193
1,3,12,1,2014,19,14309,2825,17134
1,3,12,1,2014,20,13682,2722,16404
1,3,12,1,2014,21,13405,2564,15969
1,3,12,1,2014,22,12709,2390,15099
1,3,12,1,2014,23,11933,2232,14165
1,3,12,1,2014,24,12271,2088,14359
1,4,12,1,2014,1,12597,1919,14516
1,4,12,1,2014,2,12481,1754,14235
1,4,12,1,2014,3,12527,1657,14184
1,4,12,1,2014,4,12456,1597,14053
1,4,12,1,2014,5,12468,1594,14062
1,4,12,1,2014,6,13580,1690,15270
1,4,12,1,2014,7,14590,1851,16441
1,4,12,1,2014,8,15207,2006,17213
1,4,12,1,2014,9,15745,2266,18011
1,4,12,1,2014,10,15577,2595,18172
1,4,12,1,2014,11,15841,2814,18655
1,4,12,1,2014,12,15945,2836,18781
1,4,12,1,2014,13,15902,2834,18736
1,4,12,1,2014,14,15248,2737,17985
1,4,12,1,2014,15,15531,2770,18301
1,4,12,1,2014,16,15681,2777,18458
1,4,12,1,2014,17,15071,2774,17845
1,4,12,1,2014,18,14100,2755,16855
1,4,12,1,2014,19,14086,2813,16899
1,4,12,1,2014,20,13759,2738,16497
1,4,12,1,2014,21,13287,2542,15829
1,4,12,1,2014,22,12358,2398,14756
1,4,12,1,2014,23,12119,2237,14356
1,4,12,1,2014,24,12241,2111,14352
2,6,12,1,2014,1,12434,1898,14332
2,6,12,1,2014,2,12383,1769,14152
2,6,12,1,2014,3,12626,1687,14313
2,6,12,1,2014,4,12361,1589,13950
2,6,12,1,2014,5,13036,1573,14609
2,6,12,1,2014,6,13533,1647,15180
2,6,12,1,2014,7,14809,1759,16568
2,6,12,1,2014,8,15321,1878,17199
2,6,12,1,2014,9,15656,2060,17716
2,6,12,1,2014,10,15716,2338,18054
2,6,12,1,2014,11,16116,2590,18706
2,6,12,1,2014,12,16057,2651,18708
2,6,12,1,2014,13,16074,2617,18691
2,6,12,1,2014,14,15504,2488,17992
2,6,12,1,2014,15,15604,2502,18106
2,6,12,1,2014,16,15463,2494,17957
2,6,12,1,2014,17,15018,2478,17496
2,6,12,1,2014,18,13858,2457,16315
2,6,12,1,2014,19,14140,2568,16708
2,6,12,1,2014,20,13571,2580,16151
2,6,12,1,2014,21,13204,2437,15641
2,6,12,1,2014,22,12128,2318,14446
2,6,12,1,2014,23,11923,2175,14098
2,6,12,1,2014,24,12321,2054,14375
2,7,12,1,2014,1,12509,1891,14400
2,7,12,1,2014,2,12307,1743,14050
2,7,12,1,2014,3,12454,1649,14103
2,7,12,1,2014,4,12591,1580,14171
2,7,12,1,2014,5,12566,1570,14136
2,7,12,1,2014,6,13339,1618,14957
2,7,12,1,2014,7,13792,1646,15438
2,7,12,1,2014,8,14871,1664,16535
2,7,12,1,2014,9,15322,1758,17080
2,7,12,1,2014,10,15286,1900,17186
2,7,12,1,2014,11,15579,2029,17608
2,7,12,1,2014,12,16008,2051,18059
2,7,12,1,2014,13,15696,2058,17754
2,7,12,1,2014,14,15171,1979,17150
2,7,12,1,2014,15,15395,1939,17334
2,7,12,1,2014,16,14924,1938,16862
2,7,12,1,2014,17,14545,1914,16459
2,7,12,1,2014,18,13188,1909,15097
2,7,12,1,2014,19,13888,2140,16028
2,7,12,1,2014,20,13522,2211,15733
2,7,12,1,2014,21,12629,2188,14817
2,7,12,1,2014,22,12010,2124,14134
2,7,12,1,2014,23,11652,2017,13669
2,7,12,1,2014,24,11911,1893,13804
1,8,12,1,2014,1,12224,1766,13990
1,8,12,1,2014,2,12194,1617,13811
1,8,12,1,2014,3,11897,1533,13430
1,8,12,1,2014,4,11974,1474,13448
1,8,12,1,2014,5,12425,1483,13908
1,8,12,1,2014,6,13241,1598,14839
1,8,12,1,2014,7,14106,1764,15870
1,8,12,1,2014,8,15202,1901,17103
1,8,12,1,2014,9,15524,2154,17678
1,8,12,1,2014,10,15682,2461,18143
1,8,12,1,2014,11,16034,2697,18731
1,8,12,1,2014,12,15760,2786,18546
1,8,12,1,2014,13,16275,2749,19024
1,8,12,1,2014,14,15698,2650,18348
1,8,12,1,2014,15,15965,2679,18644
1,8,12,1,2014,16,15623,2713,18336
1,8,12,1,2014,17,15173,2695,17868
1,8,12,1,2014,18,13757,2653,16410
1,8,12,1,2014,19,14053,2709,16762
1,8,12,1,2014,20,13686,2607,16293
1,8,12,1,2014,21,13308,2439,15747
1,8,12,1,2014,22,12417,2279,14696
1,8,12,1,2014,23,12363,2121,14484
1,8,12,1,2014,24,12371,1976,14347
1,9,12,1,2014,1,13089,1773,14862
1,9,12,1,2014,2,12845,1624,14469
1,9,12,1,2014,3,12857,1535,14392
1,9,12,1,2014,4,12879,1479,14358
1,9,12,1,2014,5,13175,1491,14666
1,9,12,1,2014,6,13870,1595,15465
1,9,12,1,2014,7,15243,1765,17008
1,9,12,1,2014,8,15753,1915,17668
1,9,12,1,2014,9,15777,2164,17941
1,9,12,1,2014,10,16073,2493,18566
1,9,12,1,2014,11,16374,2710,19084
1,9,12,1,2014,12,16101,2819,18920
1,9,12,1,2014,13,16263,2786,19049
1,9,12,1,2014,14,15927,2650,18577
1,9,12,1,2014,15,15995,2702,18697
1,9,12,1,2014,16,16207,2701,18908
1,9,12,1,2014,17,15347,2696,18043
1,9,12,1,2014,18,14297,2701,16998
1,9,12,1,2014,19,14517,2774,17291
1,9,12,1,2014,20,13956,2708,16664
1,9,12,1,2014,21,13362,2494,15856
1,9,12,1,2014,22,12593,2308,14901
1,9,12,1,2014,23,12653,2160,14813
1,9,12,1,2014,24,12740,1959,14699
1,10,12,1,2014,1,13076,1813,14889
1,10,12,1,2014,2,13332,1680,15012
1,10,12,1,2014,3,13038,1594,14632
1,10,12,1,2014,4,13156,1534,14690
1,10,12,1,2014,5,13413,1547,14960
1,10,12,1,2014,6,14197,1647,15844
1,10,12,1,2014,7,15222,1784,17006
1,10,12,1,2014,8,16142,1927,18069
1,10,12,1,2014,9,15965,2200,18165
1,10,12,1,2014,10,16139,2524,18663
1,10,12,1,2014,11,16518,2744,19262
1,10,12,1,2014,12,15769,2833,18602
1,10,12,1,2014,13,16434,2802,19236
1,10,12,1,2014,14,15871,2698,18569
1,10,12,1,2014,15,15898,2734,18632
1,10,12,1,2014,16,16136,2739,18875
1,10,12,1,2014,17,15116,2749,17865
1,10,12,1,2014,18,14679,2723,17402
1,10,12,1,2014,19,14457,2750,17207
1,10,12,1,2014,20,13805,2682,16487
1,10,12,1,2014,21,13499,2532,16031
1,10,12,1,2014,22,12538,2355,14893
1,10,12,1,2014,23,12328,2218,14546
1,10,12,1,2014,24,12606,2022,14628
1,11,12,1,2014,1,12538,1855,14393
1,11,12,1,2014,2,13033,1663,14696
1,11,12,1,2014,3,13010,1582,14592
1,11,12,1,2014,4,12694,1551,14245
1,11,12,1,2014,5,13364,1524,14888
1,11,12,1,2014,6,14184,1592,15776
1,11,12,1,2014,7,14957,1824,16781
1,11,12,1,2014,8,16052,1982,18034
1,11,12,1,2014,9,16160,2234,18394
1,11,12,1,2014,10,15813,2544,18357
1,11,12,1,2014,11,16365,2796,19161
1,11,12,1,2014,12,16308,2860,19168
1,11,12,1,2014,13,16272,2827,19099
1,11,12,1,2014,14,15838,2696,18534
1,11,12,1,2014,15,15834,2734,18568
1,11,12,1,2014,16,16004,2751,18755
1,11,12,1,2014,17,16053,2755,18808
1,11,12,1,2014,18,14847,2763,17610
1,11,12,1,2014,19,14427,2802,17229
1,11,12,1,2014,20,13665,2740,16405
1,11,12,1,2014,21,13298,2588,15886
1,11,12,1,2014,22,13259,2383,15642
1,11,12,1,2014,23,12613,2239,14852
1,11,12,1,2014,24,12897,2075,14972
1,12,12,1,2014,1,13081,1875,14956
1,12,12,1,2014,2,12952,1722,14674
1,12,12,1,2014,3,13003,1641,14644
1,12,12,1,2014,4,13129,1593,14722
1,12,12,1,2014,5,13243,1586,14829
1,12,12,1,2014,6,13906,1717,15623
1,12,12,1,2014,7,14453,1880,16333
1,12,12,1,2014,8,15347,2031,17378
1,12,12,1,2014,9,15419,2326,17745
1,12,12,1,2014,10,15411,2642,18053
1,12,12,1,2014,11,15512,2906,18418
1,12,12,1,2014,12,15472,2990,18462
1,12,12,1,2014,13,15418,2954,18372
1,12,12,1,2014,14,14947,2828,17775
1,12,12,1,2014,15,14555,2837,17392
1,12,12,1,2014,16,14396,2853,17249
1,12,12,1,2014,17,13673,2849,16522
1,12,12,1,2014,18,12906,2821,15727
1,12,12,1,2014,19,13280,2865,16145
1,12,12,1,2014,20,12880,2787,15667
1,12,12,1,2014,21,12382,2656,15038
1,12,12,1,2014,22,11976,2455,14431
1,12,12,1,2014,23,11651,2285,13936
1,12,12,1,2014,24,11177,2206,13383
2,13,12,1,2014,1,11358,1970,13328
2,13,12,1,2014,2,11110,1791,12901
2,13,12,1,2014,3,10798,1650,12448
2,13,12,1,2014,4,10959,1579,12538
2,13,12,1,2014,5,11150,1577,12727
2,13,12,1,2014,6,11974,1641,13615
2,13,12,1,2014,7,12664,1749,14413
2,13,12,1,2014,8,13425,1846,15271
2,13,12,1,2014,9,13472,2065,15537
2,13,12,1,2014,10,13878,2376,16254
2,13,12,1,2014,11,13871,2604,16475
2,13,12,1,2014,12,14190,2694,16884
2,13,12,1,2014,13,14183,2665,16848
2,13,12,1,2014,14,14080,2513,16593
2,13,12,1,2014,15,14125,2505,16630
2,13,12,1,2014,16,14111,2484,16595
2,13,12,1,2014,17,13589,2448,16037
2,13,12,1,2014,18,13384,2452,15836
2,13,12,1,2014,19,13703,2569,16272
2,13,12,1,2014,20,13538,2560,16098
2,13,12,1,2014,21,12923,2451,15374
2,13,12,1,2014,22,12034,2273,14307
2,13,12,1,2014,23,11956,2228,14184
2,13,12,1,2014,24,11726,2001,13727
2,14,12,1,2014,1,12042,1812,13854
2,14,12,1,2014,2,11859,1660,13519
2,14,12,1,2014,3,11681,1564,13245
2,14,12,1,2014,4,11533,1513,13046
2,14,12,1,2014,5,11955,1502,13457
2,14,12,1,2014,6,12534,1546,14080
2,14,12,1,2014,7,13194,1573,14767
2,14,12,1,2014,8,14076,1601,15677
2,14,12,1,2014,9,14147,1715,15862
2,14,12,1,2014,10,14628,1848,16476
2,14,12,1,2014,11,14601,1958,16559
2,14,12,1,2014,12,14632,1969,16601
2,14,12,1,2014,13,14467,1947,16414
2,14,12,1,2014,14,14146,1871,16017
2,14,12,1,2014,15,14095,1785,15880
2,14,12,1,2014,16,13872,1736,15608
2,14,12,1,2014,17,13328,1714,15042
2,14,12,1,2014,18,12428,1745,14173
2,14,12,1,2014,19,13235,1938,15173
2,14,12,1,2014,20,13290,2004,15294
2,14,12,1,2014,21,12059,1969,14028
2,14,12,1,2014,22,11726,1929,13655
2,14,12,1,2014,23,11566,1792,13358
2,14,12,1,2014,24,11516,1657,13173
1,15,12,1,2014,1,11826,1441,13267
1,15,12,1,2014,2,11660,1329,12989
1,15,12,1,2014,3,11602,1267,12869
1,15,12,1,2014,4,11346,1227,12573
1,15,12,1,2014,5,11582,1246,12828
1,15,12,1,2014,6,12443,1354,13797
1,15,12,1,2014,7,13443,1557,15000
1,15,12,1,2014,8,14367,1713,16080
1,15,12,1,2014,9,14696,1968,16664
1,15,12,1,2014,10,14679,2224,16903
1,15,12,1,2014,11,14768,2405,17173
1,15,12,1,2014,12,14524,2450,16974
1,15,12,1,2014,13,14248,2413,16661
1,15,12,1,2014,14,14076,2281,16357
1,15,12,1,2014,15,13901,2307,16208
1,15,12,1,2014,16,14188,2311,16499
1,15,12,1,2014,17,13857,2323,16180
1,15,12,1,2014,18,12958,2320,15278
1,15,12,1,2014,19,13703,2395,16098
1,15,12,1,2014,20,13670,2356,16026
1,15,12,1,2014,21,13048,2152,15200
1,15,12,1,2014,22,12181,2004,14185
1,15,12,1,2014,23,11986,1834,13820
1,15,12,1,2014,24,11373,1674,13047
1,16,12,1,2014,1,11598,1409,13007
1,16,12,1,2014,2,11524,1333,12857
1,16,12,1,2014,3,11136,1295,12431
1,16,12,1,2014,4,11138,1258,12396
1,16,12,1,2014,5,11384,1278,12662
1,16,12,1,2014,6,12163,1364,13527
1,16,12,1,2014,7,13473,1546,15019
1,16,12,1,2014,8,14481,1765,16246
1,16,12,1,2014,9,14891,1993,16884
1,16,12,1,2014,10,14603,2245,16848
1,16,12,1,2014,11,14721,2434,17155
1,16,12,1,2014,12,14717,2485,17202
1,16,12,1,2014,13,14476,2446,16922
1,16,12,1,2014,14,14049,2349,16398
1,16,12,1,2014,15,14508,2374,16882
1,16,12,1,2014,16,14378,2390,16768
1,16,12,1,2014,17,13928,2403,16331
1,16,12,1,2014,18,13097,2413,15510
1,16,12,1,2014,19,13744,2555,16299
1,16,12,1,2014,20,13971,2486,16457
1,16,12,1,2014,21,13456,2289,15745
1,16,12,1,2014,22,12364,2097,14461
1,16,12,1,2014,23,11574,1879,13453
1,16,12,1,2014,24,11313,1698,13011
1,17,12,1,2014,1,11431,1496,12927
1,17,12,1,2014,2,11171,1372,12543
1,17,12,1,2014,3,11298,1315,12613
1,17,12,1,2014,4,11408,1274,12682
1,17,12,1,2014,5,11507,1290,12797
1,17,12,1,2014,6,12389,1413,13802
1,17,12,1,2014,7,12936,1606,14542
1,17,12,1,2014,8,14740,1778,16518
1,17,12,1,2014,9,14902,2021,16923
1,17,12,1,2014,10,15423,2321,17744
1,17,12,1,2014,11,14822,2459,17281
1,17,12,1,2014,12,14869,2495,17364
1,17,12,1,2014,13,14234,2448,16682
1,17,12,1,2014,14,14464,2340,16804
1,17,12,1,2014,15,14069,2359,16428
1,17,12,1,2014,16,14168,2341,16509
1,17,12,1,2014,17,13779,2350,16129
1,17,12,1,2014,18,13294,2364,15658
1,17,12,1,2014,19,13966,2479,16445
1,17,12,1,2014,20,13397,2456,15853
1,17,12,1,2014,21,12858,2285,15143
1,17,12,1,2014,22,12172,2104,14276
1,17,12,1,2014,23,11376,1918,13294
1,17,12,1,2014,24,11094,1736,12830
1,18,12,1,2014,1,11186,1506,12692
1,18,12,1,2014,2,11073,1390,12463
1,18,12,1,2014,3,11050,1324,12374
1,18,12,1,2014,4,11004,1281,12285
1,18,12,1,2014,5,11247,1296,12543
1,18,12,1,2014,6,11916,1412,13328
1,18,12,1,2014,7,13209,1591,14800
1,18,12,1,2014,8,14057,1749,15806
1,18,12,1,2014,9,14555,1995,16550
1,18,12,1,2014,10,14372,2297,16669
1,18,12,1,2014,11,14321,2427,16748
1,18,12,1,2014,12,14658,2481,17139
1,18,12,1,2014,13,14022,2448,16470
1,18,12,1,2014,14,14057,2317,16374
1,18,12,1,2014,15,13981,2333,16314
1,18,12,1,2014,16,13978,2353,16331
1,18,12,1,2014,17,13702,2363,16065
1,18,12,1,2014,18,12781,2371,15152
1,18,12,1,2014,19,13669,2484,16153
1,18,12,1,2014,20,13474,2444,15918
1,18,12,1,2014,21,12214,2292,14506
1,18,12,1,2014,22,11774,2128,13902
1,18,12,1,2014,23,11156,1892,13048
1,18,12,1,2014,24,11082,1699,12781
1,19,12,1,2014,1,11192,1488,12680
1,19,12,1,2014,2,11309,1371,12680
1,19,12,1,2014,3,11141,1299,12440
1,19,12,1,2014,4,10997,1265,12262
1,19,12,1,2014,5,11367,1281,12648
1,19,12,1,2014,6,12288,1408,13696
1,19,12,1,2014,7,13165,1607,14772
1,19,12,1,2014,8,14161,1766,15927
1,19,12,1,2014,9,14772,2023,16795
1,19,12,1,2014,10,14926,2346,17272
1,19,12,1,2014,11,14754,2509,17263
1,19,12,1,2014,12,14612,2548,17160
1,19,12,1,2014,13,14452,2538,16990
1,19,12,1,2014,14,14035,2390,16425
1,19,12,1,2014,15,14127,2391,16518
1,19,12,1,2014,16,13635,2407,16042
1,19,12,1,2014,17,13373,2413,15786
1,19,12,1,2014,18,12264,2421,14685
1,19,12,1,2014,19,13114,2550,15664
1,19,12,1,2014,20,13041,2484,15525
1,19,12,1,2014,21,12122,2321,14443
1,19,12,1,2014,22,11414,2119,13533
1,19,12,1,2014,23,10975,1934,12909
1,19,12,1,2014,24,10913,1728,12641
2,20,12,1,2014,1,10688,1566,12254
2,20,12,1,2014,2,10793,1418,12211
2,20,12,1,2014,3,10611,1350,11961
2,20,12,1,2014,4,10728,1315,12043
2,20,12,1,2014,5,11138,1328,12466
2,20,12,1,2014,6,12062,1432,13494
2,20,12,1,2014,7,13296,1565,14861
2,20,12,1,2014,8,14434,1686,16120
2,20,12,1,2014,9,14799,1932,16731
2,20,12,1,2014,10,15049,2234,17283
2,20,12,1,2014,11,15283,2421,17704
2,20,12,1,2014,12,15167,2450,17617
2,20,12,1,2014,13,15173,2424,17597
2,20,12,1,2014,14,14596,2297,16893
2,20,12,1,2014,15,14872,2281,17153
2,20,12,1,2014,16,14283,2256,16539
2,20,12,1,2014,17,14022,2253,16275
2,20,12,1,2014,18,13314,2251,15565
2,20,12,1,2014,19,13497,2401,15898
2,20,12,1,2014,20,13437,2396,15833
2,20,12,1,2014,21,12571,2262,14833
2,20,12,1,2014,22,11685,2086,13771
2,20,12,1,2014,23,11322,1902,13224
2,20,12,1,2014,24,11236,1778,13014
2,21,12,1,2014,1,11917,1558,13475
2,21,12,1,2014,2,11699,1431,13130
2,21,12,1,2014,3,11439,1357,12796
2,21,12,1,2014,4,11337,1324,12661
2,21,12,1,2014,5,11723,1319,13042
2,21,12,1,2014,6,12433,1384,13817
2,21,12,1,2014,7,13492,1447,14939
2,21,12,1,2014,8,14484,1503,15987
2,21,12,1,2014,9,14764,1638,16402
2,21,12,1,2014,10,15273,1807,17080
2,21,12,1,2014,11,15385,1921,17306
2,21,12,1,2014,12,15484,1944,17428
2,21,12,1,2014,13,15260,1925,17185
2,21,12,1,2014,14,14864,1862,16726
2,21,12,1,2014,15,14724,1787,16511
2,21,12,1,2014,16,14466,1732,16198
2,21,12,1,2014,17,14019,1715,15734
2,21,12,1,2014,18,12786,1750,14536
2,21,12,1,2014,19,13353,1954,15307
2,21,12,1,2014,20,13397,2021,15418
2,21,12,1,2014,21,12438,2007,14445
2,21,12,1,2014,22,11462,1933,13395
2,21,12,1,2014,23,11153,1822,12975
2,21,12,1,2014,24,11044,1683,12727
1,22,12,1,2014,1,11374,1498,12872
1,22,12,1,2014,2,11163,1374,12537
1,22,12,1,2014,3,11044,1307,12351
1,22,12,1,2014,4,11435,1276,12711
1,22,12,1,2014,5,11619,1294,12913
1,22,12,1,2014,6,12190,1404,13594
1,22,12,1,2014,7,13829,1583,15412
1,22,12,1,2014,8,14656,1760,16416
1,22,12,1,2014,9,15068,2052,17120
1,22,12,1,2014,10,15499,2329,17828
1,22,12,1,2014,11,15583,2513,18096
1,22,12,1,2014,12,15614,2554,18168
1,22,12,1,2014,13,15410,2507,17917
1,22,12,1,2014,14,15270,2405,17675
1,22,12,1,2014,15,15338,2420,17758
1,22,12,1,2014,16,15098,2422,17520
1,22,12,1,2014,17,14535,2415,16950
1,22,12,1,2014,18,13685,2396,16081
1,22,12,1,2014,19,13787,2495,16282
1,22,12,1,2014,20,13559,2426,15985
1,22,12,1,2014,21,13003,2291,15294
1,22,12,1,2014,22,11844,2080,13924
1,22,12,1,2014,23,11234,1921,13155
1,22,12,1,2014,24,11420,1737,13157
1,23,12,1,2014,1,11573,1541,13114
1,23,12,1,2014,2,11327,1404,12731
1,23,12,1,2014,3,11189,1334,12523
1,23,12,1,2014,4,11535,1298,12833
1,23,12,1,2014,5,11627,1309,12936
1,23,12,1,2014,6,12628,1414,14042
1,23,12,1,2014,7,13916,1580,15496
1,23,12,1,2014,8,15061,1760,16821
1,23,12,1,2014,9,15645,2037,17682
1,23,12,1,2014,10,15638,2332,17970
1,23,12,1,2014,11,15872,2536,18408
1,23,12,1,2014,12,15737,2562,18299
1,23,12,1,2014,13,15505,2516,18021
1,23,12,1,2014,14,15326,2379,17705
1,23,12,1,2014,15,15041,2383,17424
1,23,12,1,2014,16,15220,2404,17624
1,23,12,1,2014,17,14769,2422,17191
1,23,12,1,2014,18,13509,2431,15940
1,23,12,1,2014,19,13883,2514,16397
1,23,12,1,2014,20,13574,2472,16046
1,23,12,1,2014,21,12783,2293,15076
1,23,12,1,2014,22,11936,2108,14044
1,23,12,1,2014,23,11421,1920,13341
1,23,12,1,2014,24,11310,1701,13011
1,24,12,1,2014,1,11420,1516,12936
1,24,12,1,2014,2,11514,1388,12902
1,24,12,1,2014,3,11258,1327,12585
1,24,12,1,2014,4,11608,1296,12904
1,24,12,1,2014,5,11817,1304,13121
1,24,12,1,2014,6,12591,1413,14004
1,24,12,1,2014,7,13679,1574,15253
1,24,12,1,2014,8,14997,1752,16749
1,24,12,1,2014,9,15693,1992,17685
1,24,12,1,2014,10,15743,2303,18046
1,24,12,1,2014,11,15670,2497,18167
1,24,12,1,2014,12,15800,2557,18357
1,24,12,1,2014,13,15368,2523,17891
1,24,12,1,2014,14,15114,2397,17511
1,24,12,1,2014,15,14874,2391,17265
1,24,12,1,2014,16,15081,2406,17487
1,24,12,1,2014,17,14710,2410,17120
1,24,12,1,2014,18,13358,2411,15769
1,24,12,1,2014,19,13884,2502,16386
1,24,12,1,2014,20,13269,2452,15721
1,24,12,1,2014,21,13051,2293,15344
1,24,12,1,2014,22,12268,2108,14376
1,24,12,1,2014,23,11383,1880,13263
1,24,12,1,2014,24,11162,1707,12869
3,25,12,1,2014,1,11420,1562,12982
3,25,12,1,2014,2,11367,1416,12783
3,25,12,1,2014,3,11336,1352,12688
3,25,12,1,2014,4,11654,1311,12965
3,25,12,1,2014,5,12003,1312,13315
3,25,12,1,2014,6,12434,1404,13838
3,25,12,1,2014,7,12901,1481,14382
3,25,12,1,2014,8,14323,1587,15910
3,25,12,1,2014,9,15358,1754,17112
3,25,12,1,2014,10,15249,2034,17283
3,25,12,1,2014,11,15813,2171,17984
3,25,12,1,2014,12,15830,2230,18060
3,25,12,1,2014,13,15334,2225,17559
3,25,12,1,2014,14,15186,2063,17249
3,25,12,1,2014,15,15221,2020,17241
3,25,12,1,2014,16,14678,2032,16710
3,25,12,1,2014,17,14338,2053,16391
3,25,12,1,2014,18,13248,2098,15346
3,25,12,1,2014,19,13399,2219,15618
3,25,12,1,2014,20,13030,2223,15253
3,25,12,1,2014,21,12694,2176,14870
3,25,12,1,2014,22,11760,2037,13797
3,25,12,1,2014,23,11515,1864,13379
3,25,12,1,2014,24,11150,1705,12855
1,26,12,1,2014,1,11507,1541,13048
1,26,12,1,2014,2,11288,1410,12698
1,26,12,1,2014,3,11511,1343,12854
1,26,12,1,2014,4,11657,1310,12967
1,26,12,1,2014,5,11919,1318,13237
1,26,12,1,2014,6,12676,1423,14099
1,26,12,1,2014,7,13491,1523,15014
1,26,12,1,2014,8,14900,1713,16613
1,26,12,1,2014,9,15182,2016,17198
1,26,12,1,2014,10,14975,2337,17312
1,26,12,1,2014,11,15543,2515,18058
1,26,12,1,2014,12,15402,2530,17932
1,26,12,1,2014,13,15020,2526,17546
1,26,12,1,2014,14,15081,2377,17458
1,26,12,1,2014,15,14148,2361,16509
1,26,12,1,2014,16,14201,2360,16561
1,26,12,1,2014,17,14689,2366,17055
1,26,12,1,2014,18,12902,2372,15274
1,26,12,1,2014,19,13843,2442,16285
1,26,12,1,2014,20,13198,2425,15623
1,26,12,1,2014,21,12921,2214,15135
1,26,12,1,2014,22,11681,2038,13719
1,26,12,1,2014,23,11005,1843,12848
1,26,12,1,2014,24,11062,1687,12749
2,27,12,1,2014,1,11250,1517,12767
2,27,12,1,2014,2,11489,1394,12883
2,27,12,1,2014,3,11586,1330,12916
2,27,12,1,2014,4,11326,1286,12612
2,27,12,1,2014,5,11670,1288,12958
2,27,12,1,2014,6,12232,1372,13604
2,27,12,1,2014,7,13213,1474,14687
2,27,12,1,2014,8,14815,1610,16425
2,27,12,1,2014,9,15118,1846,16964
2,27,12,1,2014,10,15155,2153,17308
2,27,12,1,2014,11,15651,2284,17935
2,27,12,1,2014,12,15800,2288,18088
2,27,12,1,2014,13,14937,2286,17223
2,27,12,1,2014,14,15161,2148,17309
2,27,12,1,2014,15,14855,2126,16981
2,27,12,1,2014,16,14688,2114,16802
2,27,12,1,2014,17,14025,2119,16144
2,27,12,1,2014,18,13281,2123,15404
2,27,12,1,2014,19,13463,2286,15749
2,27,12,1,2014,20,13446,2275,15721
2,27,12,1,2014,21,13056,2057,15113
2,27,12,1,2014,22,11682,1968,13650
2,27,12,1,2014,23,10874,1788,12662
2,27,12,1,2014,24,11137,1632,12769
2,28,12,1,2014,1,11246,1493,12739
2,28,12,1,2014,2,11149,1373,12522
2,28,12,1,2014,3,11165,1310,12475
2,28,12,1,2014,4,10942,1275,12217
2,28,12,1,2014,5,11619,1278,12897
2,28,12,1,2014,6,12303,1349,13652
2,28,12,1,2014,7,13198,1406,14604
2,28,12,1,2014,8,14357,1473,15830
2,28,12,1,2014,9,14799,1598,16397
2,28,12,1,2014,10,14940,1749,16689
2,28,12,1,2014,11,15334,1830,17164
2,28,12,1,2014,12,15521,1832,17353
2,28,12,1,2014,13,15230,1828,17058
2,28,12,1,2014,14,14762,1744,16506
2,28,12,1,2014,15,14673,1692,16365
2,28,12,1,2014,16,14893,1621,16514
2,28,12,1,2014,17,14134,1621,15755
2,28,12,1,2014,18,12875,1672,14547
2,28,12,1,2014,19,13195,1873,15068
2,28,12,1,2014,20,13019,1902,14921
2,28,12,1,2014,21,12482,1897,14379
2,28,12,1,2014,22,11128,1859,12987
2,28,12,1,2014,23,10674,1727,12401
2,28,12,1,2014,24,11200,1587,12787
1,30,12,1,2014,1,11616,1479,13095
1,30,12,1,2014,2,11082,1363,12445
1,30,12,1,2014,3,11079,1294,12373
1,30,12,1,2014,4,11183,1271,12454
1,30,12,1,2014,5,11542,1279,12821
1,30,12,1,2014,6,12505,1371,13876
1,30,12,1,2014,7,13823,1511,15334
1,30,12,1,2014,8,14885,1723,16608
1,30,12,1,2014,9,15938,1976,17914
1,30,12,1,2014,10,15705,2293,17998
1,30,12,1,2014,11,15819,2468,18287
1,30,12,1,2014,12,16188,2483,18671
1,30,12,1,2014,13,15844,2476,18320
1,30,12,1,2014,14,15307,2357,17664
1,30,12,1,2014,15,14850,2347,17197
1,30,12,1,2014,16,14961,2344,17305
1,30,12,1,2014,17,14072,2344,16416
1,30,12,1,2014,18,13225,2341,15566
1,30,12,1,2014,19,13779,2386,16165
1,30,12,1,2014,20,13656,2407,16063
1,30,12,1,2014,21,12719,2246,14965
1,30,12,1,2014,22,11836,2052,13888
1,30,12,1,2014,23,11240,1845,13085
1,30,12,1,2014,24,11422,1688,13110
1,31,12,1,2014,1,11312,1513,12825
1,31,12,1,2014,2,11300,1391,12691
1,31,12,1,2014,3,11306,1326,12632
1,31,12,1,2014,4,11150,1294,12444
1,31,12,1,2014,5,11382,1305,12687
1,31,12,1,2014,6,12330,1392,13722
1,31,12,1,2014,7,13350,1531,14881
1,31,12,1,2014,8,14455,1723,16178
1,31,12,1,2014,9,15115,1961,17076
1,31,12,1,2014,10,15306,2302,17608
1,31,12,1,2014,11,14794,2428,17222
1,31,12,1,2014,12,15132,2431,17563
1,31,12,1,2014,13,14782,2425,17207
1,31,12,1,2014,14,14498,2310,16808
1,31,12,1,2014,15,14244,2283,16527
1,31,12,1,2014,16,14026,2269,16295
1,31,12,1,2014,17,13757,2257,16014
1,31,12,1,2014,18,12546,2226,14772
1,31,12,1,2014,19,12995,2312,15307
1,31,12,1,2014,20,12845,2325,15170
1,31,12,1,2014,21,12064,2194,14258
1,31,12,1,2014,22,11357,2012,13369
1,31,12,1,2014,23,10736,1844,12580
1,31,12,1,2014,24,10837,1684,12521
1,1,1,1,2015,1,10722,1529,12251
1,1,1,1,2015,2,10587,1405,11992
1,1,1,1,2015,3,10347,1333,11680
1,1,1,1,2015,4,10190,1278,11468
1,1,1,1,2015,5,10048,1277,11325
1,1,1,1,2015,6,10519,1359,11878
1,1,1,1,2015,7,11034,1445,12479
1,1,1,1,2015,8,11988,1557,13545
1,1,1,1,2015,9,12416,1754,14170
1,1,1,1,2015,10,12644,1977,14621
1,1,1,1,2015,11,12686,2151,14837
1,1,1,1,2015,12,12544,2151,14695
1,1,1,1,2015,13,12776,2151,14927
1,1,1,1,2015,14,12035,2042,14077
1,1,1,1,2015,15,12023,2000,14023
1,1,1,1,2015,16,12076,1975,14051
1,1,1,1,2015,17,11761,1967,13728
1,1,1,1,2015,18,11035,1998,13033
1,1,1,1,2015,19,12062,2127,14189
1,1,1,1,2015,20,12186,2147,14333
1,1,1,1,2015,21,11389,2063,13452
1,1,1,1,2015,22,10654,1954,12608
1,1,1,1,2015,23,9929,1789,11718
1,1,1,1,2015,24,9877,1627,11504
1,2,1,1,2015,1,10133,1402,11535
1,2,1,1,2015,2,9851,1296,11147
1,2,1,1,2015,3,9842,1239,11081
1,2,1,1,2015,4,9489,1204,10693
1,2,1,1,2015,5,10124,1234,11358
1,2,1,1,2015,6,10666,1339,12005
1,2,1,1,2015,7,11783,1507,13290
1,2,1,1,2015,8,12610,1719,14329
1,2,1,1,2015,9,12858,1913,14771
1,2,1,1,2015,10,13098,2238,15336
1,2,1,1,2015,11,13047,2353,15400
1,2,1,1,2015,12,12907,2354,15261
1,2,1,1,2015,13,12600,2349,14949
1,2,1,1,2015,14,12222,2210,14432
1,2,1,1,2015,15,11910,2198,14108
1,2,1,1,2015,16,11598,2193,13791
1,2,1,1,2015,17,11436,2215,13651
1,2,1,1,2015,18,10691,2219,12910
1,2,1,1,2015,19,11883,2340,14223
1,2,1,1,2015,20,12394,2347,14741
1,2,1,1,2015,21,11717,2225,13942
1,2,1,1,2015,22,11183,2030,13213
1,2,1,1,2015,23,10552,1846,12398
1,2,1,1,2015,24,10211,1666,11877
3,3,1,1,2015,1,1489,11713,50.05
3,3,1,1,2015,2,1368,11343,50.04
3,3,1,1,2015,3,1310,11365,50.14
3,3,1,1,2015,4,1281,11255,50.12
3,3,1,1,2015,5,1277,11713,49.99
3,3,1,1,2015,6,1385,12482,49.96
3,3,1,1,2015,7,1518,13517,49.99
3,3,1,1,2015,8,1654,14568,49.89
3,3,1,1,2015,9,1902,15677,50
3,3,1,1,2015,10,2162,15961,49.91
3,3,1,1,2015,11,2311,16278,49.89
3,3,1,1,2015,12,2322,15985,49.92
3,3,1,1,2015,13,2319,15595,49.92
3,3,1,1,2015,14,2197,15227,49.98
3,3,1,1,2015,15,2182,15065,49.94
3,3,1,1,2015,16,2138,15198,49.88
3,3,1,1,2015,17,2135,14777,49.86
3,3,1,1,2015,18,2149,13858,49.89
3,3,1,1,2015,19,2310,15164,49.95
3,3,1,1,2015,20,2319,15116,49.97
3,3,1,1,2015,21,2225,13931,49.92
3,3,1,1,2015,22,2079,13530,50.02
3,3,1,1,2015,23,1886,12552,49.96
3,3,1,1,2015,24,1708,12191,49.98
2,4,1,1,2015,1,10683,1533,12216
2,4,1,1,2015,2,10499,1411,11910
2,4,1,1,2015,3,10196,1313,11509
2,4,1,1,2015,4,10312,1278,11590
2,4,1,1,2015,5,10725,1287,12012
2,4,1,1,2015,6,11174,1359,12533
2,4,1,1,2015,7,12000,1424,13424
2,4,1,1,2015,8,13084,1474,14558
2,4,1,1,2015,9,13454,1618,15072
2,4,1,1,2015,10,13763,1746,15509
2,4,1,1,2015,11,13893,1873,15766
2,4,1,1,2015,12,13847,1888,15735
2,4,1,1,2015,13,13207,1887,15094
2,4,1,1,2015,14,13005,1805,14810
2,4,1,1,2015,15,12704,1734,14438
2,4,1,1,2015,16,12932,1669,14601
2,4,1,1,2015,17,12269,1654,13923
2,4,1,1,2015,18,11436,1694,13130
2,4,1,1,2015,19,12477,1898,14375
2,4,1,1,2015,20,12075,1932,14007
2,4,1,1,2015,21,11606,1908,13514
2,4,1,1,2015,22,10953,1833,12786
2,4,1,1,2015,23,10337,1788,12125
2,4,1,1,2015,24,10285,1594,11879
1,5,1,1,2015,1,9919,1466,11385
1,5,1,1,2015,2,10101,1356,11457
1,5,1,1,2015,3,10051,1297,11348
1,5,1,1,2015,4,9307,1265,10572
1,5,1,1,2015,5,10462,1281,11743
1,5,1,1,2015,6,10781,1408,12189
1,5,1,1,2015,7,12445,1660,14105
1,5,1,1,2015,8,13487,1794,15281
1,5,1,1,2015,9,14032,2051,16083
1,5,1,1,2015,10,14142,2348,16490
1,5,1,1,2015,11,13687,2488,16175
1,5,1,1,2015,12,14047,2501,16548
1,5,1,1,2015,13,13973,2495,16468
1,5,1,1,2015,14,13476,2414,15890
1,5,1,1,2015,15,13604,2418,16022
1,5,1,1,2015,16,13638,2410,16048
1,5,1,1,2015,17,13096,2411,15507
1,5,1,1,2015,18,12113,2388,14501
1,5,1,1,2015,19,13005,2472,15477
1,5,1,1,2015,20,13192,2429,15621
1,5,1,1,2015,21,12485,2331,14816
1,5,1,1,2015,22,11738,2082,13820
1,5,1,1,2015,23,11219,1877,13096
1,5,1,1,2015,24,11081,1695,12776
1,6,1,1,2015,1,10619,1528,12147
1,6,1,1,2015,2,10824,1408,12232
1,6,1,1,2015,3,10526,1341,11867
1,6,1,1,2015,4,10592,1311,11903
1,6,1,1,2015,5,10817,1331,12148
1,6,1,1,2015,6,11577,1466,13043
1,6,1,1,2015,7,12906,1663,14569
1,6,1,1,2015,8,14233,1831,16064
1,6,1,1,2015,9,14484,2052,16536
1,6,1,1,2015,10,14704,2379,17083
1,6,1,1,2015,11,14369,2551,16920
1,6,1,1,2015,12,14894,2562,17456
1,6,1,1,2015,13,14034,2559,16593
1,6,1,1,2015,14,13977,2443,16420
1,6,1,1,2015,15,14026,2452,16478
1,6,1,1,2015,16,13604,2441,16045
1,6,1,1,2015,17,13609,2434,16043
1,6,1,1,2015,18,12461,2420,14881
1,6,1,1,2015,19,13403,2468,15871
1,6,1,1,2015,20,13327,2492,15819
1,6,1,1,2015,21,12514,2366,14880
1,6,1,1,2015,22,11762,2123,13885
1,6,1,1,2015,23,11274,1922,13196
1,6,1,1,2015,24,11191,1700,12891
1,7,1,1,2015,1,11112,1523,12635
1,7,1,1,2015,2,10857,1395,12252
1,7,1,1,2015,3,10836,1329,12165
1,7,1,1,2015,4,10904,1296,12200
1,7,1,1,2015,5,11204,1316,12520
1,7,1,1,2015,6,12007,1459,13466
1,7,1,1,2015,7,13296,1657,14953
1,7,1,1,2015,8,14635,1831,16466
1,7,1,1,2015,9,14462,2077,16539
1,7,1,1,2015,10,14800,2398,17198
1,7,1,1,2015,11,14819,2500,17319
1,7,1,1,2015,12,14448,2510,16958
1,7,1,1,2015,13,14338,2502,16840
1,7,1,1,2015,14,14403,2380,16783
1,7,1,1,2015,15,13844,2336,16180
1,7,1,1,2015,16,14052,2365,16417
1,7,1,1,2015,17,13664,2382,16046
1,7,1,1,2015,18,12994,2366,15360
1,7,1,1,2015,19,13654,2425,16079
1,7,1,1,2015,20,13380,2437,15817
1,7,1,1,2015,21,13129,2256,15385
1,7,1,1,2015,22,11650,2060,13710
1,7,1,1,2015,23,11170,1850,13020
1,7,1,1,2015,24,11145,1666,12811
1,8,1,1,2015,1,10863,1489,12352
1,8,1,1,2015,2,11057,1332,12389
1,8,1,1,2015,3,10838,1274,12112
1,8,1,1,2015,4,10551,1239,11790
1,8,1,1,2015,5,11242,1261,12503
1,8,1,1,2015,6,12263,1383,13646
1,8,1,1,2015,7,13170,1651,14821
1,8,1,1,2015,8,14223,1831,16054
1,8,1,1,2015,9,14777,2014,16791
1,8,1,1,2015,10,14831,2292,17123
1,8,1,1,2015,11,14885,2406,17291
1,8,1,1,2015,12,14915,2424,17339
1,8,1,1,2015,13,14438,2421,16859
1,8,1,1,2015,14,14159,2308,16467
1,8,1,1,2015,15,14390,2332,16722
1,8,1,1,2015,16,14151,2341,16492
1,8,1,1,2015,17,13830,2352,16182
1,8,1,1,2015,18,12498,2344,14842
1,8,1,1,2015,19,13274,2421,15695
1,8,1,1,2015,20,13360,2398,15758
1,8,1,1,2015,21,12292,2247,14539
1,8,1,1,2015,22,11656,2053,13709
1,8,1,1,2015,23,11212,1844,13056
1,8,1,1,2015,24,11032,1646,12678
1,9,1,1,2015,1,10827,1474,12301
1,9,1,1,2015,2,10895,1337,12232
1,9,1,1,2015,3,10750,1287,12037
1,9,1,1,2015,4,10903,1258,12161
1,9,1,1,2015,5,11168,1275,12443
1,9,1,1,2015,6,12224,1412,13636
1,9,1,1,2015,7,13399,1617,15016
1,9,1,1,2015,8,14200,1784,15984
1,9,1,1,2015,9,14818,1990,16808
1,9,1,1,2015,10,14795,2298,17093
1,9,1,1,2015,11,14665,2460,17125
1,9,1,1,2015,12,14598,2461,17059
1,9,1,1,2015,13,14499,2457,16956
1,9,1,1,2015,14,13798,2324,16122
1,9,1,1,2015,15,13718,2337,16055
1,9,1,1,2015,16,13907,2348,16255
1,9,1,1,2015,17,13234,2370,15604
1,9,1,1,2015,18,12154,2348,14502
1,9,1,1,2015,19,12728,2416,15144
1,9,1,1,2015,20,12994,2444,15438
1,9,1,1,2015,21,12299,2260,14559
1,9,1,1,2015,22,11465,2077,13542
1,9,1,1,2015,23,10866,1817,12683
1,9,1,1,2015,24,10817,1651,12468
2,10,1,1,2015,1,10649,1462,12111
2,10,1,1,2015,2,10602,1320,11922
2,10,1,1,2015,3,10349,1282,11631
2,10,1,1,2015,4,10414,1253,11667
2,10,1,1,2015,5,10814,1257,12071
2,10,1,1,2015,6,11425,1369,12794
2,10,1,1,2015,7,11819,1498,13317
2,10,1,1,2015,8,15127,1646,16773
2,10,1,1,2015,9,14815,1853,16668
2,10,1,1,2015,10,14868,2137,17005
2,10,1,1,2015,11,15132,2299,17431
2,10,1,1,2015,12,15240,2300,17540
2,10,1,1,2015,13,14957,2299,17256
2,10,1,1,2015,14,14442,2150,16592
2,10,1,1,2015,15,14960,2141,17101
2,10,1,1,2015,16,14464,2140,16604
2,10,1,1,2015,17,14002,2221,16223
2,10,1,1,2015,18,12719,2077,14796
2,10,1,1,2015,19,13365,2253,15618
2,10,1,1,2015,20,13058,2293,15351
2,10,1,1,2015,21,12772,2144,14916
2,10,1,1,2015,22,11946,1990,13936
2,10,1,1,2015,23,11193,1797,12990
2,10,1,1,2015,24,11321,1625,12946
2,11,1,1,2015,1,11188,1456,12644
2,11,1,1,2015,2,11109,1334,12443
2,11,1,1,2015,3,10907,1268,12175
2,11,1,1,2015,4,10737,1227,11964
2,11,1,1,2015,5,11084,1237,12321
2,11,1,1,2015,6,11949,1343,13292
2,11,1,1,2015,7,12564,1365,13929
2,11,1,1,2015,8,14044,1481,15525
2,11,1,1,2015,9,14756,1612,16368
2,11,1,1,2015,10,15334,1753,17087
2,11,1,1,2015,11,15498,1830,17328
2,11,1,1,2015,12,15187,1833,17020
2,11,1,1,2015,13,15289,1829,17118
2,11,1,1,2015,14,15135,1767,16902
2,11,1,1,2015,15,14468,1678,16146
2,11,1,1,2015,16,14401,1623,16024
2,11,1,1,2015,17,13824,1627,15451
2,11,1,1,2015,18,12357,1658,14015
2,11,1,1,2015,19,12782,1797,14579
2,11,1,1,2015,20,13110,1831,14941
2,11,1,1,2015,21,12423,1847,14270
2,11,1,1,2015,22,11415,1789,13204
2,11,1,1,2015,23,11005,1672,12677
2,11,1,1,2015,24,10933,1540,12473
1,12,1,1,2015,1,11303,1404,12707
1,12,1,1,2015,2,10726,1281,12007
1,12,1,1,2015,3,10716,1229,11945
1,12,1,1,2015,4,10604,1192,11796
1,12,1,1,2015,5,10919,1210,12129
1,12,1,1,2015,6,11872,1350,13222
1,12,1,1,2015,7,13247,1559,14806
1,12,1,1,2015,8,14825,1745,16570
1,12,1,1,2015,9,14929,1975,16904
1,12,1,1,2015,10,15270,2243,17513
1,12,1,1,2015,11,15100,2388,17488
1,12,1,1,2015,12,15088,2393,17481
1,12,1,1,2015,13,15108,2389,17497
1,12,1,1,2015,14,14625,2286,16911
1,12,1,1,2015,15,14733,2287,17020
1,12,1,1,2015,16,14559,2287,16846
1,12,1,1,2015,17,14011,2286,16297
1,12,1,1,2015,18,12365,2252,14617
1,12,1,1,2015,19,13320,2308,15628
1,12,1,1,2015,20,13484,2346,15830
1,12,1,1,2015,21,12845,2139,14984
1,12,1,1,2015,22,11996,1931,13927
1,12,1,1,2015,23,11451,1796,13247
1,12,1,1,2015,24,11241,1592,12833
1,13,1,1,2015,1,11288,1454,12742
1,13,1,1,2015,2,10935,1327,12262
1,13,1,1,2015,3,10891,1275,12166
1,13,1,1,2015,4,11062,1241,12303
1,13,1,1,2015,5,11302,1285,12587
1,13,1,1,2015,6,12313,1385,13698
1,13,1,1,2015,7,13624,1598,15222
1,13,1,1,2015,8,15045,1776,16821
1,13,1,1,2015,9,15636,2009,17645
1,13,1,1,2015,10,15526,2295,17821
1,13,1,1,2015,11,15759,2406,18165
1,13,1,1,2015,12,15346,2419,17765
1,13,1,1,2015,13,14973,2417,17390
1,13,1,1,2015,14,15031,2298,17329
1,13,1,1,2015,15,14594,2291,16885
1,13,1,1,2015,16,14633,2298,16931
1,13,1,1,2015,17,14464,2300,16764
1,13,1,1,2015,18,12611,2306,14917
1,13,1,1,2015,19,13144,2414,15558
1,13,1,1,2015,20,13335,2394,15729
1,13,1,1,2015,21,13182,2250,15432
1,13,1,1,2015,22,11889,2011,13900
1,13,1,1,2015,23,11316,1807,13123
1,13,1,1,2015,24,10856,1626,12482
1,14,1,1,2015,1,11234,1423,12657
1,14,1,1,2015,2,11326,1301,12627
1,14,1,1,2015,3,11153,1240,12393
1,14,1,1,2015,4,11321,1204,12525
1,14,1,1,2015,5,11559,1219,12778
1,14,1,1,2015,6,12412,1348,13760
1,14,1,1,2015,7,14024,1582,15606
1,14,1,1,2015,8,15236,1793,17029
1,14,1,1,2015,9,15522,1994,17516
1,14,1,1,2015,10,15795,2282,18077
1,14,1,1,2015,11,15866,2429,18295
1,14,1,1,2015,12,15848,2440,18288
1,14,1,1,2015,13,15403,2408,17811
1,14,1,1,2015,14,15328,2258,17586
1,14,1,1,2015,15,14885,2262,17147
1,14,1,1,2015,16,15618,2267,17885
1,14,1,1,2015,17,14115,2291,16406
1,14,1,1,2015,18,13368,2287,15655
1,14,1,1,2015,19,13435,2346,15781
1,14,1,1,2015,20,13394,2343,15737
1,14,1,1,2015,21,13107,2231,15338
1,14,1,1,2015,22,11930,2010,13940
1,14,1,1,2015,23,11403,1831,13234
1,14,1,1,2015,24,11287,1609,12896
1,15,1,1,2015,1,11411,1432,12843
1,15,1,1,2015,2,11385,1304,12689
1,15,1,1,2015,3,11634,1245,12879
1,15,1,1,2015,4,11169,1217,12386
1,15,1,1,2015,5,11736,1226,12962
1,15,1,1,2015,6,12665,1355,14020
1,15,1,1,2015,7,13584,1564,15148
1,15,1,1,2015,8,15188,1763,16951
1,15,1,1,2015,9,15705,1985,17690
1,15,1,1,2015,10,16678,2289,18967
1,15,1,1,2015,11,16379,2430,18809
1,15,1,1,2015,12,16321,2443,18764
1,15,1,1,2015,13,16004,2381,18385
1,15,1,1,2015,14,15648,2254,17902
1,15,1,1,2015,15,15539,2263,17802
1,15,1,1,2015,16,15401,2237,17638
1,15,1,1,2015,17,14667,2281,16948
1,15,1,1,2015,18,12945,2261,15206
1,15,1,1,2015,19,13276,2321,15597
1,15,1,1,2015,20,13355,2287,15642
1,15,1,1,2015,21,12803,2179,14982
1,15,1,1,2015,22,11959,1963,13922
1,15,1,1,2015,23,11566,1800,13366
1,15,1,1,2015,24,11549,1642,13191
1,16,1,1,2015,1,11484,1413,12897
1,16,1,1,2015,2,11323,1290,12613
1,16,1,1,2015,3,11337,1224,12561
1,16,1,1,2015,4,11321,1192,12513
1,16,1,1,2015,5,11854,1221,13075
1,16,1,1,2015,6,12679,1361,14040
1,16,1,1,2015,7,13663,1583,15246
1,16,1,1,2015,8,15428,1774,17202
1,16,1,1,2015,9,15601,1997,17598
1,16,1,1,2015,10,15409,2293,17702
1,16,1,1,2015,11,14979,2446,17425
1,16,1,1,2015,12,15302,2483,17785
1,16,1,1,2015,13,15023,2442,17465
1,16,1,1,2015,14,14802,2314,17116
1,16,1,1,2015,15,14712,2295,17007
1,16,1,1,2015,16,14084,2279,16363
1,16,1,1,2015,17,13607,2317,15924
1,16,1,1,2015,18,12750,2310,15060
1,16,1,1,2015,19,12956,2355,15311
1,16,1,1,2015,20,13198,2365,15563
1,16,1,1,2015,21,12560,2235,14795
1,16,1,1,2015,22,11804,2005,13809
1,16,1,1,2015,23,11269,1770,13039
1,16,1,1,2015,24,11259,1682,12941
2,17,1,1,2015,1,11386,1454,12840
2,17,1,1,2015,2,11280,1322,12602
2,17,1,1,2015,3,11382,1255,12637
2,17,1,1,2015,4,11339,1223,12562
2,17,1,1,2015,5,11627,1224,12851
2,17,1,1,2015,6,12384,1356,13740
2,17,1,1,2015,7,13772,1504,15276
2,17,1,1,2015,8,15183,1636,16819
2,17,1,1,2015,9,15426,1876,17302
2,17,1,1,2015,10,16449,2116,18565
2,17,1,1,2015,11,16000,2286,18286
2,17,1,1,2015,12,16237,2308,18545
2,17,1,1,2015,13,16096,2273,18369
2,17,1,1,2015,14,15385,2139,17524
2,17,1,1,2015,15,15084,2132,17216
2,17,1,1,2015,16,15086,2087,17173
2,17,1,1,2015,17,14393,2083,16476
2,17,1,1,2015,18,13115,2085,15200
2,17,1,1,2015,19,13668,2192,15860
2,17,1,1,2015,20,13373,2232,15605
2,17,1,1,2015,21,12817,2135,14952
2,17,1,1,2015,22,12201,1969,14170
2,17,1,1,2015,23,11408,1777,13185
2,17,1,1,2015,24,11474,1605,13079
2,18,1,1,2015,1,11540,1436,12976
2,18,1,1,2015,2,11538,1314,12852
2,18,1,1,2015,3,11517,1245,12762
2,18,1,1,2015,4,11579,1207,12786
2,18,1,1,2015,5,11629,1214,12843
2,18,1,1,2015,6,12572,1272,13844
2,18,1,1,2015,7,13438,1323,14761
2,18,1,1,2015,8,14706,1403,16109
2,18,1,1,2015,9,15574,1571,17145
2,18,1,1,2015,10,15960,1757,17717
2,18,1,1,2015,11,15807,1891,17698
2,18,1,1,2015,12,15799,1886,17685
2,18,1,1,2015,13,15440,1843,17283
2,18,1,1,2015,14,15151,1767,16918
2,18,1,1,2015,15,14964,1699,16663
2,18,1,1,2015,16,14805,1634,16439
2,18,1,1,2015,17,14200,1620,15820
2,18,1,1,2015,18,12764,1677,14441
2,18,1,1,2015,19,13441,1841,15282
2,18,1,1,2015,20,13469,1951,15420
2,18,1,1,2015,21,12723,1925,14648
2,18,1,1,2015,22,11836,1827,13663
2,18,1,1,2015,23,11786,1729,13515
2,18,1,1,2015,24,11219,1584,12803
1,19,1,1,2015,1,11652,1362,13014
1,19,1,1,2015,2,11476,1245,12721
1,19,1,1,2015,3,11406,1195,12601
1,19,1,1,2015,4,11508,1165,12673
1,19,1,1,2015,5,11994,1180,13174
1,19,1,1,2015,6,12778,1320,14098
1,19,1,1,2015,7,13654,1564,15218
1,19,1,1,2015,8,15363,1770,17133
1,19,1,1,2015,9,15927,1996,17923
1,19,1,1,2015,10,15856,2307,18163
1,19,1,1,2015,11,15320,2460,17780
1,19,1,1,2015,12,15593,2489,18082
1,19,1,1,2015,13,15301,2445,17746
1,19,1,1,2015,14,15093,2320,17413
1,19,1,1,2015,15,15131,2329,17460
1,19,1,1,2015,16,15010,2312,17322
1,19,1,1,2015,17,14385,2313,16698
1,19,1,1,2015,18,13230,2307,15537
1,19,1,1,2015,19,13266,2368,15634
1,19,1,1,2015,20,13356,2395,15751
1,19,1,1,2015,21,12807,2234,15041
1,19,1,1,2015,22,12108,2026,14134
1,19,1,1,2015,23,11662,1857,13519
1,19,1,1,2015,24,11336,1651,12987
1,20,1,1,2015,1,11883,1446,13329
1,20,1,1,2015,2,11542,1313,12855
1,20,1,1,2015,3,11466,1252,12718
1,20,1,1,2015,4,11543,1252,12795
1,20,1,1,2015,5,11938,1271,13209
1,20,1,1,2015,6,12793,1402,14195
1,20,1,1,2015,7,13835,1642,15477
1,20,1,1,2015,8,15329,1823,17152
1,20,1,1,2015,9,15468,2057,17525
1,20,1,1,2015,10,15884,2362,18246
1,20,1,1,2015,11,15848,2506,18354
1,20,1,1,2015,12,16004,2547,18551
1,20,1,1,2015,13,15304,2483,17787
1,20,1,1,2015,14,14928,2336,17264
1,20,1,1,2015,15,14616,2340,16956
1,20,1,1,2015,16,15045,2334,17379
1,20,1,1,2015,17,14437,2337,16774
1,20,1,1,2015,18,13092,2328,15420
1,20,1,1,2015,19,13267,2364,15631
1,20,1,1,2015,20,13733,2376,16109
1,20,1,1,2015,21,12821,2256,15077
1,20,1,1,2015,22,12061,2021,14082
1,20,1,1,2015,23,11647,1925,13572
1,20,1,1,2015,24,11337,1756,13093
1,21,1,1,2015,1,11539,1474,13013
1,21,1,1,2015,2,11480,1350,12830
1,21,1,1,2015,3,11438,1291,12729
1,21,1,1,2015,4,11397,1250,12647
1,21,1,1,2015,5,11531,1262,12793
1,21,1,1,2015,6,12658,1417,14075
1,21,1,1,2015,7,14098,1630,15728
1,21,1,1,2015,8,15360,1806,17166
1,21,1,1,2015,9,16038,2030,18068
1,21,1,1,2015,10,15790,2343,18133
1,21,1,1,2015,11,15768,2451,18219
1,21,1,1,2015,12,15478,2495,17973
1,21,1,1,2015,13,15467,2441,17908
1,21,1,1,2015,14,14913,2306,17219
1,21,1,1,2015,15,14820,2317,17137
1,21,1,1,2015,16,14869,2313,17182
1,21,1,1,2015,17,14307,2325,16632
1,21,1,1,2015,18,13045,2327,15372
1,21,1,1,2015,19,13244,2374,15618
1,21,1,1,2015,20,13489,2402,15891
1,21,1,1,2015,21,12837,2273,15110
1,21,1,1,2015,22,12150,2068,14218
1,21,1,1,2015,23,11781,1893,13674
1,21,1,1,2015,24,11333,1716,13049
1,22,1,1,2015,1,11805,1486,13291
1,22,1,1,2015,2,11721,1363,13084
1,22,1,1,2015,3,11734,1293,13027
1,22,1,1,2015,4,11666,1256,12922
1,22,1,1,2015,5,11936,1272,13208
1,22,1,1,2015,6,12809,1406,14215
1,22,1,1,2015,7,14139,1617,15756
1,22,1,1,2015,8,15378,1801,17179
1,22,1,1,2015,9,15733,2091,17824
1,22,1,1,2015,10,15894,2325,18219
1,22,1,1,2015,11,16070,2529,18599
1,22,1,1,2015,12,15863,2546,18409
1,22,1,1,2015,13,16038,2453,18491
1,22,1,1,2015,14,14847,2332,17179
1,22,1,1,2015,15,14962,2308,17270
1,22,1,1,2015,16,14377,2318,16695
1,22,1,1,2015,17,14566,2331,16897
1,22,1,1,2015,18,13103,2294,15397
1,22,1,1,2015,19,12768,2349,15117
1,22,1,1,2015,20,13496,2382,15878
1,22,1,1,2015,21,12552,2256,14808
1,22,1,1,2015,22,11999,2048,14047
1,22,1,1,2015,23,11442,1858,13300
1,22,1,1,2015,24,11549,1667,13216
1,23,1,1,2015,1,11852,1459,13311
1,23,1,1,2015,2,11506,1332,12838
1,23,1,1,2015,3,11707,1267,12974
1,23,1,1,2015,4,11732,1234,12966
1,23,1,1,2015,5,11579,1249,12828
1,23,1,1,2015,6,12717,1399,14116
1,23,1,1,2015,7,14075,1625,15700
1,23,1,1,2015,8,15401,1803,17204
1,23,1,1,2015,9,15132,2081,17213
1,23,1,1,2015,10,15347,2314,17661
1,23,1,1,2015,11,16136,2499,18635
1,23,1,1,2015,12,15716,2522,18238
1,23,1,1,2015,13,15800,2461,18261
1,23,1,1,2015,14,15603,2322,17925
1,23,1,1,2015,15,14835,2316,17151
1,23,1,1,2015,16,15068,2312,17380
1,23,1,1,2015,17,14256,2310,16566
1,23,1,1,2015,18,12807,2256,15063
1,23,1,1,2015,19,13322,2306,15628
1,23,1,1,2015,20,12923,2429,15352
1,23,1,1,2015,21,12532,2337,14869
1,23,1,1,2015,22,11881,2002,13883
1,23,1,1,2015,23,11480,1839,13319
1,23,1,1,2015,24,11315,1687,13002
2,24,1,1,2015,1,11843,1475,13318
2,24,1,1,2015,2,11284,1343,12627
2,24,1,1,2015,3,11416,1278,12694
2,24,1,1,2015,4,11323,1243,12566
2,24,1,1,2015,5,11501,1247,12748
2,24,1,1,2015,6,12682,1366,14048
2,24,1,1,2015,7,13515,1519,15034
2,24,1,1,2015,8,15093,1651,16744
2,24,1,1,2015,9,15657,1858,17515
2,24,1,1,2015,10,15728,2138,17866
2,24,1,1,2015,11,15756,2285,18041
2,24,1,1,2015,12,15817,2323,18140
2,24,1,1,2015,13,15486,2310,17796
2,24,1,1,2015,14,15259,2136,17395
2,24,1,1,2015,15,15444,2110,17554
2,24,1,1,2015,16,15138,2090,17228
2,24,1,1,2015,17,14790,2081,16871
2,24,1,1,2015,18,13043,2094,15137
2,24,1,1,2015,19,13357,2213,15570
2,24,1,1,2015,20,12952,2250,15202
2,24,1,1,2015,21,12909,2161,15070
2,24,1,1,2015,22,12062,1971,14033
2,24,1,1,2015,23,11807,1829,13636
2,24,1,1,2015,24,11514,1677,13191
2,25,1,1,2015,1,11849,1482,13331
2,25,1,1,2015,2,11874,1359,13233
2,25,1,1,2015,3,11837,1287,13124
2,25,1,1,2015,4,11502,1245,12747
2,25,1,1,2015,5,11847,1257,13104
2,25,1,1,2015,6,12366,1356,13722
2,25,1,1,2015,7,13122,1427,14549
2,25,1,1,2015,8,14187,1494,15681
2,25,1,1,2015,9,14825,1631,16456
2,25,1,1,2015,10,14524,1813,16337
2,25,1,1,2015,11,15111,1917,17028
2,25,1,1,2015,12,15251,1923,17174
2,25,1,1,2015,13,15159,1889,17048
2,25,1,1,2015,14,14509,1796,16305
2,25,1,1,2015,15,14102,1719,15821
2,25,1,1,2015,16,13771,1660,15431
2,25,1,1,2015,17,13567,1634,15201
2,25,1,1,2015,18,11978,1661,13639
2,25,1,1,2015,19,12262,1849,14111
2,25,1,1,2015,20,12734,1984,14718
2,25,1,1,2015,21,12039,1942,13981
2,25,1,1,2015,22,12004,1853,13857
2,25,1,1,2015,23,11727,1766,13493
2,25,1,1,2015,24,10513,1614,12127
3,26,1,1,2015,1,11754,1449,13203
3,26,1,1,2015,2,11114,1327,12441
3,26,1,1,2015,3,11304,1270,12574
3,26,1,1,2015,4,11592,1233,12825
3,26,1,1,2015,5,12046,1243,13289
3,26,1,1,2015,6,12507,1328,13835
3,26,1,1,2015,7,13421,1399,14820
3,26,1,1,2015,8,14255,1462,15717
3,26,1,1,2015,9,13998,1628,15626
3,26,1,1,2015,10,13783,1747,15530
3,26,1,1,2015,11,13732,1787,15519
3,26,1,1,2015,12,13926,1788,15714
3,26,1,1,2015,13,13477,1759,15236
3,26,1,1,2015,14,13005,1670,14675
3,26,1,1,2015,15,13284,1613,14897
3,26,1,1,2015,16,12791,1568,14359
3,26,1,1,2015,17,12288,1564,13852
3,26,1,1,2015,18,11022,1607,12629
3,26,1,1,2015,19,11331,1802,13133
3,26,1,1,2015,20,11741,1936,13677
3,26,1,1,2015,21,11174,1928,13102
3,26,1,1,2015,22,10448,1848,12296
3,26,1,1,2015,23,10028,1709,11737
3,26,1,1,2015,24,9878,1532,11410
1,27,1,1,2015,1,10048,1347,11395
1,27,1,1,2015,2,10371,1234,11605
1,27,1,1,2015,3,10595,1177,11772
1,27,1,1,2015,4,10218,1153,11371
1,27,1,1,2015,5,10394,1169,11563
1,27,1,1,2015,6,11120,1322,12442
1,27,1,1,2015,7,12049,1541,13590
1,27,1,1,2015,8,15000,1716,16716
1,27,1,1,2015,9,14663,1998,16661
1,27,1,1,2015,10,15001,2233,17234
1,27,1,1,2015,11,15087,2395,17482
1,27,1,1,2015,12,15122,2398,17520
1,27,1,1,2015,13,14894,2356,17250
1,27,1,1,2015,14,15189,2239,17428
1,27,1,1,2015,15,14136,2232,16368
1,27,1,1,2015,16,14313,2221,16534
1,27,1,1,2015,17,14100,2241,16341
1,27,1,1,2015,18,12610,2236,14846
1,27,1,1,2015,19,12968,2296,15264
1,27,1,1,2015,20,13210,2323,15533
1,27,1,1,2015,21,12947,2219,15166
1,27,1,1,2015,22,12257,2007,14264
1,27,1,1,2015,23,10910,1790,12700
1,27,1,1,2015,24,11881,1635,13516
1,28,1,1,2015,1,11518,1428,12946
1,28,1,1,2015,2,11536,1293,12829
1,28,1,1,2015,3,11407,1230,12637
1,28,1,1,2015,4,11286,1199,12485
1,28,1,1,2015,5,11732,1219,12951
1,28,1,1,2015,6,12658,1361,14019
1,28,1,1,2015,7,13650,1576,15226
1,28,1,1,2015,8,14805,1755,16560
1,28,1,1,2015,9,15454,1977,17431
1,28,1,1,2015,10,15404,2260,17664
1,28,1,1,2015,11,15065,2456,17521
1,28,1,1,2015,12,15378,2487,17865
1,28,1,1,2015,13,15341,2430,17771
1,28,1,1,2015,14,15009,2319,17328
1,28,1,1,2015,15,14737,2328,17065
1,28,1,1,2015,16,14765,2325,17090
1,28,1,1,2015,17,14500,2332,16832
1,28,1,1,2015,18,13095,2312,15407
1,28,1,1,2015,19,12909,2350,15259
1,28,1,1,2015,20,13489,2376,15865
1,28,1,1,2015,21,12953,2271,15224
1,28,1,1,2015,22,12267,2038,14305
1,28,1,1,2015,23,11669,1826,13495
1,28,1,1,2015,24,11679,1626,13305
1,29,1,1,2015,1,11814,1441,13255
1,29,1,1,2015,2,11873,1319,13192
1,29,1,1,2015,3,11952,1256,13208
1,29,1,1,2015,4,11436,1220,12656
1,29,1,1,2015,5,11888,1236,13124
1,29,1,1,2015,6,12577,1375,13952
1,29,1,1,2015,7,14184,1589,15773
1,29,1,1,2015,8,15646,1771,17417
1,29,1,1,2015,9,15862,2039,17901
1,29,1,1,2015,10,15921,2281,18202
1,29,1,1,2015,11,16244,2438,18682
1,29,1,1,2015,12,16273,2452,18725
1,29,1,1,2015,13,15731,2431,18162
1,29,1,1,2015,14,15659,2290,17949
1,29,1,1,2015,15,15328,2318,17646
1,29,1,1,2015,16,15130,2334,17464
1,29,1,1,2015,17,14431,2331,16762
1,29,1,1,2015,18,13242,2301,15543
1,29,1,1,2015,19,13007,2333,15340
1,29,1,1,2015,20,13603,2365,15968
1,29,1,1,2015,21,12948,2211,15159
1,29,1,1,2015,22,12012,2030,14042
1,29,1,1,2015,23,11726,1825,13551
1,29,1,1,2015,24,11742,1674,13416
1,30,1,1,2015,1,11828,1446,13274
1,30,1,1,2015,2,11825,1317,13142
1,30,1,1,2015,3,11829,1258,13087
1,30,1,1,2015,4,11746,1224,12970
1,30,1,1,2015,5,12062,1251,13313
1,30,1,1,2015,6,13054,1381,14435
1,30,1,1,2015,7,14039,1604,15643
1,30,1,1,2015,8,15227,1795,17022
1,30,1,1,2015,9,15999,2008,18007
1,30,1,1,2015,10,15764,2325,18089
1,30,1,1,2015,11,15807,2487,18294
1,30,1,1,2015,12,15770,2537,18307
1,30,1,1,2015,13,15304,2494,17798
1,30,1,1,2015,14,15131,2357,17488
1,30,1,1,2015,15,14472,2374,16846
1,30,1,1,2015,16,14650,2388,17038
1,30,1,1,2015,17,13963,2424,16387
1,30,1,1,2015,18,12458,2360,14818
1,30,1,1,2015,19,12539,2415,14954
1,30,1,1,2015,20,13395,2404,15799
1,30,1,1,2015,21,12698,2249,14947
1,30,1,1,2015,22,12279,2103,14382
1,30,1,1,2015,23,11771,1891,13662
1,30,1,1,2015,24,11863,1702,13565
2,31,1,1,2015,1,11968,1511,13479
2,31,1,1,2015,2,11728,1378,13106
2,31,1,1,2015,3,11634,1315,12949
2,31,1,1,2015,4,11635,1281,12916
2,31,1,1,2015,5,11821,1296,13117
2,31,1,1,2015,6,12853,1393,14246
2,31,1,1,2015,7,13661,1533,15194
2,31,1,1,2015,8,14898,1674,16572
2,31,1,1,2015,9,15615,1877,17492
2,31,1,1,2015,10,15756,2201,17957
2,31,1,1,2015,11,15684,2388,18072
2,31,1,1,2015,12,15405,2424,17829
2,31,1,1,2015,13,15205,2394,17599
2,31,1,1,2015,14,15185,2238,17423
2,31,1,1,2015,15,15103,2240,17343
2,31,1,1,2015,16,15178,2238,17416
2,31,1,1,2015,17,14277,2232,16509
2,31,1,1,2015,18,12854,2209,15063
2,31,1,1,2015,19,13322,2305,15627
2,31,1,1,2015,20,13735,2363,16098
2,31,1,1,2015,21,12849,2246,15095
2,31,1,1,2015,22,12212,2078,14290
2,31,1,1,2015,23,11865,1927,13792
2,31,1,1,2015,24,11886,1739,13625
2,1,2,1,2015,1,12056,1552,13608
2,1,2,1,2015,2,11788,1419,13207
2,1,2,1,2015,3,12084,1345,13429
2,1,2,1,2015,4,11761,1294,13055
2,1,2,1,2015,5,11876,1300,13176
2,1,2,1,2015,6,12436,1389,13825
2,1,2,1,2015,7,13044,1449,14493
2,1,2,1,2015,8,15179,1522,16701
2,1,2,1,2015,9,15576,1645,17221
2,1,2,1,2015,10,15512,1811,17323
2,1,2,1,2015,11,15758,1886,17644
2,1,2,1,2015,12,15643,1926,17569
2,1,2,1,2015,13,15383,1880,17263
2,1,2,1,2015,14,15105,1797,16902
2,1,2,1,2015,15,14869,1730,16599
2,1,2,1,2015,16,15026,1683,16709
2,1,2,1,2015,17,14039,1678,15717
2,1,2,1,2015,18,12550,1698,14248
2,1,2,1,2015,19,12540,1848,14388
2,1,2,1,2015,20,13178,2021,15199
2,1,2,1,2015,21,12836,1997,14833
2,1,2,1,2015,22,11668,1929,13597
2,1,2,1,2015,23,11653,1785,13438
2,1,2,1,2015,24,11659,1651,13310
1,2,2,1,2015,1,11812,1491,13303
1,2,2,1,2015,2,11723,1365,13088
1,2,2,1,2015,3,11534,1297,12831
1,2,2,1,2015,4,11858,1268,13126
1,2,2,1,2015,5,12121,1297,13418
1,2,2,1,2015,6,12596,1415,14011
1,2,2,1,2015,7,13787,1637,15424
1,2,2,1,2015,8,15002,1806,16808
1,2,2,1,2015,9,15350,2093,17443
1,2,2,1,2015,10,15553,2296,17849
1,2,2,1,2015,11,15514,2490,18004
1,2,2,1,2015,12,15801,2532,18333
1,2,2,1,2015,13,15113,2480,17593
1,2,2,1,2015,14,14938,2379,17317
1,2,2,1,2015,15,14913,2395,17308
1,2,2,1,2015,16,15062,2393,17455
1,2,2,1,2015,17,14482,2401,16883
1,2,2,1,2015,18,13007,2362,15369
1,2,2,1,2015,19,13166,2366,15532
1,2,2,1,2015,20,13660,2398,16058
1,2,2,1,2015,21,13164,2251,15415
1,2,2,1,2015,22,12311,2085,14396
1,2,2,1,2015,23,11859,1880,13739
1,2,2,1,2015,24,11695,1686,13381
1,3,2,1,2015,1,11831,1497,13328
1,3,2,1,2015,2,11629,1374,13003
1,3,2,1,2015,3,11598,1316,12914
1,3,2,1,2015,4,11544,1273,12817
1,3,2,1,2015,5,11769,1304,13073
1,3,2,1,2015,6,12495,1433,13928
1,3,2,1,2015,7,13756,1652,15408
1,3,2,1,2015,8,15228,1802,17030
1,3,2,1,2015,9,15805,2082,17887
1,3,2,1,2015,10,15904,2299,18203
1,3,2,1,2015,11,16039,2502,18541
1,3,2,1,2015,12,16326,2539,18865
1,3,2,1,2015,13,15663,2504,18167
1,3,2,1,2015,14,15497,2384,17881
1,3,2,1,2015,15,15113,2409,17522
1,3,2,1,2015,16,15185,2406,17591
1,3,2,1,2015,17,15145,2409,17554
1,3,2,1,2015,18,13267,2401,15668
1,3,2,1,2015,19,12838,2419,15257
1,3,2,1,2015,20,13385,2427,15812
1,3,2,1,2015,21,12756,2303,15059
1,3,2,1,2015,22,12085,2139,14224
1,3,2,1,2015,23,11778,1947,13725
1,3,2,1,2015,24,11933,1749,13682
1,4,2,1,2015,1,12393,1537,13930
1,4,2,1,2015,2,12287,1410,13697
1,4,2,1,2015,3,12029,1353,13382
1,4,2,1,2015,4,12125,1314,13439
1,4,2,1,2015,5,12544,1337,13881
1,4,2,1,2015,6,13116,1457,14573
1,4,2,1,2015,7,14476,1667,16143
1,4,2,1,2015,8,14980,1850,16830
1,4,2,1,2015,9,15708,2098,17806
1,4,2,1,2015,10,15726,2383,18109
1,4,2,1,2015,11,15559,2558,18117
1,4,2,1,2015,12,15804,2646,18450
1,4,2,1,2015,13,15336,2563,17899
1,4,2,1,2015,14,14932,2422,17354
1,4,2,1,2015,15,15070,2456,17526
1,4,2,1,2015,16,14745,2461,17206
1,4,2,1,2015,17,14646,2456,17102
1,4,2,1,2015,18,12718,2457,15175
1,4,2,1,2015,19,13467,2443,15910
1,4,2,1,2015,20,13645,2571,16216
1,4,2,1,2015,21,12855,2331,15186
1,4,2,1,2015,22,12083,2137,14220
1,4,2,1,2015,23,12262,1973,14235
1,4,2,1,2015,24,12067,1801,13868
1,5,2,1,2015,1,12281,1561,13842
1,5,2,1,2015,2,12057,1460,13517
1,5,2,1,2015,3,12071,1414,13485
1,5,2,1,2015,4,11909,1385,13294
1,5,2,1,2015,5,12109,1404,13513
1,5,2,1,2015,6,12819,1478,14297
1,5,2,1,2015,7,14362,1628,15990
1,5,2,1,2015,8,15479,1861,17340
1,5,2,1,2015,9,15676,2073,17749
1,5,2,1,2015,10,16432,2366,18798
1,5,2,1,2015,11,16329,2557,18886
1,5,2,1,2015,12,16426,2637,19063
1,5,2,1,2015,13,16067,2579,18646
1,5,2,1,2015,14,15657,2451,18108
1,5,2,1,2015,15,15564,2479,18043
1,5,2,1,2015,16,15377,2476,17853
1,5,2,1,2015,17,14999,2497,17496
1,5,2,1,2015,18,13332,2478,15810
1,5,2,1,2015,19,13145,2464,15609
1,5,2,1,2015,20,13450,2500,15950
1,5,2,1,2015,21,13295,2335,15630
1,5,2,1,2015,22,12716,2203,14919
1,5,2,1,2015,23,12181,1991,14172
1,5,2,1,2015,24,12177,1808,13985
1,6,2,1,2015,1,12288,1610,13898
1,6,2,1,2015,2,12064,1472,13536
1,6,2,1,2015,3,11771,1400,13171
1,6,2,1,2015,4,12125,1354,13479
1,6,2,1,2015,5,12269,1370,13639
1,6,2,1,2015,6,13155,1486,14641
1,6,2,1,2015,7,14289,1688,15977
1,6,2,1,2015,8,15574,1853,17427
1,6,2,1,2015,9,15604,2056,17660
1,6,2,1,2015,10,15881,2379,18260
1,6,2,1,2015,11,16039,2579,18618
1,6,2,1,2015,12,16178,2656,18834
1,6,2,1,2015,13,15187,2613,17800
1,6,2,1,2015,14,15241,2461,17702
1,6,2,1,2015,15,15113,2464,17577
1,6,2,1,2015,16,14969,2471,17440
1,6,2,1,2015,17,14368,2467,16835
1,6,2,1,2015,18,12416,2433,14849
1,6,2,1,2015,19,13056,2480,15536
1,6,2,1,2015,20,13477,2504,15981
1,6,2,1,2015,21,12933,2340,15273
1,6,2,1,2015,22,12028,2191,14219
1,6,2,1,2015,23,12009,1967,13976
1,6,2,1,2015,24,11589,1754,13343
2,7,2,1,2015,1,12041,1643,13684
2,7,2,1,2015,2,12091,1518,13609
2,7,2,1,2015,3,11928,1458,13386
2,7,2,1,2015,4,11975,1395,13370
2,7,2,1,2015,5,12083,1378,13461
2,7,2,1,2015,6,12943,1467,14410
2,7,2,1,2015,7,14162,1628,15790
2,7,2,1,2015,8,15579,1748,17327
2,7,2,1,2015,9,15749,1965,17714
2,7,2,1,2015,10,16302,2262,18564
2,7,2,1,2015,11,16617,2407,19024
2,7,2,1,2015,12,16195,2468,18663
2,7,2,1,2015,13,16408,2416,18824
2,7,2,1,2015,14,15938,2275,18213
2,7,2,1,2015,15,15505,2262,17767
2,7,2,1,2015,16,15484,2246,17730
2,7,2,1,2015,17,15072,2247,17319
2,7,2,1,2015,18,13348,2229,15577
2,7,2,1,2015,19,13295,2281,15576
2,7,2,1,2015,20,13801,2367,16168
2,7,2,1,2015,21,12890,2281,15171
2,7,2,1,2015,22,12492,2091,14583
2,7,2,1,2015,23,12272,1935,14207
2,7,2,1,2015,24,12301,1767,14068
2,8,2,1,2015,1,12550,1588,14138
2,8,2,1,2015,2,12345,1457,13802
2,8,2,1,2015,3,12531,1378,13909
2,8,2,1,2015,4,12357,1345,13702
2,8,2,1,2015,5,12414,1339,13753
2,8,2,1,2015,6,13119,1421,14540
2,8,2,1,2015,7,13963,1499,15462
2,8,2,1,2015,8,15233,1537,16770
2,8,2,1,2015,9,15541,1651,17192
2,8,2,1,2015,10,16580,1782,18362
2,8,2,1,2015,11,16544,1917,18461
2,8,2,1,2015,12,16840,1918,18758
2,8,2,1,2015,13,16285,1886,18171
2,8,2,1,2015,14,15588,1801,17389
2,8,2,1,2015,15,15233,1746,16979
2,8,2,1,2015,16,15160,1685,16845
2,8,2,1,2015,17,14585,1675,16260
2,8,2,1,2015,18,12858,1690,14548
2,8,2,1,2015,19,12689,1820,14509
2,8,2,1,2015,20,12998,1967,14965
2,8,2,1,2015,21,12747,1941,14688
2,8,2,1,2015,22,12161,1879,14040
2,8,2,1,2015,23,11904,1757,13661
2,8,2,1,2015,24,12102,1625,13727
1,9,2,1,2015,1,12280,1478,13758
1,9,2,1,2015,2,12290,1349,13639
1,9,2,1,2015,3,12212,1289,13501
1,9,2,1,2015,4,12020,1247,13267
1,9,2,1,2015,5,12372,1265,13637
1,9,2,1,2015,6,13231,1389,14620
1,9,2,1,2015,7,14419,1609,16028
1,9,2,1,2015,8,15548,1772,17320
1,9,2,1,2015,9,15850,2010,17860
1,9,2,1,2015,10,15944,2282,18226
1,9,2,1,2015,11,16390,2452,18842
1,9,2,1,2015,12,16493,2525,19018
1,9,2,1,2015,13,16075,2488,18563
1,9,2,1,2015,14,15573,2364,17937
1,9,2,1,2015,15,15661,2378,18039
1,9,2,1,2015,16,15467,2393,17860
1,9,2,1,2015,17,14854,2389,17243
1,9,2,1,2015,18,13093,2379,15472
1,9,2,1,2015,19,12961,2372,15333
1,9,2,1,2015,20,13414,2413,15827
1,9,2,1,2015,21,13032,2311,15343
1,9,2,1,2015,22,12324,2114,14438
1,9,2,1,2015,23,12049,1918,13967
1,9,2,1,2015,24,12075,1749,13824
1,10,2,1,2015,1,12613,1561,14174
1,10,2,1,2015,2,12601,1425,14026
1,10,2,1,2015,3,12738,1359,14097
1,10,2,1,2015,4,12627,1326,13953
1,10,2,1,2015,5,12861,1342,14203
1,10,2,1,2015,6,13397,1459,14856
1,10,2,1,2015,7,14256,1676,15932
1,10,2,1,2015,8,15786,1863,17649
1,10,2,1,2015,9,15893,2115,18008
1,10,2,1,2015,10,16262,2392,18654
1,10,2,1,2015,11,15805,2582,18387
1,10,2,1,2015,12,15838,2659,18497
1,10,2,1,2015,13,15154,2613,17767
1,10,2,1,2015,14,15061,2480,17541
1,10,2,1,2015,15,15200,2515,17715
1,10,2,1,2015,16,14967,2528,17495
1,10,2,1,2015,17,15396,2538,17934
1,10,2,1,2015,18,13163,2494,15657
1,10,2,1,2015,19,13201,2496,15697
1,10,2,1,2015,20,13554,2536,16090
1,10,2,1,2015,21,12972,2373,15345
1,10,2,1,2015,22,12402,2208,14610
1,10,2,1,2015,23,12109,1995,14104
1,10,2,1,2015,24,11870,1800,13670
1,11,2,1,2015,1,11708,1628,13336
1,11,2,1,2015,2,11386,1487,12873
1,11,2,1,2015,3,11510,1418,12928
1,11,2,1,2015,4,11274,1374,12648
1,11,2,1,2015,5,11052,1387,12439
1,11,2,1,2015,6,12018,1496,13514
1,11,2,1,2015,7,12877,1709,14586
1,11,2,1,2015,8,14075,1854,15929
1,11,2,1,2015,9,14353,2146,16499
1,11,2,1,2015,10,14511,2393,16904
1,11,2,1,2015,11,15045,2607,17652
1,11,2,1,2015,12,14703,2643,17346
1,11,2,1,2015,13,14640,2609,17249
1,11,2,1,2015,14,14441,2481,16922
1,11,2,1,2015,15,14377,2495,16872
1,11,2,1,2015,16,14278,2506,16784
1,11,2,1,2015,17,13920,2534,16454
1,11,2,1,2015,18,12397,2531,14928
1,11,2,1,2015,19,13317,2501,15818
1,11,2,1,2015,20,13616,2530,16146
1,11,2,1,2015,21,13146,2368,15514
1,11,2,1,2015,22,12579,2193,14772
1,11,2,1,2015,23,12115,1992,14107
1,11,2,1,2015,24,12214,1805,14019
1,12,2,1,2015,1,12260,1647,13907
1,12,2,1,2015,2,12107,1489,13596
1,12,2,1,2015,3,12146,1425,13571
1,12,2,1,2015,4,12287,1382,13669
1,12,2,1,2015,5,12384,1383,13767
1,12,2,1,2015,6,13010,1514,14524
1,12,2,1,2015,7,14102,1701,15803
1,12,2,1,2015,8,15248,1845,17093
1,12,2,1,2015,9,15320,2136,17456
1,12,2,1,2015,10,15700,2419,18119
1,12,2,1,2015,11,15783,2616,18399
1,12,2,1,2015,12,15789,2655,18444
1,12,2,1,2015,13,15348,2627,17975
1,12,2,1,2015,14,15059,2524,17583
1,12,2,1,2015,15,15114,2544,17658
1,12,2,1,2015,16,15135,2546,17681
1,12,2,1,2015,17,14501,2599,17100
1,12,2,1,2015,18,12793,2508,15301
1,12,2,1,2015,19,12969,2482,15451
1,12,2,1,2015,20,13714,2522,16236
1,12,2,1,2015,21,13096,2359,15455
1,12,2,1,2015,22,12453,2191,14644
1,12,2,1,2015,23,11983,1994,13977
1,12,2,1,2015,24,12341,1822,14163
1,13,2,1,2015,1,12456,1611,14067
1,13,2,1,2015,2,12150,1474,13624
1,13,2,1,2015,3,12354,1403,13757
1,13,2,1,2015,4,12280,1366,13646
1,13,2,1,2015,5,12741,1381,14122
1,13,2,1,2015,6,13207,1497,14704
1,13,2,1,2015,7,14108,1706,15814
1,13,2,1,2015,8,14888,1866,16754
1,13,2,1,2015,9,15574,2155,17729
1,13,2,1,2015,10,15544,2407,17951
1,13,2,1,2015,11,15659,2603,18262
1,13,2,1,2015,12,15376,2659,18035
1,13,2,1,2015,13,15246,2637,17883
1,13,2,1,2015,14,14681,2527,17208
1,13,2,1,2015,15,14337,2456,16793
1,13,2,1,2015,16,14215,2564,16779
1,13,2,1,2015,17,13424,2544,15968
1,13,2,1,2015,18,12747,2454,15201
1,13,2,1,2015,19,12599,2479,15078
1,13,2,1,2015,20,13339,2478,15817
1,13,2,1,2015,21,12969,2351,15320
1,13,2,1,2015,22,12163,2218,14381
1,13,2,1,2015,23,12208,2102,14310
1,13,2,1,2015,24,12347,1851,14198
2,14,2,1,2015,1,12320,1672,13992
2,14,2,1,2015,2,12315,1566,13881
2,14,2,1,2015,3,12238,1451,13689
2,14,2,1,2015,4,12017,1400,13417
2,14,2,1,2015,5,12213,1410,13623
2,14,2,1,2015,6,13025,1510,14535
2,14,2,1,2015,7,14179,1645,15824
2,14,2,1,2015,8,15405,1779,17184
2,14,2,1,2015,9,15469,2011,17480
2,14,2,1,2015,10,15934,2277,18211
2,14,2,1,2015,11,16215,2475,18690
2,14,2,1,2015,12,16335,2510,18845
2,14,2,1,2015,13,16118,2485,18603
2,14,2,1,2015,14,15740,2343,18083
2,14,2,1,2015,15,15763,2318,18081
2,14,2,1,2015,16,15421,2296,17717
2,14,2,1,2015,17,15183,2284,17467
2,14,2,1,2015,18,13378,2277,15655
2,14,2,1,2015,19,13260,2321,15581
2,14,2,1,2015,20,13719,2428,16147
2,14,2,1,2015,21,13333,2279,15612
2,14,2,1,2015,22,12562,2148,14710
2,14,2,1,2015,23,12328,1967,14295
2,14,2,1,2015,24,12504,1823,14327
2,15,2,1,2015,1,12687,1623,14310
2,15,2,1,2015,2,12575,1469,14044
2,15,2,1,2015,3,12465,1408,13873
2,15,2,1,2015,4,12502,1366,13868
2,15,2,1,2015,5,12633,1373,14006
2,15,2,1,2015,6,13111,1447,14558
2,15,2,1,2015,7,14124,1513,15637
2,15,2,1,2015,8,15235,1568,16803
2,15,2,1,2015,9,15426,1681,17107
2,15,2,1,2015,10,16212,1902,18114
2,15,2,1,2015,11,16326,2023,18349
2,15,2,1,2015,12,16251,2031,18282
2,15,2,1,2015,13,16036,1997,18033
2,15,2,1,2015,14,15238,1956,17194
2,15,2,1,2015,15,15596,1912,17508
2,15,2,1,2015,16,15025,1868,16893
2,15,2,1,2015,17,14487,1881,16368
2,15,2,1,2015,18,12586,1901,14487
2,15,2,1,2015,19,12535,1913,14448
2,15,2,1,2015,20,13065,2068,15133
2,15,2,1,2015,21,12498,2055,14553
2,15,2,1,2015,22,12449,2009,14458
2,15,2,1,2015,23,12250,1889,14139
2,15,2,1,2015,24,12394,1797,14191
1,16,2,1,2015,1,12519,1611,14130
1,16,2,1,2015,2,12377,1480,13857
1,16,2,1,2015,3,12239,1411,13650
1,16,2,1,2015,4,12187,1366,13553
1,16,2,1,2015,5,12696,1389,14085
1,16,2,1,2015,6,13248,1500,14748
1,16,2,1,2015,7,14501,1710,16211
1,16,2,1,2015,8,15413,1870,17283
1,16,2,1,2015,9,15841,2118,17959
1,16,2,1,2015,10,16320,2432,18752
1,16,2,1,2015,11,16287,2655,18942
1,16,2,1,2015,12,16697,2687,19384
1,16,2,1,2015,13,16149,2681,18830
1,16,2,1,2015,14,15768,2570,18338
1,16,2,1,2015,15,15823,2561,18384
1,16,2,1,2015,16,15959,2561,18520
1,16,2,1,2015,17,14981,2564,17545
1,16,2,1,2015,18,13572,2487,16059
1,16,2,1,2015,19,13140,2454,15594
1,16,2,1,2015,20,13752,2519,16271
1,16,2,1,2015,21,13447,2364,15811
1,16,2,1,2015,22,13092,2204,15296
1,16,2,1,2015,23,12810,2024,14834
1,16,2,1,2015,24,12729,1831,14560
3,17,2,1,2015,1,13152,1667,14819
3,17,2,1,2015,2,12776,1535,14311
3,17,2,1,2015,3,12708,1472,14180
3,17,2,1,2015,4,12713,1418,14131
3,17,2,1,2015,5,12978,1442,14420
3,17,2,1,2015,6,13457,1557,15014
3,17,2,1,2015,7,14317,1676,15993
3,17,2,1,2015,8,16152,1821,17973
3,17,2,1,2015,9,16321,2117,18438
3,17,2,1,2015,10,16686,2429,19115
3,17,2,1,2015,11,16942,2516,19458
3,17,2,1,2015,12,16860,2518,19378
3,17,2,1,2015,13,16392,2514,18906
3,17,2,1,2015,14,16074,2408,18482
3,17,2,1,2015,15,16068,2422,18490
3,17,2,1,2015,16,15885,2416,18301
3,17,2,1,2015,17,15087,2421,17508
3,17,2,1,2015,18,13324,2408,15732
3,17,2,1,2015,19,13162,2416,15578
3,17,2,1,2015,20,14301,2474,16775
3,17,2,1,2015,21,13787,2339,16126
3,17,2,1,2015,22,13010,2203,15213
3,17,2,1,2015,23,13067,2031,15098
3,17,2,1,2015,24,12994,1853,14847
1,18,2,1,2015,1,13105,1705,14810
1,18,2,1,2015,2,12893,1584,14477
1,18,2,1,2015,3,12835,1518,14353
1,18,2,1,2015,4,12865,1481,14346
1,18,2,1,2015,5,12971,1485,14456
1,18,2,1,2015,6,13623,1611,15234
1,18,2,1,2015,7,14905,1808,16713
1,18,2,1,2015,8,16042,1931,17973
1,18,2,1,2015,9,16097,2202,18299
1,18,2,1,2015,10,16456,2530,18986
1,18,2,1,2015,11,16322,2703,19025
1,18,2,1,2015,12,16767,2783,19550
1,18,2,1,2015,13,16408,2754,19162
1,18,2,1,2015,14,15909,2633,18542
1,18,2,1,2015,15,15749,2662,18411
1,18,2,1,2015,16,15592,2631,18223
1,18,2,1,2015,17,15033,2681,17714
1,18,2,1,2015,18,13432,2669,16101
1,18,2,1,2015,19,13171,2609,15780
1,18,2,1,2015,20,13859,2650,16509
1,18,2,1,2015,21,13623,2429,16052
1,18,2,1,2015,22,13315,2243,15558
1,18,2,1,2015,23,12646,2036,14682
1,18,2,1,2015,24,13036,1867,14903
3,19,2,1,2015,1,13073,1735,14808
3,19,2,1,2015,2,13040,1603,14643
3,19,2,1,2015,3,13310,1529,14839
3,19,2,1,2015,4,13126,1484,14610
3,19,2,1,2015,5,12440,1497,13937
3,19,2,1,2015,6,13348,1589,14937
3,19,2,1,2015,7,14642,1729,16371
3,19,2,1,2015,8,15732,1834,17566
3,19,2,1,2015,9,16210,2088,18298
3,19,2,1,2015,10,16971,2438,19409
3,19,2,1,2015,11,16856,2551,19407
3,19,2,1,2015,12,16859,2651,19510
3,19,2,1,2015,13,17023,2640,19663
3,19,2,1,2015,14,16358,2494,18852
3,19,2,1,2015,15,16661,2498,19159
3,19,2,1,2015,16,16130,2501,18631
3,19,2,1,2015,17,15460,2492,17952
3,19,2,1,2015,18,13630,2477,16107
3,19,2,1,2015,19,13484,2451,15935
3,19,2,1,2015,20,14301,2547,16848
3,19,2,1,2015,21,14260,2425,16685
3,19,2,1,2015,22,12996,2220,15216
3,19,2,1,2015,23,13146,2061,15207
3,19,2,1,2015,24,13361,1862,15223
1,20,2,1,2015,1,13598,1699,15297
1,20,2,1,2015,2,13113,1541,14654
1,20,2,1,2015,3,13677,1457,15134
1,20,2,1,2015,4,13218,1415,14633
1,20,2,1,2015,5,13272,1425,14697
1,20,2,1,2015,6,14042,1548,15590
1,20,2,1,2015,7,14901,1751,16652
1,20,2,1,2015,8,15776,1918,17694
1,20,2,1,2015,9,16593,2152,18745
1,20,2,1,2015,10,16384,2473,18857
1,20,2,1,2015,11,16289,2699,18988
1,20,2,1,2015,12,16871,2725,19596
1,20,2,1,2015,13,16042,2710,18752
1,20,2,1,2015,14,16113,2582,18695
1,20,2,1,2015,15,15170,2615,17785
1,20,2,1,2015,16,15426,2639,18065
1,20,2,1,2015,17,14673,2653,17326
1,20,2,1,2015,18,13217,2593,15810
1,20,2,1,2015,19,12934,2522,15456
1,20,2,1,2015,20,13380,2564,15944
1,20,2,1,2015,21,13301,2402,15703
1,20,2,1,2015,22,12872,2240,15112
1,20,2,1,2015,23,13025,2059,15084
1,20,2,1,2015,24,13003,1867,14870
2,21,2,1,2015,1,13087,1719,14806
2,21,2,1,2015,2,12926,1567,14493
2,21,2,1,2015,3,13356,1475,14831
2,21,2,1,2015,4,12650,1438,14088
2,21,2,1,2015,5,13172,1443,14615
2,21,2,1,2015,6,14236,1557,15793
2,21,2,1,2015,7,14625,1694,16319
2,21,2,1,2015,8,15085,1816,16901
2,21,2,1,2015,9,15500,2083,17583
2,21,2,1,2015,10,15974,2365,18339
2,21,2,1,2015,11,16105,2591,18696
2,21,2,1,2015,12,15666,2629,18295
2,21,2,1,2015,13,16383,2602,18985
2,21,2,1,2015,14,15548,2471,18019
2,21,2,1,2015,15,15608,2473,18081
2,21,2,1,2015,16,15965,2470,18435
2,21,2,1,2015,17,14897,2450,17347
2,21,2,1,2015,18,12773,2412,15185
2,21,2,1,2015,19,12583,2419,15002
2,21,2,1,2015,20,13594,2518,16112
2,21,2,1,2015,21,13344,2389,15733
2,21,2,1,2015,22,12626,2251,14877
2,21,2,1,2015,23,12838,2129,14967
2,21,2,1,2015,24,13038,2030,15068
2,22,2,1,2015,1,13046,1793,14839
2,22,2,1,2015,2,13366,1668,15034
2,22,2,1,2015,3,12956,1587,14543
2,22,2,1,2015,4,13133,1534,14667
2,22,2,1,2015,5,13527,1531,15058
2,22,2,1,2015,6,13967,1596,15563
2,22,2,1,2015,7,14081,1665,15746
2,22,2,1,2015,8,15522,1723,17245
2,22,2,1,2015,9,15231,1850,17081
2,22,2,1,2015,10,15594,1951,17545
2,22,2,1,2015,11,16639,2006,18645
2,22,2,1,2015,12,16415,2104,18519
2,22,2,1,2015,13,15873,2108,17981
2,22,2,1,2015,14,15265,2073,17338
2,22,2,1,2015,15,15064,2029,17093
2,22,2,1,2015,16,15488,2000,17488
2,22,2,1,2015,17,14689,2005,16694
2,22,2,1,2015,18,12658,1959,14617
2,22,2,1,2015,19,12850,1990,14840
2,22,2,1,2015,20,13355,2176,15531
2,22,2,1,2015,21,13626,2173,15799
2,22,2,1,2015,22,13982,2132,16114
2,22,2,1,2015,23,13236,2059,15295
2,22,2,1,2015,24,13961,1928,15889
1,23,2,1,2015,1,13126,1808,14934
1,23,2,1,2015,2,13182,1662,14844
1,23,2,1,2015,3,13291,1584,14875
1,23,2,1,2015,4,13255,1522,14777
1,23,2,1,2015,5,13408,1524,14932
1,23,2,1,2015,6,14253,1635,15888
1,23,2,1,2015,7,15203,1841,17044
1,23,2,1,2015,8,16183,2013,18196
1,23,2,1,2015,9,15571,2259,17830
1,23,2,1,2015,10,16083,2575,18658
1,23,2,1,2015,11,15896,2808,18704
1,23,2,1,2015,12,16460,2842,19302
1,23,2,1,2015,13,15916,2829,18745
1,23,2,1,2015,14,15681,2748,18429
1,23,2,1,2015,15,15549,2809,18358
1,23,2,1,2015,16,15713,2815,18528
1,23,2,1,2015,17,15090,2808,17898
1,23,2,1,2015,18,13620,2714,16334
1,23,2,1,2015,19,12983,2673,15656
1,23,2,1,2015,20,14080,2722,16802
1,23,2,1,2015,21,13839,2566,16405
1,23,2,1,2015,22,13241,2400,15641
1,23,2,1,2015,23,13403,2257,15660
1,23,2,1,2015,24,13273,2116,15389
1,24,2,1,2015,1,13614,1891,15505
1,24,2,1,2015,2,13414,1744,15158
1,24,2,1,2015,3,13464,1666,15130
1,24,2,1,2015,4,13295,1610,14905
1,24,2,1,2015,5,13739,1611,15350
1,24,2,1,2015,6,14347,1722,16069
1,24,2,1,2015,7,15057,1928,16985
1,24,2,1,2015,8,16378,2097,18475
1,24,2,1,2015,9,16194,2341,18535
1,24,2,1,2015,10,16233,2658,18891
1,24,2,1,2015,11,16438,2869,19307
1,24,2,1,2015,12,16531,2916,19447
1,24,2,1,2015,13,16493,2915,19408
1,24,2,1,2015,14,15864,2771,18635
1,24,2,1,2015,15,15891,2802,18693
1,24,2,1,2015,16,15981,2826,18807
1,24,2,1,2015,17,15644,2824,18468
1,24,2,1,2015,18,13884,2761,16645
1,24,2,1,2015,19,13594,2686,16280
1,24,2,1,2015,20,14482,2784,17266
1,24,2,1,2015,21,14108,2567,16675
1,24,2,1,2015,22,13628,2402,16030
1,24,2,1,2015,23,13410,2254,15664
1,24,2,1,2015,24,13667,2059,15726
1,25,2,1,2015,1,13864,1912,15776
1,25,2,1,2015,2,13786,1753,15539
1,25,2,1,2015,3,13761,1657,15418
1,25,2,1,2015,4,13807,1598,15405
1,25,2,1,2015,5,13886,1606,15492
1,25,2,1,2015,6,14718,1708,16426
1,25,2,1,2015,7,15409,1899,17308
1,25,2,1,2015,8,16307,2073,18380
1,25,2,1,2015,9,16175,2310,18485
1,25,2,1,2015,10,16467,2646,19113
1,25,2,1,2015,11,16588,2835,19423
1,25,2,1,2015,12,16520,2876,19396
1,25,2,1,2015,13,16256,2873,19129
1,25,2,1,2015,14,15782,2733,18515
1,25,2,1,2015,15,15779,2741,18520
1,25,2,1,2015,16,15514,2747,18261
1,25,2,1,2015,17,15200,2752,17952
1,25,2,1,2015,18,13853,2688,16541
1,25,2,1,2015,19,13910,2627,16537
1,25,2,1,2015,20,14563,2666,17229
1,25,2,1,2015,21,14106,2473,16579
1,25,2,1,2015,22,13595,2331,15926
1,25,2,1,2015,23,13277,2134,15411
1,25,2,1,2015,24,13591,1974,15565
1,26,2,1,2015,1,13672,1791,15463
1,26,2,1,2015,2,13570,1650,15220
1,26,2,1,2015,3,13393,1562,14955
1,26,2,1,2015,4,13517,1515,15032
1,26,2,1,2015,5,13848,1512,15360
1,26,2,1,2015,6,14628,1626,16254
1,26,2,1,2015,7,15271,1782,17053
1,26,2,1,2015,8,16006,1948,17954
1,26,2,1,2015,9,16141,2254,18395
1,26,2,1,2015,10,16460,2579,19039
1,26,2,1,2015,11,16424,2714,19138
1,26,2,1,2015,12,16189,2750,18939
1,26,2,1,2015,13,15937,2724,18661
1,26,2,1,2015,14,15793,2605,18398
1,26,2,1,2015,15,15524,2612,18136
1,26,2,1,2015,16,15461,2606,18067
1,26,2,1,2015,17,14921,2598,17519
1,26,2,1,2015,18,12974,2538,15512
1,26,2,1,2015,19,13009,2495,15504
1,26,2,1,2015,20,14105,2541,16646
1,26,2,1,2015,21,13762,2364,16126
1,26,2,1,2015,22,12960,2189,15149
1,26,2,1,2015,23,12869,2004,14873
1,26,2,1,2015,24,13411,1872,15283
1,27,2,1,2015,1,13490,1662,15152
1,27,2,1,2015,2,13275,1536,14811
1,27,2,1,2015,3,13478,1462,14940
1,27,2,1,2015,4,13233,1427,14660
1,27,2,1,2015,5,13729,1441,15170
1,27,2,1,2015,6,14096,1551,15647
1,27,2,1,2015,7,15029,1742,16771
1,27,2,1,2015,8,15848,1903,17751
1,27,2,1,2015,9,16114,2163,18277
1,27,2,1,2015,10,15671,2442,18113
1,27,2,1,2015,11,15630,2660,18290
1,27,2,1,2015,12,15751,2690,18441
1,27,2,1,2015,13,15468,2653,18121
1,27,2,1,2015,14,14784,2511,17295
1,27,2,1,2015,15,14504,2505,17009
1,27,2,1,2015,16,14879,2514,17393
1,27,2,1,2015,17,14063,2495,16558
1,27,2,1,2015,18,12767,2453,15220
1,27,2,1,2015,19,12440,2420,14860
1,27,2,1,2015,20,13636,2515,16151
1,27,2,1,2015,21,13264,2405,15669
1,27,2,1,2015,22,12576,2233,14809
1,27,2,1,2015,23,12498,2028,14526
1,27,2,1,2015,24,12860,1896,14756
2,28,2,1,2015,1,13183,1699,14882
2,28,2,1,2015,2,13075,1554,14629
2,28,2,1,2015,3,13025,1484,14509
2,28,2,1,2015,4,13208,1440,14648
2,28,2,1,2015,5,13196,1438,14634
2,28,2,1,2015,6,13939,1545,15484
2,28,2,1,2015,7,14638,1686,16324
2,28,2,1,2015,8,15541,1813,17354
2,28,2,1,2015,9,15903,2083,17986
2,28,2,1,2015,10,16169,2266,18435
2,28,2,1,2015,11,16044,2489,18533
2,28,2,1,2015,12,16209,2505,18714
2,28,2,1,2015,13,15907,2458,18365
2,28,2,1,2015,14,15147,2296,17443
2,28,2,1,2015,15,14731,2221,16952
2,28,2,1,2015,16,13799,2179,15978
2,28,2,1,2015,17,13163,2170,15333
2,28,2,1,2015,18,11866,2163,14029
2,28,2,1,2015,19,11785,2220,14005
2,28,2,1,2015,20,11811,2244,14055
2,28,2,1,2015,21,11329,2136,13465
2,28,2,1,2015,22,10533,1972,12505
2,28,2,1,2015,23,10329,1871,12200
2,28,2,1,2015,24,10221,1721,11942
2,1,3,1,2015,1,9918,1461,11379
2,1,3,1,2015,2,9548,1340,10888
2,1,3,1,2015,3,9260,1282,10542
2,1,3,1,2015,4,8638,1254,9892
2,1,3,1,2015,5,8129,1248,9377
2,1,3,1,2015,6,8557,1350,9907
2,1,3,1,2015,7,8791,1421,10212
2,1,3,1,2015,8,9682,1494,11176
2,1,3,1,2015,9,9898,1622,11520
2,1,3,1,2015,10,10533,1795,12328
2,1,3,1,2015,11,10343,1879,12222
2,1,3,1,2015,12,10037,1882,11919
2,1,3,1,2015,13,10164,1858,12022
2,1,3,1,2015,14,9946,1782,11728
2,1,3,1,2015,15,10053,1718,11771
2,1,3,1,2015,16,10000,1667,11667
2,1,3,1,2015,17,10595,1669,12264
2,1,3,1,2015,18,10400,1726,12126
2,1,3,1,2015,19,10636,1823,12459
2,1,3,1,2015,20,11219,1942,13161
2,1,3,1,2015,21,10582,1944,12526
2,1,3,1,2015,22,10173,1925,12098
2,1,3,1,2015,23,9829,1794,11623
2,1,3,1,2015,24,9525,1634,11159
1,2,3,1,2015,1,9147,1480,10627
1,2,3,1,2015,2,9244,1364,10608
1,2,3,1,2015,3,9384,1291,10675
1,2,3,1,2015,4,9072,1269,10341
1,2,3,1,2015,5,9616,1296,10912
1,2,3,1,2015,6,9850,1423,11273
1,2,3,1,2015,7,10682,1619,12301
1,2,3,1,2015,8,11153,1816,12969
1,2,3,1,2015,9,12257,2091,14348
1,2,3,1,2015,10,11987,2388,14375
1,2,3,1,2015,11,11655,2531,14186
1,2,3,1,2015,12,11274,2532,13806
1,2,3,1,2015,13,11199,2478,13677
1,2,3,1,2015,14,10913,2350,13263
1,2,3,1,2015,15,11021,2353,13374
1,2,3,1,2015,16,11097,2348,13445
1,2,3,1,2015,17,11150,2342,13492
1,2,3,1,2015,18,10649,2321,12970
1,2,3,1,2015,19,11629,2289,13918
1,2,3,1,2015,20,12770,2355,15125
1,2,3,1,2015,21,12119,2246,14365
1,2,3,1,2015,22,11600,2078,13678
1,2,3,1,2015,23,11016,1866,12882
1,2,3,1,2015,24,10750,1677,12427
1,3,3,1,2015,1,10643,1496,12139
1,3,3,1,2015,2,10458,1360,11818
1,3,3,1,2015,3,10565,1316,11881
1,3,3,1,2015,4,10557,1281,11838
1,3,3,1,2015,5,10814,1299,12113
1,3,3,1,2015,6,11440,1421,12861
1,3,3,1,2015,7,12519,1629,14148
1,3,3,1,2015,8,13110,1783,14893
1,3,3,1,2015,9,13147,2085,15232
1,3,3,1,2015,10,13203,2325,15528
1,3,3,1,2015,11,12979,2477,15456
1,3,3,1,2015,12,12653,2481,15134
1,3,3,1,2015,13,12776,2452,15228
1,3,3,1,2015,14,12233,2297,14530
1,3,3,1,2015,15,12217,2323,14540
1,3,3,1,2015,16,12438,2317,14755
1,3,3,1,2015,17,11919,2331,14250
1,3,3,1,2015,18,11337,2310,13647
1,3,3,1,2015,19,11676,2288,13964
1,3,3,1,2015,20,13062,2375,15437
1,3,3,1,2015,21,12325,2248,14573
1,3,3,1,2015,22,11781,2035,13816
1,3,3,1,2015,23,11074,1875,12949
1,3,3,1,2015,24,10907,1706,12613
1,4,3,1,2015,1,11346,1482,12828
1,4,3,1,2015,2,10858,1362,12220
1,4,3,1,2015,3,10873,1302,12175
1,4,3,1,2015,4,10924,1265,12189
1,4,3,1,2015,5,11306,1289,12595
1,4,3,1,2015,6,11901,1410,13311
1,4,3,1,2015,7,12803,1606,14409
1,4,3,1,2015,8,13136,1882,15018
1,4,3,1,2015,9,13967,2046,16013
1,4,3,1,2015,10,13766,2338,16104
1,4,3,1,2015,11,13682,2479,16161
1,4,3,1,2015,12,13157,2489,15646
1,4,3,1,2015,13,13381,2436,15817
1,4,3,1,2015,14,13011,2327,15338
1,4,3,1,2015,15,12918,2321,15239
1,4,3,1,2015,16,13035,2330,15365
1,4,3,1,2015,17,12608,2332,14940
1,4,3,1,2015,18,11943,2298,14241
1,4,3,1,2015,19,12257,2267,14524
1,4,3,1,2015,20,13481,2348,15829
1,4,3,1,2015,21,12433,2249,14682
1,4,3,1,2015,22,12292,2090,14382
1,4,3,1,2015,23,11702,1880,13582
1,4,3,1,2015,24,11729,1689,13418
1,5,3,1,2015,1,11382,1501,12883
1,5,3,1,2015,2,10993,1388,12381
1,5,3,1,2015,3,11115,1335,12450
1,5,3,1,2015,4,11152,1316,12468
1,5,3,1,2015,5,11374,1313,12687
1,5,3,1,2015,6,12238,1422,13660
1,5,3,1,2015,7,13006,1591,14597
1,5,3,1,2015,8,13770,1774,15544
1,5,3,1,2015,9,13791,2094,15885
1,5,3,1,2015,10,14329,2328,16657
1,5,3,1,2015,11,14654,2510,17164
1,5,3,1,2015,12,13983,2518,16501
1,5,3,1,2015,13,14159,2517,16676
1,5,3,1,2015,14,13786,2380,16166
1,5,3,1,2015,15,13621,2403,16024
1,5,3,1,2015,16,13780,2397,16177
1,5,3,1,2015,17,13321,2393,15714
1,5,3,1,2015,18,12102,2365,14467
1,5,3,1,2015,19,12075,2306,14381
1,5,3,1,2015,20,13121,2374,15495
1,5,3,1,2015,21,12658,2246,14904
1,5,3,1,2015,22,12041,2086,14127
1,5,3,1,2015,23,11682,1912,13594
1,5,3,1,2015,24,11336,1752,13088
3,6,3,1,2015,1,11298,1569,12867
3,6,3,1,2015,2,11576,1430,13006
3,6,3,1,2015,3,11137,1368,12505
3,6,3,1,2015,4,11171,1337,12508
3,6,3,1,2015,5,11368,1339,12707
3,6,3,1,2015,6,11740,1401,13141
3,6,3,1,2015,7,12079,1444,13523
3,6,3,1,2015,8,12885,1455,14340
3,6,3,1,2015,9,12762,1565,14327
3,6,3,1,2015,10,12645,1647,14292
3,6,3,1,2015,11,12620,1690,14310
3,6,3,1,2015,12,12517,1741,14258
3,6,3,1,2015,13,12652,1823,14475
3,6,3,1,2015,14,12363,1780,14143
3,6,3,1,2015,15,12301,1686,13987
3,6,3,1,2015,16,12012,1646,13658
3,6,3,1,2015,17,11533,1664,13197
3,6,3,1,2015,18,11138,1704,12842
3,6,3,1,2015,19,11288,1790,13078
3,6,3,1,2015,20,11959,1934,13893
3,6,3,1,2015,21,11461,1941,13402
3,6,3,1,2015,22,10562,1922,12484
3,6,3,1,2015,23,10601,1836,12437
3,6,3,1,2015,24,10387,1713,12100
2,7,3,1,2015,1,10453,1557,12010
2,7,3,1,2015,2,10357,1439,11796
2,7,3,1,2015,3,10332,1378,11710
2,7,3,1,2015,4,10336,1328,11664
2,7,3,1,2015,5,10521,1366,11887
2,7,3,1,2015,6,11346,1460,12806
2,7,3,1,2015,7,12248,1585,13833
2,7,3,1,2015,8,13365,1672,15037
2,7,3,1,2015,9,14345,1962,16307
2,7,3,1,2015,10,14710,2221,16931
2,7,3,1,2015,11,14567,2448,17015
2,7,3,1,2015,12,14859,2480,17339
2,7,3,1,2015,13,14642,2476,17118
2,7,3,1,2015,14,14172,2385,16557
2,7,3,1,2015,15,14112,2370,16482
2,7,3,1,2015,16,14149,2356,16505
2,7,3,1,2015,17,13717,2331,16048
2,7,3,1,2015,18,12399,2299,14698
2,7,3,1,2015,19,12117,2290,14407
2,7,3,1,2015,20,13393,2399,15792
2,7,3,1,2015,21,12780,2306,15086
2,7,3,1,2015,22,12545,2186,14731
2,7,3,1,2015,23,12144,2035,14179
2,7,3,1,2015,24,12005,1879,13884
2,8,3,1,2015,1,11176,1705,12881
2,8,3,1,2015,2,10923,1580,12503
2,8,3,1,2015,3,10828,1505,12333
2,8,3,1,2015,4,10779,1453,12232
2,8,3,1,2015,5,10997,1446,12443
2,8,3,1,2015,6,11648,1521,13169
2,8,3,1,2015,7,12217,1563,13780
2,8,3,1,2015,8,12881,1620,14501
2,8,3,1,2015,9,13295,1755,15050
2,8,3,1,2015,10,14062,1908,15970
2,8,3,1,2015,11,14027,2057,16084
2,8,3,1,2015,12,13626,2079,15705
2,8,3,1,2015,13,13736,2080,15816
2,8,3,1,2015,14,13193,1996,15189
2,8,3,1,2015,15,13274,1930,15204
2,8,3,1,2015,16,13213,1903,15116
2,8,3,1,2015,17,12629,1884,14513
2,8,3,1,2015,18,11297,1867,13164
2,8,3,1,2015,19,10840,1939,12779
2,8,3,1,2015,20,12038,2102,14140
2,8,3,1,2015,21,11943,2107,14050
2,8,3,1,2015,22,11401,2110,13511
2,8,3,1,2015,23,11080,1969,13049
2,8,3,1,2015,24,11178,1870,13048
1,9,3,1,2015,1,11965,1697,13662
1,9,3,1,2015,2,12128,1553,13681
1,9,3,1,2015,3,11863,1485,13348
1,9,3,1,2015,4,12116,1457,13573
1,9,3,1,2015,5,12572,1456,14028
1,9,3,1,2015,6,13199,1586,14785
1,9,3,1,2015,7,14236,1756,15992
1,9,3,1,2015,8,15250,1950,17200
1,9,3,1,2015,9,14984,2245,17229
1,9,3,1,2015,10,15023,2497,17520
1,9,3,1,2015,11,15386,2720,18106
1,9,3,1,2015,12,15565,2763,18328
1,9,3,1,2015,13,15128,2744,17872
1,9,3,1,2015,14,14816,2606,17422
1,9,3,1,2015,15,15002,2656,17658
1,9,3,1,2015,16,14792,2650,17442
1,9,3,1,2015,17,14799,2638,17437
1,9,3,1,2015,18,12649,2586,15235
1,9,3,1,2015,19,12651,2518,15169
1,9,3,1,2015,20,13471,2564,16035
1,9,3,1,2015,21,12972,2507,15479
1,9,3,1,2015,22,12482,2207,14689
1,9,3,1,2015,23,12360,2130,14490
1,9,3,1,2015,24,12018,1936,13954
1,10,3,1,2015,1,12271,1761,14032
1,10,3,1,2015,2,11944,1601,13545
1,10,3,1,2015,3,12084,1540,13624
1,10,3,1,2015,4,11710,1501,13211
1,10,3,1,2015,5,12062,1506,13568
1,10,3,1,2015,6,12996,1606,14602
1,10,3,1,2015,7,13927,1789,15716
1,10,3,1,2015,8,14786,1983,16769
1,10,3,1,2015,9,14845,2238,17083
1,10,3,1,2015,10,14778,2590,17368
1,10,3,1,2015,11,15095,2757,17852
1,10,3,1,2015,12,15102,2822,17924
1,10,3,1,2015,13,14987,2814,17801
1,10,3,1,2015,14,14702,2695,17397
1,10,3,1,2015,15,14904,2726,17630
1,10,3,1,2015,16,14546,2747,17293
1,10,3,1,2015,17,13980,2733,16713
1,10,3,1,2015,18,12439,2712,15151
1,10,3,1,2015,19,12305,2626,14931
1,10,3,1,2015,20,13445,2657,16102
1,10,3,1,2015,21,12964,2524,15488
1,10,3,1,2015,22,12618,2363,14981
1,10,3,1,2015,23,12121,2171,14292
1,10,3,1,2015,24,11781,2028,13809
1,11,3,1,2015,1,12266,1871,14137
1,11,3,1,2015,2,11553,1709,13262
1,11,3,1,2015,3,11957,1620,13577
1,11,3,1,2015,4,11723,1563,13286
1,11,3,1,2015,5,11710,1578,13288
1,11,3,1,2015,6,12314,1676,13990
1,11,3,1,2015,7,13465,1851,15316
1,11,3,1,2015,8,14008,2007,16015
1,11,3,1,2015,9,14474,2274,16748
1,11,3,1,2015,10,14382,2677,17059
1,11,3,1,2015,11,14541,2857,17398
1,11,3,1,2015,12,14603,2933,17536
1,11,3,1,2015,13,14335,2925,17260
1,11,3,1,2015,14,13847,2793,16640
1,11,3,1,2015,15,14192,2829,17021
1,11,3,1,2015,16,14204,2839,17043
1,11,3,1,2015,17,14081,2820,16901
1,11,3,1,2015,18,12942,2777,15719
1,11,3,1,2015,19,13045,2716,15761
1,11,3,1,2015,20,13955,2755,16710
1,11,3,1,2015,21,12685,2662,15347
1,11,3,1,2015,22,12963,2444,15407
1,11,3,1,2015,23,12191,2261,14452
1,11,3,1,2015,24,12234,2092,14326
1,12,3,1,2015,1,12172,1945,14117
1,12,3,1,2015,2,12175,1768,13943
1,12,3,1,2015,3,11835,1699,13534
1,12,3,1,2015,4,11834,1641,13475
1,12,3,1,2015,5,11942,1633,13575
1,12,3,1,2015,6,12578,1724,14302
1,12,3,1,2015,7,13304,1885,15189
1,12,3,1,2015,8,13776,2029,15805
1,12,3,1,2015,9,13833,2315,16148
1,12,3,1,2015,10,14122,2679,16801
1,12,3,1,2015,11,14162,2901,17063
1,12,3,1,2015,12,13821,2948,16769
1,12,3,1,2015,13,14126,2960,17086
1,12,3,1,2015,14,13844,2898,16742
1,12,3,1,2015,15,13927,2950,16877
1,12,3,1,2015,16,13906,2959,16865
1,12,3,1,2015,17,13320,2958,16278
1,12,3,1,2015,18,12565,2887,15452
1,12,3,1,2015,19,12407,2787,15194
1,12,3,1,2015,20,13712,2812,16524
1,12,3,1,2015,21,13281,2703,15984
1,12,3,1,2015,22,12725,2527,15252
1,12,3,1,2015,23,12397,2409,14806
1,12,3,1,2015,24,12138,2259,14397
1,13,3,1,2015,1,11977,2069,14046
1,13,3,1,2015,2,11972,1874,13846
1,13,3,1,2015,3,11908,1772,13680
1,13,3,1,2015,4,11746,1709,13455
1,13,3,1,2015,5,12088,1698,13786
1,13,3,1,2015,6,12657,1797,14454
1,13,3,1,2015,7,13563,1963,15526
1,13,3,1,2015,8,14136,2094,16230
1,13,3,1,2015,9,14220,2356,16576
1,13,3,1,2015,10,13929,2727,16656
1,13,3,1,2015,11,14161,2904,17065
1,13,3,1,2015,12,13897,2984,16881
1,13,3,1,2015,13,13660,2979,16639
1,13,3,1,2015,14,13609,2882,16491
1,13,3,1,2015,15,13627,2947,16574
1,13,3,1,2015,16,13414,2970,16384
1,13,3,1,2015,17,12864,2964,15828
1,13,3,1,2015,18,11687,2906,14593
1,13,3,1,2015,19,12076,2809,14885
1,13,3,1,2015,20,13027,2835,15862
1,13,3,1,2015,21,12465,2666,15131
1,13,3,1,2015,22,12187,2499,14686
1,13,3,1,2015,23,11878,2350,14228
1,13,3,1,2015,24,11793,2297,14090
2,14,3,1,2015,1,11809,2137,13946
2,14,3,1,2015,2,11757,1934,13691
2,14,3,1,2015,3,11902,1835,13737
2,14,3,1,2015,4,11428,1765,13193
2,14,3,1,2015,5,11444,1749,13193
2,14,3,1,2015,6,12216,1796,14012
2,14,3,1,2015,7,12026,1893,13919
2,14,3,1,2015,8,12984,2025,15009
2,14,3,1,2015,9,13440,2229,15669
2,14,3,1,2015,10,13686,2524,16210
2,14,3,1,2015,11,13542,2722,16264
2,14,3,1,2015,12,14129,2774,16903
2,14,3,1,2015,13,13849,2786,16635
2,14,3,1,2015,14,13388,2692,16080
2,14,3,1,2015,15,14049,2690,16739
2,14,3,1,2015,16,13636,2678,16314
2,14,3,1,2015,17,12821,2644,15465
2,14,3,1,2015,18,12831,2572,15403
2,14,3,1,2015,19,12442,2557,14999
2,14,3,1,2015,20,12965,2653,15618
2,14,3,1,2015,21,13224,2584,15808
2,14,3,1,2015,22,12279,2401,14680
2,14,3,1,2015,23,12120,2268,14388
2,14,3,1,2015,24,11780,2179,13959
2,15,3,1,2015,1,11237,2065,13302
2,15,3,1,2015,2,10874,1883,12757
2,15,3,1,2015,3,11415,1764,13179
2,15,3,1,2015,4,10856,1696,12552
2,15,3,1,2015,5,11216,1675,12891
2,15,3,1,2015,6,11831,1740,13571
2,15,3,1,2015,7,12259,1759,14018
2,15,3,1,2015,8,12905,1784,14689
2,15,3,1,2015,9,13142,1881,15023
2,15,3,1,2015,10,13436,2029,15465
2,15,3,1,2015,11,13340,2145,15485
2,15,3,1,2015,12,13532,2163,15695
2,15,3,1,2015,13,13022,2161,15183
2,15,3,1,2015,14,12833,2099,14932
2,15,3,1,2015,15,12548,2057,14605
2,15,3,1,2015,16,12833,2017,14850
2,15,3,1,2015,17,12001,1981,13982
2,15,3,1,2015,18,11311,1947,13258
2,15,3,1,2015,19,11798,1973,13771
2,15,3,1,2015,20,12568,2164,14732
2,15,3,1,2015,21,12714,2196,14910
2,15,3,1,2015,22,12159,2177,14336
2,15,3,1,2015,23,11673,2130,13803
2,15,3,1,2015,24,11607,2069,13676
1,16,3,1,2015,1,11669,1944,13613
1,16,3,1,2015,2,11771,1690,13461
1,16,3,1,2015,3,12144,1612,13756
1,16,3,1,2015,4,11763,1618,13381
1,16,3,1,2015,5,12039,1624,13663
1,16,3,1,2015,6,13054,1721,14775
1,16,3,1,2015,7,13713,1886,15599
1,16,3,1,2015,8,13809,2029,15838
1,16,3,1,2015,9,14517,2269,16786
1,16,3,1,2015,10,13609,2618,16227
1,16,3,1,2015,11,14466,2831,17297
1,16,3,1,2015,12,14128,2866,16994
1,16,3,1,2015,13,14604,2866,17470
1,16,3,1,2015,14,14150,2766,16916
1,16,3,1,2015,15,13836,2765,16601
1,16,3,1,2015,16,14206,2764,16970
1,16,3,1,2015,17,13382,2739,16121
1,16,3,1,2015,18,12714,2689,15403
1,16,3,1,2015,19,12458,2593,15051
1,16,3,1,2015,20,13886,2638,16524
1,16,3,1,2015,21,13348,2469,15817
1,16,3,1,2015,22,12880,2288,15168
1,16,3,1,2015,23,12490,2139,14629
1,16,3,1,2015,24,12344,2019,14363
1,17,3,1,2015,1,12123,1839,13962
1,17,3,1,2015,2,11874,1699,13573
1,17,3,1,2015,3,11939,1588,13527
1,17,3,1,2015,4,11633,1540,13173
1,17,3,1,2015,5,12057,1541,13598
1,17,3,1,2015,6,12930,1642,14572
1,17,3,1,2015,7,13709,1793,15502
1,17,3,1,2015,8,14362,1941,16303
1,17,3,1,2015,9,14212,2264,16476
1,17,3,1,2015,10,14324,2506,16830
1,17,3,1,2015,11,14527,2732,17259
1,17,3,1,2015,12,14493,2793,17286
1,17,3,1,2015,13,14445,2765,17210
1,17,3,1,2015,14,13977,2690,16667
1,17,3,1,2015,15,14311,2724,17035
1,17,3,1,2015,16,14315,2742,17057
1,17,3,1,2015,17,13563,2752,16315
1,17,3,1,2015,18,12770,2694,15464
1,17,3,1,2015,19,12565,2612,15177
1,17,3,1,2015,20,13950,2657,16607
1,17,3,1,2015,21,13464,2573,16037
1,17,3,1,2015,22,12745,2318,15063
1,17,3,1,2015,23,12778,2173,14951
1,17,3,1,2015,24,12492,2050,14542
1,18,3,1,2015,1,12366,1890,14256
1,18,3,1,2015,2,12370,1724,14094
1,18,3,1,2015,3,12461,1649,14110
1,18,3,1,2015,4,12175,1597,13772
1,18,3,1,2015,5,12497,1596,14093
1,18,3,1,2015,6,13225,1688,14913
1,18,3,1,2015,7,13890,1830,15720
1,18,3,1,2015,8,14593,1973,16566
1,18,3,1,2015,9,14526,2298,16824
1,18,3,1,2015,10,14807,2545,17352
1,18,3,1,2015,11,14881,2782,17663
1,18,3,1,2015,12,15503,2831,18334
1,18,3,1,2015,13,14738,2822,17560
1,18,3,1,2015,14,14695,2748,17443
1,18,3,1,2015,15,14824,2799,17623
1,18,3,1,2015,16,14727,2813,17540
1,18,3,1,2015,17,14310,2817,17127
1,18,3,1,2015,18,13067,2766,15833
1,18,3,1,2015,19,13257,2724,15981
1,18,3,1,2015,20,14116,2729,16845
1,18,3,1,2015,21,14131,2603,16734
1,18,3,1,2015,22,13597,2424,16021
1,18,3,1,2015,23,13005,2267,15272
1,18,3,1,2015,24,13075,2141,15216
1,19,3,1,2015,1,12818,1957,14775
1,19,3,1,2015,2,12817,1788,14605
1,19,3,1,2015,3,12806,1698,14504
1,19,3,1,2015,4,12700,1640,14340
1,19,3,1,2015,5,12778,1637,14415
1,19,3,1,2015,6,13463,1756,15219
1,19,3,1,2015,7,14444,1889,16333
1,19,3,1,2015,8,14860,2026,16886
1,19,3,1,2015,9,15228,2392,17620
1,19,3,1,2015,10,15215,2655,17870
1,19,3,1,2015,11,15696,2927,18623
1,19,3,1,2015,12,15924,2961,18885
1,19,3,1,2015,13,15621,2960,18581
1,19,3,1,2015,14,15511,2838,18349
1,19,3,1,2015,15,15441,2890,18331
1,19,3,1,2015,16,15512,2906,18418
1,19,3,1,2015,17,15090,2899,17989
1,19,3,1,2015,18,13500,2783,16283
1,19,3,1,2015,19,13345,2693,16038
1,19,3,1,2015,20,14341,2793,17134
1,19,3,1,2015,21,14319,2705,17024
1,19,3,1,2015,22,13323,2521,15844
1,19,3,1,2015,23,13078,2331,15409
1,19,3,1,2015,24,12914,2176,15090
1,20,3,1,2015,1,13148,2044,15192
1,20,3,1,2015,2,12761,1868,14629
1,20,3,1,2015,3,12663,1766,14429
1,20,3,1,2015,4,12592,1705,14297
1,20,3,1,2015,5,13012,1700,14712
1,20,3,1,2015,6,13744,1784,15528
1,20,3,1,2015,7,14205,1938,16143
1,20,3,1,2015,8,15184,2058,17242
1,20,3,1,2015,9,15072,2378,17450
1,20,3,1,2015,10,15271,2675,17946
1,20,3,1,2015,11,15340,2991,18331
1,20,3,1,2015,12,15525,3025,18550
1,20,3,1,2015,13,15322,3021,18343
1,20,3,1,2015,14,14882,2883,17765
1,20,3,1,2015,15,14963,2926,17889
1,20,3,1,2015,16,14798,2938,17736
1,20,3,1,2015,17,14216,2921,17137
1,20,3,1,2015,18,12782,2856,15638
1,20,3,1,2015,19,12731,2776,15507
1,20,3,1,2015,20,13778,2832,16610
1,20,3,1,2015,21,13478,2674,16152
1,20,3,1,2015,22,13208,2521,15729
1,20,3,1,2015,23,13084,2402,15486
1,20,3,1,2015,24,13198,2317,15515
3,21,3,1,2015,1,13590,2123,15713
3,21,3,1,2015,2,13401,1937,15338
3,21,3,1,2015,3,13255,1805,15060
3,21,3,1,2015,4,13180,1727,14907
3,21,3,1,2015,5,13160,1721,14881
3,21,3,1,2015,6,14025,1812,15837
3,21,3,1,2015,7,14566,1882,16448
3,21,3,1,2015,8,15069,1941,17010
3,21,3,1,2015,9,15211,2099,17310
3,21,3,1,2015,10,14982,2341,17323
3,21,3,1,2015,11,15639,2516,18155
3,21,3,1,2015,12,15550,2570,18120
3,21,3,1,2015,13,15401,2588,17989
3,21,3,1,2015,14,15535,2490,18025
3,21,3,1,2015,15,15194,2502,17696
3,21,3,1,2015,16,15472,2500,17972
3,21,3,1,2015,17,14572,2463,17035
3,21,3,1,2015,18,13050,2438,15488
3,21,3,1,2015,19,12805,2463,15268
3,21,3,1,2015,20,13546,2584,16130
3,21,3,1,2015,21,13556,2535,16091
3,21,3,1,2015,22,13422,2484,15906
3,21,3,1,2015,23,12926,2425,15351
3,21,3,1,2015,24,13375,2390,15765
2,22,3,1,2015,1,13381,2230,15611
2,22,3,1,2015,2,13160,2071,15231
2,22,3,1,2015,3,13049,1942,14991
2,22,3,1,2015,4,13132,1853,14985
2,22,3,1,2015,5,13194,1812,15006
2,22,3,1,2015,6,14034,1855,15889
2,22,3,1,2015,7,14516,1866,16382
2,22,3,1,2015,8,15342,1886,17228
2,22,3,1,2015,9,15283,1975,17258
2,22,3,1,2015,10,15457,2084,17541
2,22,3,1,2015,11,15710,2225,17935
2,22,3,1,2015,12,16122,2271,18393
2,22,3,1,2015,13,14601,2310,16911
2,22,3,1,2015,14,15508,2195,17703
2,22,3,1,2015,15,15519,2170,17689
2,22,3,1,2015,16,15801,2151,17952
2,22,3,1,2015,17,14981,2112,17093
2,22,3,1,2015,18,13212,2059,15271
2,22,3,1,2015,19,13219,2103,15322
2,22,3,1,2015,20,14175,2331,16506
2,22,3,1,2015,21,13731,2290,16021
2,22,3,1,2015,22,13810,2277,16087
2,22,3,1,2015,23,13735,2267,16002
2,22,3,1,2015,24,13569,2295,15864
1,23,3,1,2015,1,14018,2230,16248
1,23,3,1,2015,2,13878,2053,15931
1,23,3,1,2015,3,13967,1928,15895
1,23,3,1,2015,4,13640,1855,15495
1,23,3,1,2015,5,14044,1817,15861
1,23,3,1,2015,6,14525,1888,16413
1,23,3,1,2015,7,15103,2010,17113
1,23,3,1,2015,8,15514,2136,17650
1,23,3,1,2015,9,15458,2487,17945
1,23,3,1,2015,10,15791,2810,18601
1,23,3,1,2015,11,16559,3089,19648
1,23,3,1,2015,12,16377,3134,19511
1,23,3,1,2015,13,16124,3152,19276
1,23,3,1,2015,14,16241,3045,19286
1,23,3,1,2015,15,15990,3095,19085
1,23,3,1,2015,16,16323,3121,19444
1,23,3,1,2015,17,15405,3085,18490
1,23,3,1,2015,18,13840,3000,16840
1,23,3,1,2015,19,13675,2868,16543
1,23,3,1,2015,20,14766,2895,17661
1,23,3,1,2015,21,14389,2798,17187
1,23,3,1,2015,22,13833,2693,16526
1,23,3,1,2015,23,14006,2563,16569
1,23,3,1,2015,24,14144,2490,16634
1,24,3,1,2015,1,14467,2310,16777
1,24,3,1,2015,2,14298,2074,16372
1,24,3,1,2015,3,14175,1911,16086
1,24,3,1,2015,4,13749,1859,15608
1,24,3,1,2015,5,14136,1837,15973
1,24,3,1,2015,6,14724,1907,16631
1,24,3,1,2015,7,15160,2040,17200
1,24,3,1,2015,8,15842,2192,18034
1,24,3,1,2015,9,15658,2513,18171
1,24,3,1,2015,10,15973,2773,18746
1,24,3,1,2015,11,16639,3085,19724
1,24,3,1,2015,12,16318,3147,19465
1,24,3,1,2015,13,16120,3156,19276
1,24,3,1,2015,14,15870,3066,18936
1,24,3,1,2015,15,16297,3082,19379
1,24,3,1,2015,16,16134,3079,19213
1,24,3,1,2015,17,15555,3059,18614
1,24,3,1,2015,18,14336,2994,17330
1,24,3,1,2015,19,13717,2888,16605
1,24,3,1,2015,20,14748,2903,17651
1,24,3,1,2015,21,14632,2740,17372
1,24,3,1,2015,22,14219,2644,16863
1,24,3,1,2015,23,14090,2469,16559
1,24,3,1,2015,24,14352,2451,16803
1,25,3,1,2015,1,14409,2305,16714
1,25,3,1,2015,2,14062,2076,16138
1,25,3,1,2015,3,14037,1958,15995
1,25,3,1,2015,4,14097,1880,15977
1,25,3,1,2015,5,14246,1845,16091
1,25,3,1,2015,6,14671,1913,16584
1,25,3,1,2015,7,15341,2025,17366
1,25,3,1,2015,8,15439,2147,17586
1,25,3,1,2015,9,15711,2434,18145
1,25,3,1,2015,10,15825,2786,18611
1,25,3,1,2015,11,16249,3071,19320
1,25,3,1,2015,12,16560,3164,19724
1,25,3,1,2015,13,15622,3196,18818
1,25,3,1,2015,14,15824,3126,18950
1,25,3,1,2015,15,16204,3209,19413
1,25,3,1,2015,16,15996,3216,19212
1,25,3,1,2015,17,15505,3210,18715
1,25,3,1,2015,18,13926,3134,17060
1,25,3,1,2015,19,13589,3041,16630
1,25,3,1,2015,20,14479,3048,17527
1,25,3,1,2015,21,14574,2915,17489
1,25,3,1,2015,22,14012,2820,16832
1,25,3,1,2015,23,14084,2819,16903
1,25,3,1,2015,24,14322,2641,16963
1,26,3,1,2015,1,14613,2582,17195
1,26,3,1,2015,2,14483,2321,16804
1,26,3,1,2015,3,14216,2144,16360
1,26,3,1,2015,4,14266,2087,16353
1,26,3,1,2015,5,14592,2048,16640
1,26,3,1,2015,6,14988,2110,17098
1,26,3,1,2015,7,15679,2163,17842
1,26,3,1,2015,8,16084,2282,18366
1,26,3,1,2015,9,16064,2528,18592
1,26,3,1,2015,10,16644,3005,19649
1,26,3,1,2015,11,16895,3277,20172
1,26,3,1,2015,12,17128,3349,20477
1,26,3,1,2015,13,16945,3344,20289
1,26,3,1,2015,14,16492,3253,19745
1,26,3,1,2015,15,16720,3336,20056
1,26,3,1,2015,16,16576,3342,19918
1,26,3,1,2015,17,16132,3304,19436
1,26,3,1,2015,18,13679,3116,16795
1,26,3,1,2015,19,13652,3036,16688
1,26,3,1,2015,20,14432,3044,17476
1,26,3,1,2015,21,14557,2935,17492
1,26,3,1,2015,22,14148,2838,16986
1,26,3,1,2015,23,14065,2795,16860
1,26,3,1,2015,24,14388,2739,17127
1,27,3,1,2015,1,14532,2525,17057
1,27,3,1,2015,2,14292,2315,16607
1,27,3,1,2015,3,14126,2146,16272
1,27,3,1,2015,4,14245,2056,16301
1,27,3,1,2015,5,14565,2026,16591
1,27,3,1,2015,6,14665,2061,16726
1,27,3,1,2015,7,15308,2154,17462
1,27,3,1,2015,8,15531,2256,17787
1,27,3,1,2015,9,15267,2554,17821
1,27,3,1,2015,10,15636,2920,18556
1,27,3,1,2015,11,15676,3221,18897
1,27,3,1,2015,12,15679,3305,18984
1,27,3,1,2015,13,15446,3325,18771
1,27,3,1,2015,14,14971,3250,18221
1,27,3,1,2015,15,15359,3311,18670
1,27,3,1,2015,16,15054,3307,18361
1,27,3,1,2015,17,14541,3255,17796
1,27,3,1,2015,18,13436,3153,16589
1,27,3,1,2015,19,13423,3044,16467
1,27,3,1,2015,20,14435,3037,17472
1,27,3,1,2015,21,14324,2885,17209
1,27,3,1,2015,22,14126,2797,16923
1,27,3,1,2015,23,14297,2741,17038
1,27,3,1,2015,24,14082,2641,16723
3,28,3,1,2015,1,14759,2549,17308
3,28,3,1,2015,2,14283,2323,16606
3,28,3,1,2015,3,14152,2173,16325
3,28,3,1,2015,4,13838,2069,15907
3,28,3,1,2015,5,14014,2024,16038
3,28,3,1,2015,6,14439,2056,16495
3,28,3,1,2015,7,15190,2067,17257
3,28,3,1,2015,8,15645,2096,17741
3,28,3,1,2015,9,15701,2310,18011
3,28,3,1,2015,10,15757,2622,18379
3,28,3,1,2015,11,16468,2884,19352
3,28,3,1,2015,12,16390,2994,19384
3,28,3,1,2015,13,16314,2998,19312
3,28,3,1,2015,14,16009,2926,18935
3,28,3,1,2015,15,16057,2964,19021
3,28,3,1,2015,16,16316,2957,19273
3,28,3,1,2015,17,15190,2911,18101
3,28,3,1,2015,18,13430,2818,16248
3,28,3,1,2015,19,13290,2727,16017
3,28,3,1,2015,20,13886,2850,16736
3,28,3,1,2015,21,13532,2757,16289
3,28,3,1,2015,22,13605,2657,16262
3,28,3,1,2015,23,13815,2590,16405
3,28,3,1,2015,24,14034,2588,16622
2,29,3,1,2015,1,14114,2453,16567
2,29,3,1,2015,2,14148,2278,16426
2,29,3,1,2015,3,13904,2136,16040
2,29,3,1,2015,4,13799,2041,15840
2,29,3,1,2015,5,13924,1996,15920
2,29,3,1,2015,6,14162,2004,16166
2,29,3,1,2015,7,14842,2001,16843
2,29,3,1,2015,8,14990,1973,16963
2,29,3,1,2015,9,15071,2055,17126
2,29,3,1,2015,10,15155,2189,17344
2,29,3,1,2015,11,15458,2333,17791
2,29,3,1,2015,12,15765,2403,18168
2,29,3,1,2015,13,15488,2433,17921
2,29,3,1,2015,14,15218,2448,17666
2,29,3,1,2015,15,15427,2449,17876
2,29,3,1,2015,16,15334,2393,17727
2,29,3,1,2015,17,14395,2316,16711
2,29,3,1,2015,18,12794,2236,15030
2,29,3,1,2015,19,12501,2238,14739
2,29,3,1,2015,20,13542,2439,15981
2,29,3,1,2015,21,13062,2484,15546
2,29,3,1,2015,22,12734,2505,15239
2,29,3,1,2015,23,13057,2520,15577
2,29,3,1,2015,24,13474,2522,15996
1,30,3,1,2015,1,13717,2392,16109
1,30,3,1,2015,2,13385,2167,15552
1,30,3,1,2015,3,13159,2009,15168
1,30,3,1,2015,4,13207,1903,15110
1,30,3,1,2015,5,12632,1861,14493
1,30,3,1,2015,6,13831,1929,15760
1,30,3,1,2015,7,13948,2004,15952
1,30,3,1,2015,8,14853,2132,16985
1,30,3,1,2015,9,14411,2469,16880
1,30,3,1,2015,10,14455,2778,17233
1,30,3,1,2015,11,14914,3092,18006
1,30,3,1,2015,12,15624,3202,18826
1,30,3,1,2015,13,14761,3198,17959
1,30,3,1,2015,14,14949,3122,18071
1,30,3,1,2015,15,15413,3152,18565
1,30,3,1,2015,16,15405,3175,18580
1,30,3,1,2015,17,14818,3160,17978
1,30,3,1,2015,18,13209,3027,16236
1,30,3,1,2015,19,13325,2915,16240
1,30,3,1,2015,20,13538,2938,16476
1,30,3,1,2015,21,14254,2818,17072
1,30,3,1,2015,22,13870,2711,16581
1,30,3,1,2015,23,14086,2669,16755
1,30,3,1,2015,24,13834,2644,16478
1,31,3,1,2015,1,14252,2472,16724
1,31,3,1,2015,2,14113,2233,16346
1,31,3,1,2015,3,13917,2085,16002
1,31,3,1,2015,4,13843,1997,15840
1,31,3,1,2015,5,13900,1957,15857
1,31,3,1,2015,6,14318,2001,16319
1,31,3,1,2015,7,14891,2067,16958
1,31,3,1,2015,8,15042,2151,17193
1,31,3,1,2015,9,15178,2443,17621
1,31,3,1,2015,10,15509,2817,18326
1,31,3,1,2015,11,15697,3047,18744
1,31,3,1,2015,12,15806,3092,18898
1,31,3,1,2015,13,15894,3080,18974
1,31,3,1,2015,14,15442,2945,18387
1,31,3,1,2015,15,15558,2967,18525
1,31,3,1,2015,16,15831,2971,18802
1,31,3,1,2015,17,15173,2951,18124
1,31,3,1,2015,18,13658,2890,16548
1,31,3,1,2015,19,13128,2757,15885
1,31,3,1,2015,20,14596,2802,17398
1,31,3,1,2015,21,13901,2724,16625
1,31,3,1,2015,22,13778,2523,16301
1,31,3,1,2015,23,13686,2434,16120
1,31,3,1,2015,24,14047,2408,16455
1,1,4,2,2015,1,13755,2227,15982
1,1,4,2,2015,2,14242,2060,16302
1,1,4,2,2015,3,13541,1927,15468
1,1,4,2,2015,4,13584,1834,15418
1,1,4,2,2015,5,13657,1804,15461
1,1,4,2,2015,6,14275,1866,16141
1,1,4,2,2015,7,14917,1953,16870
1,1,4,2,2015,8,14940,2058,16998
1,1,4,2,2015,9,14807,2358,17165
1,1,4,2,2015,10,15150,2651,17801
1,1,4,2,2015,11,15520,2976,18496
1,1,4,2,2015,12,15476,3058,18534
1,1,4,2,2015,13,15350,3055,18405
1,1,4,2,2015,14,15178,2981,18159
1,1,4,2,2015,15,15471,3029,18500
1,1,4,2,2015,16,15364,3048,18412
1,1,4,2,2015,17,15091,3015,18106
1,1,4,2,2015,18,13207,2906,16113
1,1,4,2,2015,19,12941,2796,15737
1,1,4,2,2015,20,14249,2837,17086
1,1,4,2,2015,21,13997,2691,16688
1,1,4,2,2015,22,13672,2554,16226
1,1,4,2,2015,23,13721,2378,16099
1,1,4,2,2015,24,13710,2402,16112
3,2,4,2,2015,1,14094,2314,16408
3,2,4,2,2015,2,13826,2090,15916
3,2,4,2,2015,3,13906,1960,15866
3,2,4,2,2015,4,13752,1873,15625
3,2,4,2,2015,5,13938,1838,15776
3,2,4,2,2015,6,13855,1888,15743
3,2,4,2,2015,7,15305,1924,17229
3,2,4,2,2015,8,15375,1997,17372
3,2,4,2,2015,9,15451,2281,17732
3,2,4,2,2015,10,15626,2598,18224
3,2,4,2,2015,11,16395,2842,19237
3,2,4,2,2015,12,16197,2918,19115
3,2,4,2,2015,13,16225,2905,19130
3,2,4,2,2015,14,15728,2835,18563
3,2,4,2,2015,15,15839,2853,18692
3,2,4,2,2015,16,15859,2870,18729
3,2,4,2,2015,17,15230,2841,18071
3,2,4,2,2015,18,13447,2763,16210
3,2,4,2,2015,19,13420,2681,16101
3,2,4,2,2015,20,14188,2756,16944
3,2,4,2,2015,21,14146,2624,16770
3,2,4,2,2015,22,13422,2498,15920
3,2,4,2,2015,23,13892,2391,16283
3,2,4,2,2015,24,13824,2434,16258
3,3,4,2,2015,1,14257,2278,16535
3,3,4,2,2015,2,14172,2095,16267
3,3,4,2,2015,3,14084,1960,16044
3,3,4,2,2015,4,13689,1878,15567
3,3,4,2,2015,5,13755,1843,15598
3,3,4,2,2015,6,14045,1888,15933
3,3,4,2,2015,7,15167,1906,17073
3,3,4,2,2015,8,15560,1959,17519
3,3,4,2,2015,9,15090,2208,17298
3,3,4,2,2015,10,15437,2483,17920
3,3,4,2,2015,11,15725,2732,18457
3,3,4,2,2015,12,15540,2788,18328
3,3,4,2,2015,13,15023,2786,17809
3,3,4,2,2015,14,14745,2662,17407
3,3,4,2,2015,15,14749,2718,17467
3,3,4,2,2015,16,14976,2743,17719
3,3,4,2,2015,17,14525,2737,17262
3,3,4,2,2015,18,12915,2664,15579
3,3,4,2,2015,19,12406,2597,15003
3,3,4,2,2015,20,14314,2728,17042
3,3,4,2,2015,21,13671,2622,16293
3,3,4,2,2015,22,13483,2481,15964
3,3,4,2,2015,23,13691,2411,16102
3,3,4,2,2015,24,14043,2386,16429
2,4,4,2,2015,1,14251,2245,16496
2,4,4,2,2015,2,13679,2061,15740
2,4,4,2,2015,3,13561,1942,15503
2,4,4,2,2015,4,13801,1859,15660
2,4,4,2,2015,5,13590,1825,15415
2,4,4,2,2015,6,14170,1881,16051
2,4,4,2,2015,7,14920,1918,16838
2,4,4,2,2015,8,14706,1992,16698
2,4,4,2,2015,9,14810,2252,17062
2,4,4,2,2015,10,14793,2525,17318
2,4,4,2,2015,11,15338,2803,18141
2,4,4,2,2015,12,15607,2860,18467
2,4,4,2,2015,13,15593,2855,18448
2,4,4,2,2015,14,15210,2753,17963
2,4,4,2,2015,15,15160,2798,17958
2,4,4,2,2015,16,15360,2807,18167
2,4,4,2,2015,17,14873,2768,17641
2,4,4,2,2015,18,12786,2666,15452
2,4,4,2,2015,19,12494,2612,15106
2,4,4,2,2015,20,14419,2767,17186
2,4,4,2,2015,21,13999,2670,16669
2,4,4,2,2015,22,13569,2498,16067
2,4,4,2,2015,23,13274,2454,15728
2,4,4,2,2015,24,13567,2422,15989
2,5,4,2,2015,1,14220,2278,16498
2,5,4,2,2015,2,14043,2086,16129
2,5,4,2,2015,3,13131,1964,15095
2,5,4,2,2015,4,13837,1890,15727
2,5,4,2,2015,5,13547,1855,15402
2,5,4,2,2015,6,13989,1905,15894
2,5,4,2,2015,7,14409,1890,16299
2,5,4,2,2015,8,14886,1886,16772
2,5,4,2,2015,9,15358,1954,17312
2,5,4,2,2015,10,15533,2078,17611
2,5,4,2,2015,11,15679,2193,17872
2,5,4,2,2015,12,16135,2261,18396
2,5,4,2,2015,13,15320,2248,17568
2,5,4,2,2015,14,15323,2192,17515
2,5,4,2,2015,15,15170,2167,17337
2,5,4,2,2015,16,15165,2169,17334
2,5,4,2,2015,17,14602,2135,16737
2,5,4,2,2015,18,13102,2071,15173
2,5,4,2,2015,19,13016,2145,15161
2,5,4,2,2015,20,14226,2360,16586
2,5,4,2,2015,21,13827,2399,16226
2,5,4,2,2015,22,13283,2363,15646
2,5,4,2,2015,23,13675,2374,16049
2,5,4,2,2015,24,13711,2398,16109
1,6,4,2,2015,1,14127,2237,16364
1,6,4,2,2015,2,14049,2044,16093
1,6,4,2,2015,3,13512,1938,15450
1,6,4,2,2015,4,13410,1858,15268
1,6,4,2,2015,5,13630,1849,15479
1,6,4,2,2015,6,14038,1908,15946
1,6,4,2,2015,7,15140,2014,17154
1,6,4,2,2015,8,14929,2132,17061
1,6,4,2,2015,9,14896,2394,17290
1,6,4,2,2015,10,15795,2725,18520
1,6,4,2,2015,11,15919,2931,18850
1,6,4,2,2015,12,16157,3036,19193
1,6,4,2,2015,13,15578,3044,18622
1,6,4,2,2015,14,15515,2963,18478
1,6,4,2,2015,15,15542,2990,18532
1,6,4,2,2015,16,15797,3026,18823
1,6,4,2,2015,17,15100,3012,18112
1,6,4,2,2015,18,13465,2879,16344
1,6,4,2,2015,19,12849,2763,15612
1,6,4,2,2015,20,13929,2777,16706
1,6,4,2,2015,21,14103,2683,16786
1,6,4,2,2015,22,13670,2517,16187
1,6,4,2,2015,23,13518,2447,15965
1,6,4,2,2015,24,14214,2370,16584
1,7,4,2,2015,1,14269,2218,16487
1,7,4,2,2015,2,13903,2015,15918
1,7,4,2,2015,3,13979,1896,15875
1,7,4,2,2015,4,13601,1810,15411
1,7,4,2,2015,5,13647,1758,15405
1,7,4,2,2015,6,14144,1853,15997
1,7,4,2,2015,7,14755,1967,16722
1,7,4,2,2015,8,15315,2089,17404
1,7,4,2,2015,9,15453,2418,17871
1,7,4,2,2015,10,15972,2724,18696
1,7,4,2,2015,11,16050,2961,19011
1,7,4,2,2015,12,16284,3026,19310
1,7,4,2,2015,13,16016,3020,19036
1,7,4,2,2015,14,15873,2952,18825
1,7,4,2,2015,15,15701,3002,18703
1,7,4,2,2015,16,16150,3016,19166
1,7,4,2,2015,17,15571,3015,18586
1,7,4,2,2015,18,13935,2944,16879
1,7,4,2,2015,19,13087,2790,15877
1,7,4,2,2015,20,14320,2828,17148
1,7,4,2,2015,21,14455,2704,17159
1,7,4,2,2015,22,14162,2547,16709
1,7,4,2,2015,23,14013,2478,16491
1,7,4,2,2015,24,14396,2406,16802
1,8,4,2,2015,1,14849,2249,17098
1,8,4,2,2015,2,14730,2031,16761
1,8,4,2,2015,3,14587,1917,16504
1,8,4,2,2015,4,14253,1835,16088
1,8,4,2,2015,5,14399,1811,16210
1,8,4,2,2015,6,14724,1869,16593
1,8,4,2,2015,7,15679,1961,17640
1,8,4,2,2015,8,15538,2086,17624
1,8,4,2,2015,9,15741,2362,18103
1,8,4,2,2015,10,16159,2726,18885
1,8,4,2,2015,11,16371,2997,19368
1,8,4,2,2015,12,16036,3052,19088
1,8,4,2,2015,13,15990,3048,19038
1,8,4,2,2015,14,15967,2961,18928
1,8,4,2,2015,15,16019,3009,19028
1,8,4,2,2015,16,16218,3019,19237
1,8,4,2,2015,17,15805,3000,18805
1,8,4,2,2015,18,14158,2941,17099
1,8,4,2,2015,19,13700,2816,16516
1,8,4,2,2015,20,14794,2879,17673
1,8,4,2,2015,21,14397,2750,17147
1,8,4,2,2015,22,14054,2616,16670
1,8,4,2,2015,23,14317,2505,16822
1,8,4,2,2015,24,14782,2449,17231
1,9,4,2,2015,1,14983,2270,17253
1,9,4,2,2015,2,14544,2074,16618
1,9,4,2,2015,3,14515,1957,16472
1,9,4,2,2015,4,14295,1879,16174
1,9,4,2,2015,5,14323,1850,16173
1,9,4,2,2015,6,14523,1919,16442
1,9,4,2,2015,7,15293,1992,17285
1,9,4,2,2015,8,15419,2122,17541
1,9,4,2,2015,9,15585,2467,18052
1,9,4,2,2015,10,16019,2766,18785
1,9,4,2,2015,11,16319,3036,19355
1,9,4,2,2015,12,16380,3100,19480
1,9,4,2,2015,13,16795,3097,19892
1,9,4,2,2015,14,15802,2979,18781
1,9,4,2,2015,15,15987,3027,19014
1,9,4,2,2015,16,16534,3081,19615
1,9,4,2,2015,17,15568,3045,18613
1,9,4,2,2015,18,13545,2941,16486
1,9,4,2,2015,19,13051,2807,15858
1,9,4,2,2015,20,14641,2866,17507
1,9,4,2,2015,21,14309,2727,17036
1,9,4,2,2015,22,14003,2604,16607
1,9,4,2,2015,23,14127,2521,16648
1,9,4,2,2015,24,14252,2501,16753
1,10,4,2,2015,1,14198,2282,16480
1,10,4,2,2015,2,14222,2098,16320
1,10,4,2,2015,3,13827,1965,15792
1,10,4,2,2015,4,13593,1881,15474
1,10,4,2,2015,5,13538,1858,15396
1,10,4,2,2015,6,13843,1929,15772
1,10,4,2,2015,7,14695,2004,16699
1,10,4,2,2015,8,14585,2118,16703
1,10,4,2,2015,9,14794,2446,17240
1,10,4,2,2015,10,15085,2811,17896
1,10,4,2,2015,11,15317,3079,18396
1,10,4,2,2015,12,15310,3149,18459
1,10,4,2,2015,13,15496,3124,18620
1,10,4,2,2015,14,15093,2999,18092
1,10,4,2,2015,15,15406,3059,18465
1,10,4,2,2015,16,15214,3085,18299
1,10,4,2,2015,17,14470,3081,17551
1,10,4,2,2015,18,12699,2989,15688
1,10,4,2,2015,19,12833,2865,15698
1,10,4,2,2015,20,13587,2881,16468
1,10,4,2,2015,21,13422,2685,16107
1,10,4,2,2015,22,13369,2642,16011
1,10,4,2,2015,23,13279,2541,15820
1,10,4,2,2015,24,13603,2489,16092
2,11,4,2,2015,1,13707,2320,16027
2,11,4,2,2015,2,13202,2149,15351
2,11,4,2,2015,3,13264,2017,15281
2,11,4,2,2015,4,13464,1925,15389
2,11,4,2,2015,5,13276,1878,15154
2,11,4,2,2015,6,13774,1926,15700
2,11,4,2,2015,7,14259,1954,16213
2,11,4,2,2015,8,14287,2019,16306
2,11,4,2,2015,9,14534,2251,16785
2,11,4,2,2015,10,14531,2564,17095
2,11,4,2,2015,11,14959,2854,17813
2,11,4,2,2015,12,15279,2889,18168
2,11,4,2,2015,13,15223,2887,18110
2,11,4,2,2015,14,14561,2769,17330
2,11,4,2,2015,15,14221,2788,17009
2,11,4,2,2015,16,13396,2791,16187
2,11,4,2,2015,17,12787,2737,15524
2,11,4,2,2015,18,12416,2659,15075
2,11,4,2,2015,19,12080,2597,14677
2,11,4,2,2015,20,13107,2695,15802
2,11,4,2,2015,21,12905,2628,15533
2,11,4,2,2015,22,12384,2555,14939
2,11,4,2,2015,23,12811,2470,15281
2,11,4,2,2015,24,12771,2362,15133
2,12,4,2,2015,1,12495,2272,14767
2,12,4,2,2015,2,12516,2122,14638
2,12,4,2,2015,3,12136,1983,14119
2,12,4,2,2015,4,11917,1890,13807
2,12,4,2,2015,5,12039,1856,13895
2,12,4,2,2015,6,12447,1878,14325
2,12,4,2,2015,7,12874,1854,14728
2,12,4,2,2015,8,13242,1851,15093
2,12,4,2,2015,9,13344,1933,15277
2,12,4,2,2015,10,13997,2082,16079
2,12,4,2,2015,11,13821,2161,15982
2,12,4,2,2015,12,14167,2209,16376
2,12,4,2,2015,13,13839,2215,16054
2,12,4,2,2015,14,13441,2164,15605
2,12,4,2,2015,15,13451,2155,15606
2,12,4,2,2015,16,13405,2158,15563
2,12,4,2,2015,17,12440,2127,14567
2,12,4,2,2015,18,11536,2087,13623
2,12,4,2,2015,19,11554,2104,13658
2,12,4,2,2015,20,12936,2269,15205
2,12,4,2,2015,21,12738,2390,15128
2,12,4,2,2015,22,12139,2288,14427
2,12,4,2,2015,23,12414,2362,14776
2,12,4,2,2015,24,12308,2321,14629
1,13,4,2,2015,1,12530,2236,14766
1,13,4,2,2015,2,12284,2047,14331
1,13,4,2,2015,3,11877,1916,13793
1,13,4,2,2015,4,11855,1830,13685
1,13,4,2,2015,5,12088,1798,13886
1,13,4,2,2015,6,12608,1849,14457
1,13,4,2,2015,7,13141,1939,15080
1,13,4,2,2015,8,13736,2078,15814
1,13,4,2,2015,9,13826,2376,16202
1,13,4,2,2015,10,14118,2747,16865
1,13,4,2,2015,11,14275,3015,17290
1,13,4,2,2015,12,14393,3055,17448
1,13,4,2,2015,13,14244,3053,17297
1,13,4,2,2015,14,13534,2932,16466
1,13,4,2,2015,15,13752,2970,16722
1,13,4,2,2015,16,13740,3001,16741
1,13,4,2,2015,17,13036,2985,16021
1,13,4,2,2015,18,12293,2865,15158
1,13,4,2,2015,19,11915,2755,14670
1,13,4,2,2015,20,12835,2780,15615
1,13,4,2,2015,21,13018,2687,15705
1,13,4,2,2015,22,12438,2516,14954
1,13,4,2,2015,23,13012,2463,15475
3,13,4,2,2015,24,12208,2417,14625
3,14,4,2,2015,1,12451,2277,14728
3,14,4,2,2015,2,12029,2085,14114
3,14,4,2,2015,3,12079,1953,14032
3,14,4,2,2015,4,11940,1880,13820
3,14,4,2,2015,5,12091,1839,13930
3,14,4,2,2015,6,12372,1881,14253
3,14,4,2,2015,7,13235,1901,15136
3,14,4,2,2015,8,13457,1991,15448
3,14,4,2,2015,9,14333,2203,16536
3,14,4,2,2015,10,14133,2546,16679
3,14,4,2,2015,11,14133,2791,16924
3,14,4,2,2015,12,14199,2833,17032
3,14,4,2,2015,13,13805,2760,16565
3,14,4,2,2015,14,13678,2791,16469
3,14,4,2,2015,15,13778,2804,16582
3,14,4,2,2015,16,14068,2800,16868
3,14,4,2,2015,17,13470,2754,16224
3,14,4,2,2015,18,12236,2644,14880
3,14,4,2,2015,19,12201,2598,14799
3,14,4,2,2015,20,13507,2639,16146
3,14,4,2,2015,21,12933,2552,15485
3,14,4,2,2015,22,12951,2468,15419
3,14,4,2,2015,23,12743,2419,15162
1,14,4,2,2015,24,12984,2363,15347
1,15,4,2,2015,1,13066,2186,15252
1,15,4,2,2015,2,12717,1984,14701
1,15,4,2,2015,3,12191,1868,14059
1,15,4,2,2015,4,12419,1791,14210
1,15,4,2,2015,5,12592,1770,14362
1,15,4,2,2015,6,12763,1832,14595
1,15,4,2,2015,7,13616,1897,15513
1,15,4,2,2015,8,14099,2036,16135
1,15,4,2,2015,9,13997,2334,16331
1,15,4,2,2015,10,14739,2699,17438
1,15,4,2,2015,11,15149,2984,18133
1,15,4,2,2015,12,14186,3029,17215
1,15,4,2,2015,13,14650,3029,17679
1,15,4,2,2015,14,13719,2958,16677
1,15,4,2,2015,15,14001,3018,17019
1,15,4,2,2015,16,14071,3019,17090
1,15,4,2,2015,17,13574,3016,16590
1,15,4,2,2015,18,12547,2966,15513
1,15,4,2,2015,19,13377,2768,16145
1,15,4,2,2015,20,13683,2854,16537
1,15,4,2,2015,21,13567,2732,16299
1,15,4,2,2015,22,13205,2608,15813
1,15,4,2,2015,23,13134,2531,15665
1,15,4,2,2015,24,13196,2495,15691
1,16,4,2,2015,1,13189,2343,15532
1,16,4,2,2015,2,12750,2132,14882
1,16,4,2,2015,3,12620,1990,14610
1,16,4,2,2015,4,12622,1891,14513
1,16,4,2,2015,5,12729,1865,14594
1,16,4,2,2015,6,13091,1915,15006
1,16,4,2,2015,7,13599,1986,15585
1,16,4,2,2015,8,14115,2106,16221
1,16,4,2,2015,9,14263,2380,16643
1,16,4,2,2015,10,14914,2792,17706
1,16,4,2,2015,11,14695,3069,17764
1,16,4,2,2015,12,14596,3121,17717
1,16,4,2,2015,13,14617,3125,17742
1,16,4,2,2015,14,14406,3054,17460
1,16,4,2,2015,15,14245,3105,17350
1,16,4,2,2015,16,14422,3119,17541
1,16,4,2,2015,17,14011,3088,17099
1,16,4,2,2015,18,12703,3013,15716
1,16,4,2,2015,19,12556,2843,15399
1,16,4,2,2015,20,13761,2853,16614
1,16,4,2,2015,21,13634,2772,16406
1,16,4,2,2015,22,13109,2667,15776
1,16,4,2,2015,23,13353,2604,15957
1,16,4,2,2015,24,13318,2594,15912
1,17,4,2,2015,1,13363,2426,15789
1,17,4,2,2015,2,13163,2201,15364
1,17,4,2,2015,3,13017,2063,15080
1,17,4,2,2015,4,12819,1968,14787
1,17,4,2,2015,5,12819,1934,14753
1,17,4,2,2015,6,13332,1980,15312
1,17,4,2,2015,7,14038,2032,16070
1,17,4,2,2015,8,14677,2158,16835
1,17,4,2,2015,9,14308,2470,16778
1,17,4,2,2015,10,14862,2860,17722
1,17,4,2,2015,11,15217,3135,18352
1,17,4,2,2015,12,15148,3231,18379
1,17,4,2,2015,13,14245,3255,17500
1,17,4,2,2015,14,13788,3130,16918
1,17,4,2,2015,15,13813,3170,16983
1,17,4,2,2015,16,14084,3201,17285
1,17,4,2,2015,17,13571,3148,16719
1,17,4,2,2015,18,12624,3017,15641
1,17,4,2,2015,19,12561,2897,15458
1,17,4,2,2015,20,13901,2926,16827
1,17,4,2,2015,21,14158,2792,16950
1,17,4,2,2015,22,13644,2688,16332
1,17,4,2,2015,23,13893,2648,16541
1,17,4,2,2015,24,14072,2634,16706
2,18,4,2,2015,1,13856,2517,16373
2,18,4,2,2015,2,13516,2290,15806
2,18,4,2,2015,3,13715,2136,15851
2,18,4,2,2015,4,13028,2027,15055
2,18,4,2,2015,5,13359,1970,15329
2,18,4,2,2015,6,13809,2005,15814
2,18,4,2,2015,7,14203,2003,16206
2,18,4,2,2015,8,14083,2061,16144
2,18,4,2,2015,9,14646,2274,16920
2,18,4,2,2015,10,14676,2653,17329
2,18,4,2,2015,11,15119,2918,18037
2,18,4,2,2015,12,14873,3061,17934
2,18,4,2,2015,13,14713,3085,17798
2,18,4,2,2015,14,14404,2983,17387
2,18,4,2,2015,15,14746,3033,17779
2,18,4,2,2015,16,14775,3036,17811
2,18,4,2,2015,17,14461,2979,17440
2,18,4,2,2015,18,13456,2849,16305
2,18,4,2,2015,19,12967,2754,15721
2,18,4,2,2015,20,14494,2846,17340
2,18,4,2,2015,21,14305,2846,17151
2,18,4,2,2015,22,14119,2597,16716
2,18,4,2,2015,23,14108,2617,16725
2,18,4,2,2015,24,14282,2591,16873
2,19,4,2,2015,1,14360,2508,16868
2,19,4,2,2015,2,14053,2322,16375
2,19,4,2,2015,3,14017,2165,16182
2,19,4,2,2015,4,14061,2060,16121
2,19,4,2,2015,5,14004,2015,16019
2,19,4,2,2015,6,14229,2019,16248
2,19,4,2,2015,7,14570,1979,16549
2,19,4,2,2015,8,14458,1952,16410
2,19,4,2,2015,9,15067,1998,17065
2,19,4,2,2015,10,15441,2134,17575
2,19,4,2,2015,11,15699,2240,17939
2,19,4,2,2015,12,15877,2324,18201
2,19,4,2,2015,13,15471,2364,17835
2,19,4,2,2015,14,14934,2364,17298
2,19,4,2,2015,15,15268,2395,17663
2,19,4,2,2015,16,15575,2407,17982
2,19,4,2,2015,17,14842,2381,17223
2,19,4,2,2015,18,13410,2288,15698
2,19,4,2,2015,19,12632,2238,14870
2,19,4,2,2015,20,13853,2441,16294
2,19,4,2,2015,21,13967,2483,16450
2,19,4,2,2015,22,13917,2510,16427
2,19,4,2,2015,23,14171,2539,16710
2,19,4,2,2015,24,14405,2585,16990
1,20,4,2,2015,1,14723,2528,17251
1,20,4,2,2015,2,14416,2312,16728
1,20,4,2,2015,3,14154,2151,16305
1,20,4,2,2015,4,13804,2046,15850
1,20,4,2,2015,5,13545,1992,15537
1,20,4,2,2015,6,14194,2072,16266
1,20,4,2,2015,7,15034,2080,17114
1,20,4,2,2015,8,15018,2202,17220
1,20,4,2,2015,9,15413,2541,17954
1,20,4,2,2015,10,16070,2953,19023
1,20,4,2,2015,11,16431,3222,19653
1,20,4,2,2015,12,16503,3328,19831
1,20,4,2,2015,13,16064,3343,19407
1,20,4,2,2015,14,16115,3272,19387
1,20,4,2,2015,15,16124,3330,19454
1,20,4,2,2015,16,16447,3339,19786
1,20,4,2,2015,17,16152,3326,19478
1,20,4,2,2015,18,14193,3240,17433
1,20,4,2,2015,19,13805,3009,16814
1,20,4,2,2015,20,15146,3063,18209
1,20,4,2,2015,21,14859,3014,17873
1,20,4,2,2015,22,14610,2908,17518
1,20,4,2,2015,23,15336,2876,18212
1,20,4,2,2015,24,15087,2832,17919
1,21,4,2,2015,1,15196,2674,17870
1,21,4,2,2015,2,14909,2437,17346
1,21,4,2,2015,3,14874,2272,17146
1,21,4,2,2015,4,14562,2165,16727
1,21,4,2,2015,5,14648,2116,16764
1,21,4,2,2015,6,15055,2153,17208
1,21,4,2,2015,7,15560,2169,17729
1,21,4,2,2015,8,15863,2246,18109
1,21,4,2,2015,9,15906,2588,18494
1,21,4,2,2015,10,16339,3032,19371
1,21,4,2,2015,11,16518,3311,19829
1,21,4,2,2015,12,16623,3391,20014
1,21,4,2,2015,13,16508,3402,19910
1,21,4,2,2015,14,16062,3350,19412
1,21,4,2,2015,15,16240,3401,19641
1,21,4,2,2015,16,16297,3400,19697
1,21,4,2,2015,17,15844,3378,19222
1,21,4,2,2015,18,13313,3255,16568
1,21,4,2,2015,19,13698,3093,16791
1,21,4,2,2015,20,14617,3113,17730
1,21,4,2,2015,21,14409,3006,17415
1,21,4,2,2015,22,14480,2904,17384
1,21,4,2,2015,23,14744,2883,17627
1,21,4,2,2015,24,15314,2871,18185
1,22,4,2,2015,1,14901,2728,17629
1,22,4,2,2015,2,15055,2492,17547
1,22,4,2,2015,3,14713,2311,17024
1,22,4,2,2015,4,14832,2194,17026
1,22,4,2,2015,5,14586,2145,16731
1,22,4,2,2015,6,15164,2168,17332
1,22,4,2,2015,7,15359,2178,17537
1,22,4,2,2015,8,15329,2274,17603
1,22,4,2,2015,9,15443,2626,18069
1,22,4,2,2015,10,15929,2939,18868
1,22,4,2,2015,11,16453,3295,19748
1,22,4,2,2015,12,16264,3385,19649
1,22,4,2,2015,13,16364,3409,19773
1,22,4,2,2015,14,15902,3362,19264
1,22,4,2,2015,15,16372,3359,19731
1,22,4,2,2015,16,16795,3409,20204
1,22,4,2,2015,17,15559,3403,18962
1,22,4,2,2015,18,14169,3338,17507
1,22,4,2,2015,19,13974,3135,17109
1,22,4,2,2015,20,14981,3129,18110
1,22,4,2,2015,21,14983,2972,17955
1,22,4,2,2015,22,14733,2889,17622
1,22,4,2,2015,23,14261,2914,17175
1,22,4,2,2015,24,14614,2856,17470
1,23,4,2,2015,1,15004,2726,17730
1,23,4,2,2015,2,14719,2483,17202
1,23,4,2,2015,3,14622,2316,16938
1,23,4,2,2015,4,14329,2204,16533
1,23,4,2,2015,5,14445,2155,16600
1,23,4,2,2015,6,14660,2182,16842
1,23,4,2,2015,7,15336,2191,17527
1,23,4,2,2015,8,14977,2271,17248
1,23,4,2,2015,9,15479,2567,18046
1,23,4,2,2015,10,16102,2966,19068
1,23,4,2,2015,11,16380,3252,19632
1,23,4,2,2015,12,16063,3331,19394
1,23,4,2,2015,13,16260,3349,19609
1,23,4,2,2015,14,15823,3276,19099
1,23,4,2,2015,15,15593,3335,18928
1,23,4,2,2015,16,16392,3337,19729
1,23,4,2,2015,17,15510,3346,18856
1,23,4,2,2015,18,14072,3277,17349
1,23,4,2,2015,19,13296,3035,16331
1,23,4,2,2015,20,14860,3052,17912
1,23,4,2,2015,21,14887,2977,17864
1,23,4,2,2015,22,14701,3157,17858
1,23,4,2,2015,23,14459,2820,17279
1,23,4,2,2015,24,14992,2773,17765
1,24,4,2,2015,1,15322,2646,17968
1,24,4,2,2015,2,15004,2397,17401
1,24,4,2,2015,3,14822,2258,17080
1,24,4,2,2015,4,14700,2154,16854
1,24,4,2,2015,5,14602,2092,16694
1,24,4,2,2015,6,14748,2104,16852
1,24,4,2,2015,7,15142,2118,17260
1,24,4,2,2015,8,15167,2217,17384
1,24,4,2,2015,9,15634,2488,18122
1,24,4,2,2015,10,15254,2914,18168
1,24,4,2,2015,11,15682,3168,18850
1,24,4,2,2015,12,15462,3263,18725
1,24,4,2,2015,13,15413,3263,18676
1,24,4,2,2015,14,14905,3156,18061
1,24,4,2,2015,15,14852,3222,18074
1,24,4,2,2015,16,15358,3263,18621
1,24,4,2,2015,17,14508,3221,17729
1,24,4,2,2015,18,13500,3109,16609
1,24,4,2,2015,19,12951,2928,15879
1,24,4,2,2015,20,14367,2973,17340
1,24,4,2,2015,21,14522,2819,17341
1,24,4,2,2015,22,14234,2716,16950
1,24,4,2,2015,23,14681,2660,17341
1,24,4,2,2015,24,14917,2664,17581
2,25,4,2,2015,1,15167,2567,17734
2,25,4,2,2015,2,14722,2354,17076
2,25,4,2,2015,3,14788,2212,17000
2,25,4,2,2015,4,14492,2100,16592
2,25,4,2,2015,5,14298,2039,16337
2,25,4,2,2015,6,14925,2061,16986
2,25,4,2,2015,7,15231,2065,17296
2,25,4,2,2015,8,15084,2136,17220
2,25,4,2,2015,9,15414,2272,17686
2,25,4,2,2015,10,15401,2583,17984
2,25,4,2,2015,11,16454,2885,19339
2,25,4,2,2015,12,15918,2948,18866
2,25,4,2,2015,13,16180,2944,19124
2,25,4,2,2015,14,15260,2863,18123
2,25,4,2,2015,15,15642,2910,18552
2,25,4,2,2015,16,15919,2917,18836
2,25,4,2,2015,17,15418,2860,18278
2,25,4,2,2015,18,14177,2784,16961
2,25,4,2,2015,19,13805,2689,16494
2,25,4,2,2015,20,15052,2775,17827
2,25,4,2,2015,21,14801,2711,17512
2,25,4,2,2015,22,14448,2605,17053
2,25,4,2,2015,23,14200,2584,16784
2,25,4,2,2015,24,14838,2575,17413
2,26,4,2,2015,1,15246,2477,17723
2,26,4,2,2015,2,14812,2306,17118
2,26,4,2,2015,3,14556,2179,16735
2,26,4,2,2015,4,14502,2067,16569
2,26,4,2,2015,5,14663,2036,16699
2,26,4,2,2015,6,14730,2025,16755
2,26,4,2,2015,7,15208,1963,17171
2,26,4,2,2015,8,14912,1931,16843
2,26,4,2,2015,9,15097,1988,17085
2,26,4,2,2015,10,15269,2090,17359
2,26,4,2,2015,11,15824,2228,18052
2,26,4,2,2015,12,15458,2289,17747
2,26,4,2,2015,13,15494,2283,17777
2,26,4,2,2015,14,15124,2255,17379
2,26,4,2,2015,15,16020,2282,18302
2,26,4,2,2015,16,15847,2289,18136
2,26,4,2,2015,17,15094,2248,17342
2,26,4,2,2015,18,13229,2201,15430
2,26,4,2,2015,19,12625,2188,14813
2,26,4,2,2015,20,13923,2382,16305
2,26,4,2,2015,21,14142,2457,16599
2,26,4,2,2015,22,13926,2490,16416
2,26,4,2,2015,23,14467,2326,16793
2,26,4,2,2015,24,14485,2534,17019
1,27,4,2,2015,1,14974,2419,17393
1,27,4,2,2015,2,14830,2232,17062
1,27,4,2,2015,3,14313,2092,16405
1,27,4,2,2015,4,14057,1998,16055
1,27,4,2,2015,5,14050,1943,15993
1,27,4,2,2015,6,14612,1984,16596
1,27,4,2,2015,7,15096,1994,17090
1,27,4,2,2015,8,15224,2122,17346
1,27,4,2,2015,9,15196,2493,17689
1,27,4,2,2015,10,16074,2818,18892
1,27,4,2,2015,11,16750,3136,19886
1,27,4,2,2015,12,16318,3214,19532
1,27,4,2,2015,13,16291,3226,19517
1,27,4,2,2015,14,15881,3158,19039
1,27,4,2,2015,15,16162,3202,19364
1,27,4,2,2015,16,16361,3208,19569
1,27,4,2,2015,17,15624,3199,18823
1,27,4,2,2015,18,13879,3105,16984
1,27,4,2,2015,19,13257,2989,16246
1,27,4,2,2015,20,14886,3013,17899
1,27,4,2,2015,21,14711,2916,17627
1,27,4,2,2015,22,14284,2784,17068
1,27,4,2,2015,23,14613,2768,17381
1,27,4,2,2015,24,15205,2716,17921
1,28,4,2,2015,1,15301,2572,17873
1,28,4,2,2015,2,14779,2344,17123
1,28,4,2,2015,3,14689,2192,16881
1,28,4,2,2015,4,14602,2088,16690
1,28,4,2,2015,5,14436,2033,16469
1,28,4,2,2015,6,14987,2076,17063
1,28,4,2,2015,7,15059,2074,17133
1,28,4,2,2015,8,14743,2180,16923
1,28,4,2,2015,9,15249,2469,17718
1,28,4,2,2015,10,15863,2877,18740
1,28,4,2,2015,11,16380,3166,19546
1,28,4,2,2015,12,16033,3250,19283
1,28,4,2,2015,13,16011,3247,19258
1,28,4,2,2015,14,15637,3159,18796
1,28,4,2,2015,15,15818,3250,19068
1,28,4,2,2015,16,16074,3255,19329
1,28,4,2,2015,17,15615,3252,18867
1,28,4,2,2015,18,13893,3113,17006
1,28,4,2,2015,19,14048,2931,16979
1,28,4,2,2015,20,14866,2959,17825
1,28,4,2,2015,21,14871,2878,17749
1,28,4,2,2015,22,14552,2787,17339
1,28,4,2,2015,23,14730,2745,17475
1,28,4,2,2015,24,15078,2736,17814
1,29,4,2,2015,1,15640,2591,18231
1,29,4,2,2015,2,15306,2385,17691
1,29,4,2,2015,3,14996,2209,17205
1,29,4,2,2015,4,14643,2105,16748
1,29,4,2,2015,5,14620,2044,16664
1,29,4,2,2015,6,14736,2068,16804
1,29,4,2,2015,7,15176,2061,17237
1,29,4,2,2015,8,15222,2177,17399
1,29,4,2,2015,9,15722,2541,18263
1,29,4,2,2015,10,16213,2844,19057
1,29,4,2,2015,11,16670,3167,19837
1,29,4,2,2015,12,16521,3269,19790
1,29,4,2,2015,13,16462,3265,19727
1,29,4,2,2015,14,15642,3178,18820
1,29,4,2,2015,15,16049,3248,19297
1,29,4,2,2015,16,16003,3276,19279
1,29,4,2,2015,17,15992,3255,19247
1,29,4,2,2015,18,14567,3127,17694
1,29,4,2,2015,19,13510,2924,16434
1,29,4,2,2015,20,14261,2954,17215
1,29,4,2,2015,21,15168,2817,17985
1,29,4,2,2015,22,14629,2812,17441
1,29,4,2,2015,23,15000,2702,17702
1,29,4,2,2015,24,15436,2671,18107
1,30,4,2,2015,1,16096,2561,18657
1,30,4,2,2015,2,15244,2319,17563
1,30,4,2,2015,3,15172,2183,17355
1,30,4,2,2015,4,15129,2078,17207
1,30,4,2,2015,5,14610,2007,16617
1,30,4,2,2015,6,14576,2055,16631
1,30,4,2,2015,7,15234,2043,17277
1,30,4,2,2015,8,14910,2141,17051
1,30,4,2,2015,9,15402,2507,17909
1,30,4,2,2015,10,15738,2807,18545
1,30,4,2,2015,11,16417,3136,19553
1,30,4,2,2015,12,16329,3188,19517
1,30,4,2,2015,13,16128,3204,19332
1,30,4,2,2015,14,15747,3154,18901
1,30,4,2,2015,15,15967,3200,19167
1,30,4,2,2015,16,15952,3213,19165
1,30,4,2,2015,17,15749,3210,18959
1,30,4,2,2015,18,14140,3084,17224
1,30,4,2,2015,19,13820,2941,16761
1,30,4,2,2015,20,14984,2971,17955
1,30,4,2,2015,21,14910,2885,17795
1,30,4,2,2015,22,14189,2772,16961
1,30,4,2,2015,23,14816,2710,17526
1,30,4,2,2015,24,14670,2692,17362
3,1,5,2,2015,1,15028,2544,17572
3,1,5,2,2015,2,15301,2307,17608
3,1,5,2,2015,3,14853,2179,17032
3,1,5,2,2015,4,14344,2072,16416
3,1,5,2,2015,5,14371,2007,16378
3,1,5,2,2015,6,14338,2020,16358
3,1,5,2,2015,7,14689,1972,16661
3,1,5,2,2015,8,14105,1955,16060
3,1,5,2,2015,9,13454,2021,15475
3,1,5,2,2015,10,13884,2151,16035
3,1,5,2,2015,11,14262,2289,16551
3,1,5,2,2015,12,13942,2379,16321
3,1,5,2,2015,13,13936,2417,16353
3,1,5,2,2015,14,13103,2370,15473
3,1,5,2,2015,15,13652,2405,16057
3,1,5,2,2015,16,13700,2453,16153
3,1,5,2,2015,17,13150,2412,15562
3,1,5,2,2015,18,11633,2328,13961
3,1,5,2,2015,19,11573,2296,13869
3,1,5,2,2015,20,12814,2445,15259
3,1,5,2,2015,21,12912,2496,15408
3,1,5,2,2015,22,13248,2477,15725
3,1,5,2,2015,23,13156,2481,15637
3,1,5,2,2015,24,13894,2511,16405
2,2,5,2,2015,1,14586,2419,17005
2,2,5,2,2015,2,14004,2224,16228
2,2,5,2,2015,3,13853,2091,15944
2,2,5,2,2015,4,13708,1982,15690
2,2,5,2,2015,5,13692,1945,15637
2,2,5,2,2015,6,13753,1942,15695
2,2,5,2,2015,7,14185,1920,16105
2,2,5,2,2015,8,14509,1971,16480
2,2,5,2,2015,9,14905,2206,17111
2,2,5,2,2015,10,15411,2599,18010
2,2,5,2,2015,11,15946,2821,18767
2,2,5,2,2015,12,15967,2969,18936
2,2,5,2,2015,13,15743,2995,18738
2,2,5,2,2015,14,15686,2935,18621
2,2,5,2,2015,15,15501,2962,18463
2,2,5,2,2015,16,15958,2987,18945
2,2,5,2,2015,17,15466,2944,18410
2,2,5,2,2015,18,13940,2799,16739
2,2,5,2,2015,19,12932,2719,15651
2,2,5,2,2015,20,14691,2791,17482
2,2,5,2,2015,21,14399,2696,17095
2,2,5,2,2015,22,14677,2653,17330
2,2,5,2,2015,23,14935,2566,17501
2,2,5,2,2015,24,15752,2631,18383
2,3,5,2,2015,1,15636,2513,18149
2,3,5,2,2015,2,15151,2332,17483
2,3,5,2,2015,3,15057,2189,17246
2,3,5,2,2015,4,14346,2087,16433
2,3,5,2,2015,5,14542,2018,16560
2,3,5,2,2015,6,14610,2025,16635
2,3,5,2,2015,7,15193,1946,17139
2,3,5,2,2015,8,15336,1918,17254
2,3,5,2,2015,9,15060,1994,17054
2,3,5,2,2015,10,15389,2104,17493
2,3,5,2,2015,11,16295,2233,18528
2,3,5,2,2015,12,16247,2311,18558
2,3,5,2,2015,13,15989,2328,18317
2,3,5,2,2015,14,15977,2309,18286
2,3,5,2,2015,15,15764,2355,18119
2,3,5,2,2015,16,16262,2374,18636
2,3,5,2,2015,17,15577,2334,17911
2,3,5,2,2015,18,13532,2264,15796
2,3,5,2,2015,19,13902,2213,16115
2,3,5,2,2015,20,14614,2390,17004
2,3,5,2,2015,21,14949,2392,17341
2,3,5,2,2015,22,14448,2450,16898
2,3,5,2,2015,23,14301,2504,16805
2,3,5,2,2015,24,15091,2523,17614
3,4,5,2,2015,1,15482,2491,17973
3,4,5,2,2015,2,15106,2294,17400
3,4,5,2,2015,3,14318,2150,16468
3,4,5,2,2015,4,14374,2042,16416
3,4,5,2,2015,5,14183,1990,16173
3,4,5,2,2015,6,14711,2007,16718
3,4,5,2,2015,7,14877,1995,16872
3,4,5,2,2015,8,15011,2082,17093
3,4,5,2,2015,9,14970,2342,17312
3,4,5,2,2015,10,16271,2767,19038
3,4,5,2,2015,11,16414,2942,19356
3,4,5,2,2015,12,16055,3055,19110
3,4,5,2,2015,13,15949,3087,19036
3,4,5,2,2015,14,15665,3027,18692
3,4,5,2,2015,15,16074,3102,19176
3,4,5,2,2015,16,16562,3114,19676
3,4,5,2,2015,17,15608,3093,18701
3,4,5,2,2015,18,13557,3024,16581
3,4,5,2,2015,19,13149,2871,16020
3,4,5,2,2015,20,13829,2904,16733
3,4,5,2,2015,21,12708,2819,15527
3,4,5,2,2015,22,12801,2732,15533
3,4,5,2,2015,23,13979,2756,16735
3,4,5,2,2015,24,14684,2770,17454
1,5,5,2,2015,1,14271,2631,16902
1,5,5,2,2015,2,14625,2432,17057
1,5,5,2,2015,3,14429,2257,16686
1,5,5,2,2015,4,14183,2149,16332
1,5,5,2,2015,5,13846,2085,15931
1,5,5,2,2015,6,14214,2112,16326
1,5,5,2,2015,7,14811,2095,16906
1,5,5,2,2015,8,15127,2209,17336
1,5,5,2,2015,9,15116,2548,17664
1,5,5,2,2015,10,15320,2916,18236
1,5,5,2,2015,11,14209,3255,17464
1,5,5,2,2015,12,13632,3339,16971
1,5,5,2,2015,13,15229,3342,18571
1,5,5,2,2015,14,15287,3285,18572
1,5,5,2,2015,15,15443,3345,18788
1,5,5,2,2015,16,16042,3350,19392
1,5,5,2,2015,17,15370,3339,18709
1,5,5,2,2015,18,13929,3159,17088
1,5,5,2,2015,19,13295,3013,16308
1,5,5,2,2015,20,13892,3012,16904
1,5,5,2,2015,21,13144,2813,15957
1,5,5,2,2015,22,13402,2667,16069
1,5,5,2,2015,23,13614,2647,16261
1,5,5,2,2015,24,13962,2686,16648
1,6,5,2,2015,1,14148,2578,16726
1,6,5,2,2015,2,13919,2410,16329
1,6,5,2,2015,3,13705,2275,15980
1,6,5,2,2015,4,13654,2195,15849
1,6,5,2,2015,5,13252,2130,15382
1,6,5,2,2015,6,13954,2160,16114
1,6,5,2,2015,7,14206,2089,16295
1,6,5,2,2015,8,14107,2188,16295
1,6,5,2,2015,9,14608,2441,17049
1,6,5,2,2015,10,14740,2899,17639
1,6,5,2,2015,11,15790,3175,18965
1,6,5,2,2015,12,15834,3274,19108
1,6,5,2,2015,13,15751,3319,19070
1,6,5,2,2015,14,15410,3247,18657
1,6,5,2,2015,15,15855,3324,19179
1,6,5,2,2015,16,15961,3324,19285
1,6,5,2,2015,17,15544,3284,18828
1,6,5,2,2015,18,13774,3194,16968
1,6,5,2,2015,19,13691,2970,16661
1,6,5,2,2015,20,14645,2992,17637
1,6,5,2,2015,21,14759,2880,17639
1,6,5,2,2015,22,14583,2746,17329
1,6,5,2,2015,23,14692,2786,17478
1,6,5,2,2015,24,15619,2756,18375
1,7,5,2,2015,1,15490,2686,18176
1,7,5,2,2015,2,14916,2433,17349
1,7,5,2,2015,3,14610,2278,16888
1,7,5,2,2015,4,14715,2169,16884
1,7,5,2,2015,5,14572,2121,16693
1,7,5,2,2015,6,15199,2125,17324
1,7,5,2,2015,7,14983,2103,17086
1,7,5,2,2015,8,14874,2197,17071
1,7,5,2,2015,9,15067,2515,17582
1,7,5,2,2015,10,15742,2881,18623
1,7,5,2,2015,11,16643,3205,19848
1,7,5,2,2015,12,15845,3255,19100
1,7,5,2,2015,13,16323,3319,19642
1,7,5,2,2015,14,15879,3298,19177
1,7,5,2,2015,15,16031,3314,19345
1,7,5,2,2015,16,16210,3317,19527
1,7,5,2,2015,17,15520,3272,18792
1,7,5,2,2015,18,14070,3140,17210
1,7,5,2,2015,19,13861,2970,16831
1,7,5,2,2015,20,14790,2968,17758
1,7,5,2,2015,21,14803,2829,17632
1,7,5,2,2015,22,14698,2712,17410
1,7,5,2,2015,23,14949,2760,17709
1,7,5,2,2015,24,15330,2719,18049
1,8,5,2,2015,1,15491,2659,18150
1,8,5,2,2015,2,15110,2382,17492
1,8,5,2,2015,3,14848,2301,17149
1,8,5,2,2015,4,14900,2201,17101
1,8,5,2,2015,5,14619,2127,16746
1,8,5,2,2015,6,14936,2137,17073
1,8,5,2,2015,7,14986,2115,17101
1,8,5,2,2015,8,15033,2212,17245
1,8,5,2,2015,9,14861,2473,17334
1,8,5,2,2015,10,15082,2906,17988
1,8,5,2,2015,11,15148,3219,18367
1,8,5,2,2015,12,15777,3299,19076
1,8,5,2,2015,13,14898,3282,18180
1,8,5,2,2015,14,14980,3207,18187
1,8,5,2,2015,15,14966,3307,18273
1,8,5,2,2015,16,15251,3211,18462
1,8,5,2,2015,17,14908,3290,18198
1,8,5,2,2015,18,13592,3204,16796
1,8,5,2,2015,19,13504,3029,16533
1,8,5,2,2015,20,14357,2986,17343
1,8,5,2,2015,21,14525,2927,17452
1,8,5,2,2015,22,14699,2809,17508
1,8,5,2,2015,23,14642,2805,17447
1,8,5,2,2015,24,14782,2850,17632
2,9,5,2,2015,1,15077,2642,17719
2,9,5,2,2015,2,14861,2451,17312
2,9,5,2,2015,3,14736,2284,17020
2,9,5,2,2015,4,14724,2168,16892
2,9,5,2,2015,5,14658,2097,16755
2,9,5,2,2015,6,14907,2111,17018
2,9,5,2,2015,7,15035,2056,17091
2,9,5,2,2015,8,14754,2094,16848
2,9,5,2,2015,9,15406,2282,17688
2,9,5,2,2015,10,15690,2640,18330
2,9,5,2,2015,11,16054,2893,18947
2,9,5,2,2015,12,16037,3043,19080
2,9,5,2,2015,13,15831,3100,18931
2,9,5,2,2015,14,15845,3064,18909
2,9,5,2,2015,15,16237,3100,19337
2,9,5,2,2015,16,16239,3106,19345
2,9,5,2,2015,17,15553,2999,18552
2,9,5,2,2015,18,13973,2857,16830
2,9,5,2,2015,19,13447,2725,16172
2,9,5,2,2015,20,14181,2792,16973
2,9,5,2,2015,21,14267,2764,17031
2,9,5,2,2015,22,13859,2692,16551
2,9,5,2,2015,23,13803,2677,16480
2,9,5,2,2015,24,14000,2640,16640
2,10,5,2,2015,1,13914,2590,16504
2,10,5,2,2015,2,13614,2415,16029
2,10,5,2,2015,3,13764,2272,16036
2,10,5,2,2015,4,13460,2172,15632
2,10,5,2,2015,5,13614,2133,15747
2,10,5,2,2015,6,13503,2105,15608
2,10,5,2,2015,7,13776,2035,15811
2,10,5,2,2015,8,14011,2004,16015
2,10,5,2,2015,9,13903,2059,15962
2,10,5,2,2015,10,14275,2154,16429
2,10,5,2,2015,11,14787,2275,17062
2,10,5,2,2015,12,15142,2349,17491
2,10,5,2,2015,13,14645,2391,17036
2,10,5,2,2015,14,15293,2373,17666
2,10,5,2,2015,15,15166,2375,17541
2,10,5,2,2015,16,15635,2363,17998
2,10,5,2,2015,17,14998,2318,17316
2,10,5,2,2015,18,13527,2254,15781
2,10,5,2,2015,19,13257,2218,15475
2,10,5,2,2015,20,14179,2367,16546
2,10,5,2,2015,21,14571,2451,17022
2,10,5,2,2015,22,14124,2419,16543
2,10,5,2,2015,23,14773,2465,17238
2,10,5,2,2015,24,15207,2564,17771
1,11,5,2,2015,1,15189,2556,17745
1,11,5,2,2015,2,15113,2374,17487
1,11,5,2,2015,3,14813,2234,17047
1,11,5,2,2015,4,14595,2133,16728
1,11,5,2,2015,5,13985,2094,16079
1,11,5,2,2015,6,14393,2113,16506
1,11,5,2,2015,7,14689,2091,16780
1,11,5,2,2015,8,14941,2228,17169
1,11,5,2,2015,9,14819,2504,17323
1,11,5,2,2015,10,15678,2872,18550
1,11,5,2,2015,11,16524,3188,19712
1,11,5,2,2015,12,16661,3294,19955
1,11,5,2,2015,13,16269,3356,19625
1,11,5,2,2015,14,16119,3311,19430
1,11,5,2,2015,15,16530,3321,19851
1,11,5,2,2015,16,17039,3328,20367
1,11,5,2,2015,17,16310,3287,19597
1,11,5,2,2015,18,14684,3163,17847
1,11,5,2,2015,19,13226,2939,16165
1,11,5,2,2015,20,14688,2929,17617
1,11,5,2,2015,21,14420,2863,17283
1,11,5,2,2015,22,14417,2738,17155
1,11,5,2,2015,23,14204,2750,16954
1,11,5,2,2015,24,14561,2767,17328
1,12,5,2,2015,1,14901,2647,17548
1,12,5,2,2015,2,14338,2428,16766
1,12,5,2,2015,3,14087,2252,16339
1,12,5,2,2015,4,13696,2159,15855
1,12,5,2,2015,5,13671,2126,15797
1,12,5,2,2015,6,14012,2133,16145
1,12,5,2,2015,7,14582,2101,16683
1,12,5,2,2015,8,14666,2199,16865
1,12,5,2,2015,9,14845,2520,17365
1,12,5,2,2015,10,15475,2852,18327
1,12,5,2,2015,11,15908,3161,19069
1,12,5,2,2015,12,15682,3243,18925
1,12,5,2,2015,13,15565,3284,18849
1,12,5,2,2015,14,15639,3240,18879
1,12,5,2,2015,15,15968,3281,19249
1,12,5,2,2015,16,16764,3288,20052
1,12,5,2,2015,17,15769,3266,19035
1,12,5,2,2015,18,14552,3152,17704
1,12,5,2,2015,19,13727,2970,16697
1,12,5,2,2015,20,14785,2985,17770
1,12,5,2,2015,21,15076,2827,17903
1,12,5,2,2015,22,14865,2760,17625
1,12,5,2,2015,23,14708,2745,17453
1,12,5,2,2015,24,15005,2729,17734
1,13,5,2,2015,1,15406,2670,18076
1,13,5,2,2015,2,14947,2455,17402
1,13,5,2,2015,3,14680,2296,16976
1,13,5,2,2015,4,14426,2191,16617
1,13,5,2,2015,5,14289,2133,16422
1,13,5,2,2015,6,14599,2155,16754
1,13,5,2,2015,7,14560,2124,16684
1,13,5,2,2015,8,15524,2204,17728
1,13,5,2,2015,9,15003,2488,17491
1,13,5,2,2015,10,15492,2855,18347
1,13,5,2,2015,11,16132,3109,19241
1,13,5,2,2015,12,16676,3234,19910
1,13,5,2,2015,13,16293,3251,19544
1,13,5,2,2015,14,16114,3192,19306
1,13,5,2,2015,15,16705,3250,19955
1,13,5,2,2015,16,15743,3259,19002
1,13,5,2,2015,17,15018,3250,18268
1,13,5,2,2015,18,13653,3127,16780
1,13,5,2,2015,19,13314,2955,16269
1,13,5,2,2015,20,13437,2957,16394
1,13,5,2,2015,21,13573,2843,16416
1,13,5,2,2015,22,13409,2763,16172
1,13,5,2,2015,23,13762,2727,16489
1,13,5,2,2015,24,13400,2773,16173
1,14,5,2,2015,1,13792,2686,16478
1,14,5,2,2015,2,13127,2460,15587
1,14,5,2,2015,3,13067,2320,15387
1,14,5,2,2015,4,12820,2205,15025
1,14,5,2,2015,5,12554,2141,14695
1,14,5,2,2015,6,12876,2134,15010
1,14,5,2,2015,7,13181,2094,15275
1,14,5,2,2015,8,13259,2197,15456
1,14,5,2,2015,9,13742,2512,16254
1,14,5,2,2015,10,13863,2962,16825
1,14,5,2,2015,11,14599,3162,17761
1,14,5,2,2015,12,14639,3284,17923
1,14,5,2,2015,13,14610,3284,17894
1,14,5,2,2015,14,14520,3219,17739
1,14,5,2,2015,15,14923,3279,18202
1,14,5,2,2015,16,15054,3312,18366
1,14,5,2,2015,17,14916,3266,18182
1,14,5,2,2015,18,13352,3141,16493
1,14,5,2,2015,19,13451,2926,16377
1,14,5,2,2015,20,13650,2905,16555
1,14,5,2,2015,21,14677,2884,17561
1,14,5,2,2015,22,13967,2812,16779
1,14,5,2,2015,23,14487,2797,17284
1,14,5,2,2015,24,14790,2723,17513
1,15,5,2,2015,1,14963,2655,17618
1,15,5,2,2015,2,14685,2446,17131
1,15,5,2,2015,3,14386,2306,16692
1,15,5,2,2015,4,14213,2193,16406
1,15,5,2,2015,5,14236,2127,16363
1,15,5,2,2015,6,14078,2123,16201
1,15,5,2,2015,7,14480,2081,16561
1,15,5,2,2015,8,14090,2190,16280
1,15,5,2,2015,9,14374,2396,16770
1,15,5,2,2015,10,14662,2790,17452
1,15,5,2,2015,11,14945,3133,18078
1,15,5,2,2015,12,14817,3247,18064
1,15,5,2,2015,13,14457,3317,17774
1,15,5,2,2015,14,14366,3233,17599
1,15,5,2,2015,15,14405,3340,17745
1,15,5,2,2015,16,14256,3363,17619
1,15,5,2,2015,17,13731,3356,17087
1,15,5,2,2015,18,12561,3202,15763
1,15,5,2,2015,19,12576,3042,15618
1,15,5,2,2015,20,13577,3020,16597
1,15,5,2,2015,21,14075,2902,16977
1,15,5,2,2015,22,13895,2841,16736
1,15,5,2,2015,23,13695,2821,16516
1,15,5,2,2015,24,14109,2863,16972
2,16,5,2,2015,1,14303,2754,17057
2,16,5,2,2015,2,13698,2533,16231
2,16,5,2,2015,3,13316,2381,15697
2,16,5,2,2015,4,13442,2236,15678
2,16,5,2,2015,5,13562,2173,15735
2,16,5,2,2015,6,13734,2159,15893
2,16,5,2,2015,7,14115,2100,16215
2,16,5,2,2015,8,14174,2155,16329
2,16,5,2,2015,9,14503,2374,16877
2,16,5,2,2015,10,14534,2717,17251
2,16,5,2,2015,11,15766,3004,18770
2,16,5,2,2015,12,15643,3070,18713
2,16,5,2,2015,13,15812,3162,18974
2,16,5,2,2015,14,15586,3123,18709
2,16,5,2,2015,15,15432,3166,18598
2,16,5,2,2015,16,15761,3157,18918
2,16,5,2,2015,17,15282,3138,18420
2,16,5,2,2015,18,13807,2970,16777
2,16,5,2,2015,19,14261,2823,17084
2,16,5,2,2015,20,14792,2870,17662
2,16,5,2,2015,21,14701,2865,17566
2,16,5,2,2015,22,14302,2807,17109
2,16,5,2,2015,23,14724,2771,17495
2,16,5,2,2015,24,14885,2798,17683
2,17,5,2,2015,1,15111,2697,17808
2,17,5,2,2015,2,14696,2551,17247
2,17,5,2,2015,3,14582,2400,16982
2,17,5,2,2015,4,14467,2287,16754
2,17,5,2,2015,5,13989,2217,16206
2,17,5,2,2015,6,14295,2186,16481
2,17,5,2,2015,7,14465,2089,16554
2,17,5,2,2015,8,14358,2037,16395
2,17,5,2,2015,9,14534,2082,16616
2,17,5,2,2015,10,14868,2148,17016
2,17,5,2,2015,11,15595,2282,17877
2,17,5,2,2015,12,15710,2337,18047
2,17,5,2,2015,13,15524,2384,17908
2,17,5,2,2015,14,15394,2425,17819
2,17,5,2,2015,15,15730,2478,18208
2,17,5,2,2015,16,15511,2500,18011
2,17,5,2,2015,17,15336,2460,17796
2,17,5,2,2015,18,13382,2363,15745
2,17,5,2,2015,19,12626,2274,14900
2,17,5,2,2015,20,13925,2419,16344
2,17,5,2,2015,21,14501,2479,16980
2,17,5,2,2015,22,14134,2564,16698
2,17,5,2,2015,23,14280,2635,16915
2,17,5,2,2015,24,14843,2710,17553
1,18,5,2,2015,1,14686,2642,17328
1,18,5,2,2015,2,14831,2452,17283
1,18,5,2,2015,3,14472,2306,16778
1,18,5,2,2015,4,14376,2197,16573
1,18,5,2,2015,5,13791,2129,15920
1,18,5,2,2015,6,14533,2118,16651
1,18,5,2,2015,7,14896,2074,16970
1,18,5,2,2015,8,14787,2188,16975
1,18,5,2,2015,9,14852,2552,17404
1,18,5,2,2015,10,15943,2861,18804
1,18,5,2,2015,11,16043,3188,19231
1,18,5,2,2015,12,16105,3321,19426
1,18,5,2,2015,13,15935,3326,19261
1,18,5,2,2015,14,15740,3252,18992
1,18,5,2,2015,15,16283,3335,19618
1,18,5,2,2015,16,16173,3350,19523
1,18,5,2,2015,17,15982,3330,19312
1,18,5,2,2015,18,14053,3201,17254
1,18,5,2,2015,19,13561,2955,16516
1,18,5,2,2015,20,14382,2932,17314
1,18,5,2,2015,21,14759,2854,17613
1,18,5,2,2015,22,14486,2789,17275
1,18,5,2,2015,23,14855,2796,17651
1,18,5,2,2015,24,14580,2830,17410
1,19,5,2,2015,1,15090,2724,17814
1,19,5,2,2015,2,15126,2528,17654
1,19,5,2,2015,3,14987,2360,17347
1,19,5,2,2015,4,14655,2255,16910
1,19,5,2,2015,5,14359,2176,16535
1,19,5,2,2015,6,14874,2179,17053
1,19,5,2,2015,7,14966,2110,17076
1,19,5,2,2015,8,15079,2210,17289
1,19,5,2,2015,9,15342,2483,17825
1,19,5,2,2015,10,15683,2903,18586
1,19,5,2,2015,11,15903,3193,19096
1,19,5,2,2015,12,15780,3280,19060
1,19,5,2,2015,13,15495,3285,18780
1,19,5,2,2015,14,15518,3252,18770
1,19,5,2,2015,15,16495,3297,19792
1,19,5,2,2015,16,16156,3313,19469
1,19,5,2,2015,17,15871,3304,19175
1,19,5,2,2015,18,14659,3154,17813
1,19,5,2,2015,19,13160,2972,16132
1,19,5,2,2015,20,14750,2957,17707
1,19,5,2,2015,21,14723,2899,17622
1,19,5,2,2015,22,14446,2881,17327
1,19,5,2,2015,23,14786,2801,17587
1,19,5,2,2015,24,15774,2840,18614
1,20,5,2,2015,1,15603,2691,18294
1,20,5,2,2015,2,15289,2511,17800
1,20,5,2,2015,3,15235,2348,17583
1,20,5,2,2015,4,14764,2231,16995
1,20,5,2,2015,5,14837,2157,16994
1,20,5,2,2015,6,15074,2156,17230
1,20,5,2,2015,7,14773,2111,16884
1,20,5,2,2015,8,15107,2215,17322
1,20,5,2,2015,9,15314,2508,17822
1,20,5,2,2015,10,16054,2856,18910
1,20,5,2,2015,11,16750,3196,19946
1,20,5,2,2015,12,16366,3276,19642
1,20,5,2,2015,13,16408,3335,19743
1,20,5,2,2015,14,15807,3252,19059
1,20,5,2,2015,15,16670,3324,19994
1,20,5,2,2015,16,16720,3345,20065
1,20,5,2,2015,17,16237,3283,19520
1,20,5,2,2015,18,15207,3149,18356
1,20,5,2,2015,19,13646,2923,16569
1,20,5,2,2015,20,15504,2931,18435
1,20,5,2,2015,21,14904,2895,17799
1,20,5,2,2015,22,15121,2780,17901
1,20,5,2,2015,23,15056,2797,17853
1,20,5,2,2015,24,15934,2800,18734
1,21,5,2,2015,1,15781,2678,18459
1,21,5,2,2015,2,15028,2476,17504
1,21,5,2,2015,3,15381,2316,17697
1,21,5,2,2015,4,15011,2201,17212
1,21,5,2,2015,5,14512,2137,16649
1,21,5,2,2015,6,14725,2137,16862
1,21,5,2,2015,7,14815,2109,16924
1,21,5,2,2015,8,15074,2213,17287
1,21,5,2,2015,9,15640,2510,18150
1,21,5,2,2015,10,15580,2863,18443
1,21,5,2,2015,11,15901,3178,19079
1,21,5,2,2015,12,16154,3238,19392
1,21,5,2,2015,13,16018,3285,19303
1,21,5,2,2015,14,15774,3213,18987
1,21,5,2,2015,15,16050,3307,19357
1,21,5,2,2015,16,16526,3315,19841
1,21,5,2,2015,17,16073,3289,19362
1,21,5,2,2015,18,13994,3147,17141
1,21,5,2,2015,19,13659,2958,16617
1,21,5,2,2015,20,14719,2932,17651
1,21,5,2,2015,21,15050,2919,17969
1,21,5,2,2015,22,14605,2797,17402
1,21,5,2,2015,23,14619,2727,17346
1,21,5,2,2015,24,15053,2775,17828
1,22,5,2,2015,1,15579,2677,18256
1,22,5,2,2015,2,15524,2446,17970
1,22,5,2,2015,3,15127,2293,17420
1,22,5,2,2015,4,14717,2183,16900
1,22,5,2,2015,5,14438,2126,16564
1,22,5,2,2015,6,14600,2123,16723
1,22,5,2,2015,7,14922,2094,17016
1,22,5,2,2015,8,15252,2186,17438
1,22,5,2,2015,9,14739,2483,17222
1,22,5,2,2015,10,15639,2913,18552
1,22,5,2,2015,11,15595,3132,18727
1,22,5,2,2015,12,15792,3242,19034
1,22,5,2,2015,13,15661,3275,18936
1,22,5,2,2015,14,15580,3212,18792
1,22,5,2,2015,15,15745,3282,19027
1,22,5,2,2015,16,15609,3304,18913
1,22,5,2,2015,17,15160,3285,18445
1,22,5,2,2015,18,13875,3202,17077
1,22,5,2,2015,19,13239,2955,16194
1,22,5,2,2015,20,14490,2989,17479
1,22,5,2,2015,21,14735,2856,17591
1,22,5,2,2015,22,14814,2712,17526
1,22,5,2,2015,23,14864,2793,17657
1,22,5,2,2015,24,15178,2786,17964
2,23,5,2,2015,1,15730,2662,18392
2,23,5,2,2015,2,15407,2482,17889
2,23,5,2,2015,3,15237,2301,17538
2,23,5,2,2015,4,15058,2239,17297
2,23,5,2,2015,5,14986,2164,17150
2,23,5,2,2015,6,15575,2130,17705
2,23,5,2,2015,7,15522,2115,17637
2,23,5,2,2015,8,15506,2132,17638
2,23,5,2,2015,9,15400,2281,17681
2,23,5,2,2015,10,15361,2544,17905
2,23,5,2,2015,11,15715,2939,18654
2,23,5,2,2015,12,15687,3010,18697
2,23,5,2,2015,13,15651,3022,18673
2,23,5,2,2015,14,15262,2950,18212
2,23,5,2,2015,15,15434,3006,18440
2,23,5,2,2015,16,15486,3007,18493
2,23,5,2,2015,17,15253,2931,18184
2,23,5,2,2015,18,13955,2829,16784
2,23,5,2,2015,19,13642,2666,16308
2,23,5,2,2015,20,14499,2742,17241
2,23,5,2,2015,21,14803,2720,17523
2,23,5,2,2015,22,14634,2666,17300
2,23,5,2,2015,23,15066,2603,17669
2,23,5,2,2015,24,15368,2658,18026
2,24,5,2,2015,1,15679,2601,18280
2,24,5,2,2015,2,15057,2442,17499
2,24,5,2,2015,3,15221,2299,17520
2,24,5,2,2015,4,14729,2197,16926
2,24,5,2,2015,5,14749,2172,16921
2,24,5,2,2015,6,14755,2155,16910
2,24,5,2,2015,7,14785,2054,16839
2,24,5,2,2015,8,14382,2008,16390
2,24,5,2,2015,9,14801,2067,16868
2,24,5,2,2015,10,15073,2126,17199
2,24,5,2,2015,11,15405,2239,17644
2,24,5,2,2015,12,15613,2316,17929
2,24,5,2,2015,13,15335,2347,17682
2,24,5,2,2015,14,15263,2357,17620
2,24,5,2,2015,15,15275,2404,17679
2,24,5,2,2015,16,15704,2420,18124
2,24,5,2,2015,17,15166,2359,17525
2,24,5,2,2015,18,13583,2244,15827
2,24,5,2,2015,19,13157,2201,15358
2,24,5,2,2015,20,14304,2379,16683
2,24,5,2,2015,21,14558,2490,17048
2,24,5,2,2015,22,14214,2520,16734
2,24,5,2,2015,23,14767,2573,17340
2,24,5,2,2015,24,14950,2628,17578
1,25,5,2,2015,1,15453,2628,18081
1,25,5,2,2015,2,14925,2466,17391
1,25,5,2,2015,3,14655,2303,16958
1,25,5,2,2015,4,14170,2186,16356
1,25,5,2,2015,5,14058,2139,16197
1,25,5,2,2015,6,14693,2125,16818
1,25,5,2,2015,7,14782,2130,16912
1,25,5,2,2015,8,15084,2225,17309
1,25,5,2,2015,9,15124,2474,17598
1,25,5,2,2015,10,15767,2847,18614
1,25,5,2,2015,11,16190,3183,19373
1,25,5,2,2015,12,16543,3296,19839
1,25,5,2,2015,13,16474,3311,19785
1,25,5,2,2015,14,15965,3249,19214
1,25,5,2,2015,15,16536,3305,19841
1,25,5,2,2015,16,16503,3321,19824
1,25,5,2,2015,17,16328,3302,19630
1,25,5,2,2015,18,14812,3176,17988
1,25,5,2,2015,19,13412,2958,16370
1,25,5,2,2015,20,15148,2914,18062
1,25,5,2,2015,21,15224,2796,18020
1,25,5,2,2015,22,14857,2762,17619
1,25,5,2,2015,23,15280,2758,18038
1,25,5,2,2015,24,15814,2781,18595
1,26,5,2,2015,1,15555,2712,18267
1,26,5,2,2015,2,15526,2498,18024
1,26,5,2,2015,3,15428,2347,17775
1,26,5,2,2015,4,15016,2229,17245
1,26,5,2,2015,5,14504,2165,16669
1,26,5,2,2015,6,15220,2160,17380
1,26,5,2,2015,7,15125,2103,17228
1,26,5,2,2015,8,15265,2209,17474
1,26,5,2,2015,9,15557,2465,18022
1,26,5,2,2015,10,16283,2905,19188
1,26,5,2,2015,11,16359,3181,19540
1,26,5,2,2015,12,16589,3308,19897
1,26,5,2,2015,13,15917,3319,19236
1,26,5,2,2015,14,15704,3250,18954
1,26,5,2,2015,15,16467,3316,19783
1,26,5,2,2015,16,16740,3330,20070
1,26,5,2,2015,17,15609,3304,18913
1,26,5,2,2015,18,14978,3163,18141
1,26,5,2,2015,19,13798,2969,16767
1,26,5,2,2015,20,14738,2944,17682
1,26,5,2,2015,21,15141,2864,18005
1,26,5,2,2015,22,14934,2729,17663
1,26,5,2,2015,23,15211,2828,18039
1,26,5,2,2015,24,15305,2847,18152
1,27,5,2,2015,1,15892,2692,18584
1,27,5,2,2015,2,15637,2477,18114
1,27,5,2,2015,3,15192,2339,17531
1,27,5,2,2015,4,15140,2204,17344
1,27,5,2,2015,5,14879,2142,17021
1,27,5,2,2015,6,15177,2127,17304
1,27,5,2,2015,7,15345,2100,17445
1,27,5,2,2015,8,15509,2206,17715
1,27,5,2,2015,9,15600,2477,18077
1,27,5,2,2015,10,16251,2938,19189
1,27,5,2,2015,11,16988,3103,20091
1,27,5,2,2015,12,16757,3230,19987
1,27,5,2,2015,13,16735,3284,20019
1,27,5,2,2015,14,16500,3202,19702
1,27,5,2,2015,15,16612,3282,19894
1,27,5,2,2015,16,17027,3287,20314
1,27,5,2,2015,17,16185,3253,19438
1,27,5,2,2015,18,14706,3118,17824
1,27,5,2,2015,19,13633,2923,16556
1,27,5,2,2015,20,14981,2946,17927
1,27,5,2,2015,21,15024,2824,17848
1,27,5,2,2015,22,14631,2759,17390
1,27,5,2,2015,23,15194,2756,17950
1,27,5,2,2015,24,15014,2796,17810
1,28,5,2,2015,1,15697,2693,18390
1,28,5,2,2015,2,15488,2516,18004
1,28,5,2,2015,3,15194,2358,17552
1,28,5,2,2015,4,14765,2242,17007
1,28,5,2,2015,5,14810,2177,16987
1,28,5,2,2015,6,15379,2162,17541
1,28,5,2,2015,7,15520,2116,17636
1,28,5,2,2015,8,15478,2211,17689
1,28,5,2,2015,9,15652,2544,18196
1,28,5,2,2015,10,16252,2867,19119
1,28,5,2,2015,11,16693,3183,19876
1,28,5,2,2015,12,17011,3288,20299
1,28,5,2,2015,13,16562,3324,19886
1,28,5,2,2015,14,16314,3251,19565
1,28,5,2,2015,15,16472,3324,19796
1,28,5,2,2015,16,16564,3326,19890
1,28,5,2,2015,17,16061,3299,19360
1,28,5,2,2015,18,14296,3143,17439
1,28,5,2,2015,19,13745,2964,16709
1,28,5,2,2015,20,14626,2938,17564
1,28,5,2,2015,21,14946,2828,17774
1,28,5,2,2015,22,14396,2741,17137
1,28,5,2,2015,23,14932,2721,17653
1,28,5,2,2015,24,15510,2808,18318
1,29,5,2,2015,1,16147,2726,18873
1,29,5,2,2015,2,15242,2467,17709
1,29,5,2,2015,3,15648,2307,17955
1,29,5,2,2015,4,14727,2198,16925
1,29,5,2,2015,5,14336,2146,16482
1,29,5,2,2015,6,15672,2200,17872
1,29,5,2,2015,7,15331,2152,17483
1,29,5,2,2015,8,15338,2255,17593
1,29,5,2,2015,9,14748,2522,17270
1,29,5,2,2015,10,16147,2931,19078
1,29,5,2,2015,11,15728,3198,18926
1,29,5,2,2015,12,15993,3293,19286
1,29,5,2,2015,13,16149,3353,19502
1,29,5,2,2015,14,16051,3269,19320
1,29,5,2,2015,15,16577,3370,19947
1,29,5,2,2015,16,16199,3394,19593
1,29,5,2,2015,17,15299,3346,18645
1,29,5,2,2015,18,13762,3181,16943
1,29,5,2,2015,19,12149,2977,15126
1,29,5,2,2015,20,13711,2954,16665
1,29,5,2,2015,21,13554,2848,16402
1,29,5,2,2015,22,13820,2766,16586
1,29,5,2,2015,23,13690,2811,16501
1,29,5,2,2015,24,13979,2846,16825
2,30,5,2,2015,1,14023,2741,16764
2,30,5,2,2015,2,13727,2543,16270
2,30,5,2,2015,3,13474,2380,15854
2,30,5,2,2015,4,13276,2272,15548
2,30,5,2,2015,5,12616,2217,14833
2,30,5,2,2015,6,13599,2200,15799
2,30,5,2,2015,7,13533,2125,15658
2,30,5,2,2015,8,13766,2163,15929
2,30,5,2,2015,9,14119,2348,16467
2,30,5,2,2015,10,14666,2731,17397
2,30,5,2,2015,11,14993,2959,17952
2,30,5,2,2015,12,15030,3092,18122
2,30,5,2,2015,13,15518,3094,18612
2,30,5,2,2015,14,15121,3001,18122
2,30,5,2,2015,15,15808,3039,18847
2,30,5,2,2015,16,15612,3031,18643
2,30,5,2,2015,17,15646,2978,18624
2,30,5,2,2015,18,14923,2878,17801
2,30,5,2,2015,19,13599,2787,16386
2,30,5,2,2015,20,15361,2864,18225
2,30,5,2,2015,21,15269,2829,18098
2,30,5,2,2015,22,15325,2762,18087
2,30,5,2,2015,23,15325,2761,18086
2,30,5,2,2015,24,15173,2817,17990
2,31,5,2,2015,1,15431,2692,18123
2,31,5,2,2015,2,15290,2524,17814
2,31,5,2,2015,3,15568,2373,17941
2,31,5,2,2015,4,14978,2270,17248
2,31,5,2,2015,5,14706,2195,16901
2,31,5,2,2015,6,14727,2167,16894
2,31,5,2,2015,7,14775,2060,16835
2,31,5,2,2015,8,14781,2022,16803
2,31,5,2,2015,9,14121,2068,16189
2,31,5,2,2015,10,14551,2160,16711
2,31,5,2,2015,11,14944,2288,17232
2,31,5,2,2015,12,15103,2379,17482
2,31,5,2,2015,13,15666,2429,18095
2,31,5,2,2015,14,15380,2452,17832
2,31,5,2,2015,15,15259,2510,17769
2,31,5,2,2015,16,15586,2533,18119
2,31,5,2,2015,17,14963,2453,17416
2,31,5,2,2015,18,13729,2348,16077
2,31,5,2,2015,19,13158,2286,15444
2,31,5,2,2015,20,14120,2458,16578
2,31,5,2,2015,21,14298,2565,16863
2,31,5,2,2015,22,14217,2619,16836
2,31,5,2,2015,23,14508,2662,17170
2,31,5,2,2015,24,14350,2703,17053
1,1,6,2,2015,1,14602,2701,17303
1,1,6,2,2015,2,14768,2505,17273
1,1,6,2,2015,3,14486,2357,16843
1,1,6,2,2015,4,13783,2240,16023
1,1,6,2,2015,5,13674,2167,15841
1,1,6,2,2015,6,13748,2151,15899
1,1,6,2,2015,7,14230,2120,16350
1,1,6,2,2015,8,14843,2208,17051
1,1,6,2,2015,9,14433,2522,16955
1,1,6,2,2015,10,15277,2917,18194
1,1,6,2,2015,11,15667,3217,18884
1,1,6,2,2015,12,15692,3317,19009
1,1,6,2,2015,13,15554,3342,18896
1,1,6,2,2015,14,15521,3287,18808
1,1,6,2,2015,15,15663,3341,19004
1,1,6,2,2015,16,16204,3343,19547
1,1,6,2,2015,17,15830,3322,19152
1,1,6,2,2015,18,14875,3172,18047
1,1,6,2,2015,19,13648,2944,16592
1,1,6,2,2015,20,15058,2906,17964
1,1,6,2,2015,21,15028,2865,17893
1,1,6,2,2015,22,14155,2782,16937
1,1,6,2,2015,23,14495,2779,17274
1,1,6,2,2015,24,15267,2865,18132
1,2,6,2,2015,1,15193,2708,17901
1,2,6,2,2015,2,14728,2488,17216
1,2,6,2,2015,3,14597,2345,16942
1,2,6,2,2015,4,14586,2243,16829
1,2,6,2,2015,5,14605,2169,16774
1,2,6,2,2015,6,14738,2157,16895
1,2,6,2,2015,7,14712,2122,16834
1,2,6,2,2015,8,14707,2220,16927
1,2,6,2,2015,9,14981,2545,17526
1,2,6,2,2015,10,15381,2872,18253
1,2,6,2,2015,11,15724,3173,18897
1,2,6,2,2015,12,15629,3236,18865
1,2,6,2,2015,13,15736,3274,19010
1,2,6,2,2015,14,15664,3214,18878
1,2,6,2,2015,15,15415,3298,18713
1,2,6,2,2015,16,16455,3306,19761
1,2,6,2,2015,17,15677,3287,18964
1,2,6,2,2015,18,14219,3139,17358
1,2,6,2,2015,19,13279,2907,16186
1,2,6,2,2015,20,14360,2901,17261
1,2,6,2,2015,21,13816,2830,16646
1,2,6,2,2015,22,13855,2757,16612
1,2,6,2,2015,23,13762,2775,16537
1,2,6,2,2015,24,14394,2825,17219
1,3,6,2,2015,1,14430,2677,17107
1,3,6,2,2015,2,14583,2482,17065
1,3,6,2,2015,3,14488,2347,16835
1,3,6,2,2015,4,14261,2244,16505
1,3,6,2,2015,5,14056,2174,16230
1,3,6,2,2015,6,14094,2170,16264
1,3,6,2,2015,7,14563,2119,16682
1,3,6,2,2015,8,14702,2244,16946
1,3,6,2,2015,9,15265,2500,17765
1,3,6,2,2015,10,15406,2891,18297
1,3,6,2,2015,11,15975,3116,19091
1,3,6,2,2015,12,15849,3215,19064
1,3,6,2,2015,13,15725,3259,18984
1,3,6,2,2015,14,15568,3198,18766
1,3,6,2,2015,15,16050,3298,19348
1,3,6,2,2015,16,16329,3314,19643
1,3,6,2,2015,17,15907,3285,19192
1,3,6,2,2015,18,14555,3152,17707
1,3,6,2,2015,19,13693,2916,16609
1,3,6,2,2015,20,14848,2901,17749
1,3,6,2,2015,21,14993,2816,17809
1,3,6,2,2015,22,14524,2764,17288
1,3,6,2,2015,23,14782,2790,17572
1,3,6,2,2015,24,15197,2856,18053
1,4,6,2,2015,1,15392,2750,18142
1,4,6,2,2015,2,14903,2534,17437
1,4,6,2,2015,3,14976,2381,17357
1,4,6,2,2015,4,14431,2266,16697
1,4,6,2,2015,5,14619,2200,16819
1,4,6,2,2015,6,14857,2192,17049
1,4,6,2,2015,7,15256,2136,17392
1,4,6,2,2015,8,15184,2261,17445
1,4,6,2,2015,9,15408,2514,17922
1,4,6,2,2015,10,15646,2932,18578
1,4,6,2,2015,11,16245,3169,19414
1,4,6,2,2015,12,16227,3285,19512
1,4,6,2,2015,13,15866,3339,19205
1,4,6,2,2015,14,15641,3302,18943
1,4,6,2,2015,15,16162,3370,19532
1,4,6,2,2015,16,16436,3392,19828
1,4,6,2,2015,17,15343,3368,18711
1,4,6,2,2015,18,14296,3195,17491
1,4,6,2,2015,19,13462,3054,16516
1,4,6,2,2015,20,14475,3067,17542
1,4,6,2,2015,21,14585,2934,17519
1,4,6,2,2015,22,14457,2835,17292
1,4,6,2,2015,23,14496,2894,17390
1,4,6,2,2015,24,14475,2905,17380
1,5,6,2,2015,1,14849,2808,17657
1,5,6,2,2015,2,14219,2622,16841
1,5,6,2,2015,3,14271,2443,16714
1,5,6,2,2015,4,13850,2316,16166
1,5,6,2,2015,5,13870,2255,16125
1,5,6,2,2015,6,13757,2268,16025
1,5,6,2,2015,7,13814,2193,16007
1,5,6,2,2015,8,13606,2243,15849
1,5,6,2,2015,9,13904,2526,16430
1,5,6,2,2015,10,14007,2828,16835
1,5,6,2,2015,11,14019,3170,17189
1,5,6,2,2015,12,14469,3271,17740
1,5,6,2,2015,13,14087,3298,17385
1,5,6,2,2015,14,14066,3236,17302
1,5,6,2,2015,15,14565,3352,17917
1,5,6,2,2015,16,14910,3369,18279
1,5,6,2,2015,17,14413,3330,17743
1,5,6,2,2015,18,13820,3225,17045
1,5,6,2,2015,19,13415,3065,16480
1,5,6,2,2015,20,14474,3025,17499
1,5,6,2,2015,21,14555,2918,17473
1,5,6,2,2015,22,13518,2908,16426
1,5,6,2,2015,23,13981,2856,16837
1,5,6,2,2015,24,13803,2924,16727
2,6,6,2,2015,1,14267,2782,17049
2,6,6,2,2015,2,13898,2579,16477
2,6,6,2,2015,3,13619,2420,16039
2,6,6,2,2015,4,13280,2283,15563
2,6,6,2,2015,5,12891,2197,15088
2,6,6,2,2015,6,13151,2197,15348
2,6,6,2,2015,7,13373,2143,15516
2,6,6,2,2015,8,13613,2145,15758
2,6,6,2,2015,9,13881,2285,16166
2,6,6,2,2015,10,14422,2626,17048
2,6,6,2,2015,11,14682,2894,17576
2,6,6,2,2015,12,15047,3060,18107
2,6,6,2,2015,13,14933,3124,18057
2,6,6,2,2015,14,14962,3077,18039
2,6,6,2,2015,15,15234,3157,18391
2,6,6,2,2015,16,15428,3158,18586
2,6,6,2,2015,17,15036,3104,18140
2,6,6,2,2015,18,14358,2971,17329
2,6,6,2,2015,19,13747,2816,16563
2,6,6,2,2015,20,14632,2871,17503
2,6,6,2,2015,21,14552,2878,17430
2,6,6,2,2015,22,14612,2806,17418
2,6,6,2,2015,23,14200,2714,16914
2,6,6,2,2015,24,14518,2851,17369
2,7,6,2,2015,1,14732,2720,17452
2,7,6,2,2015,2,14462,2490,16952
2,7,6,2,2015,3,14325,2344,16669
2,7,6,2,2015,4,14116,2222,16338
2,7,6,2,2015,5,14190,2173,16363
2,7,6,2,2015,6,14132,2166,16298
2,7,6,2,2015,7,14580,2067,16647
2,7,6,2,2015,8,14322,2030,16352
2,7,6,2,2015,9,14177,2077,16254
2,7,6,2,2015,10,14719,2136,16855
2,7,6,2,2015,11,14955,2232,17187
2,7,6,2,2015,12,15340,2310,17650
2,7,6,2,2015,13,14676,2391,17067
2,7,6,2,2015,14,14392,2363,16755
2,7,6,2,2015,15,14164,2444,16608
2,7,6,2,2015,16,14038,2400,16438
2,7,6,2,2015,17,13129,2346,15475
2,7,6,2,2015,18,12346,2244,14590
2,7,6,2,2015,19,11593,2245,13838
2,7,6,2,2015,20,12138,2379,14517
2,7,6,2,2015,21,12372,2400,14772
2,7,6,2,2015,22,12178,2437,14615
2,7,6,2,2015,23,12457,2503,14960
2,7,6,2,2015,24,12587,2533,15120
1,8,6,2,2015,1,12948,2484,15432
1,8,6,2,2015,2,12474,2312,14786
1,8,6,2,2015,3,12638,2194,14832
1,8,6,2,2015,4,12279,2114,14393
1,8,6,2,2015,5,11944,2053,13997
1,8,6,2,2015,6,12320,2076,14396
1,8,6,2,2015,7,12430,2055,14485
1,8,6,2,2015,8,12454,2162,14616
1,8,6,2,2015,9,12921,2414,15335
1,8,6,2,2015,10,13665,2834,16499
1,8,6,2,2015,11,13809,3082,16891
1,8,6,2,2015,12,14238,3220,17458
1,8,6,2,2015,13,14236,3242,17478
1,8,6,2,2015,14,14447,3164,17611
1,8,6,2,2015,15,14611,3218,17829
1,8,6,2,2015,16,14690,3256,17946
1,8,6,2,2015,17,14953,3249,18202
1,8,6,2,2015,18,13856,3145,17001
1,8,6,2,2015,19,13080,2921,16001
1,8,6,2,2015,20,14005,2866,16871
1,8,6,2,2015,21,14086,2886,16972
1,8,6,2,2015,22,13996,2742,16738
1,8,6,2,2015,23,13889,2689,16578
1,8,6,2,2015,24,13507,2666,16173
1,9,6,2,2015,1,13727,2591,16318
1,9,6,2,2015,2,13550,2420,15970
1,9,6,2,2015,3,13255,2281,15536
1,9,6,2,2015,4,12660,2174,14834
1,9,6,2,2015,5,12877,2118,14995
1,9,6,2,2015,6,13175,2141,15316
1,9,6,2,2015,7,13235,2089,15324
1,9,6,2,2015,8,13380,2185,15565
1,9,6,2,2015,9,13904,2414,16318
1,9,6,2,2015,10,14321,2853,17174
1,9,6,2,2015,11,14831,3082,17913
1,9,6,2,2015,12,14902,3158,18060
1,9,6,2,2015,13,14841,3219,18060
1,9,6,2,2015,14,14665,3182,17847
1,9,6,2,2015,15,15308,3254,18562
1,9,6,2,2015,16,15158,3254,18412
1,9,6,2,2015,17,15158,3252,18410
1,9,6,2,2015,18,13840,3196,17036
1,9,6,2,2015,19,12721,2984,15705
1,9,6,2,2015,20,14385,2955,17340
1,9,6,2,2015,21,14452,2869,17321
1,9,6,2,2015,22,14164,2796,16960
1,9,6,2,2015,23,14304,2788,17092
1,9,6,2,2015,24,13899,2815,16714
1,10,6,2,2015,1,13987,2633,16620
1,10,6,2,2015,2,13726,2408,16134
1,10,6,2,2015,3,13407,2262,15669
1,10,6,2,2015,4,13269,2166,15435
1,10,6,2,2015,5,12862,2094,14956
1,10,6,2,2015,6,13157,2106,15263
1,10,6,2,2015,7,13568,2085,15653
1,10,6,2,2015,8,13980,2176,16156
1,10,6,2,2015,9,14464,2534,16998
1,10,6,2,2015,10,14653,2872,17525
1,10,6,2,2015,11,15083,3177,18260
1,10,6,2,2015,12,15289,3236,18525
1,10,6,2,2015,13,15132,3262,18394
1,10,6,2,2015,14,14987,3226,18213
1,10,6,2,2015,15,15316,3261,18577
1,10,6,2,2015,16,15322,3266,18588
1,10,6,2,2015,17,14870,3261,18131
1,10,6,2,2015,18,14048,3144,17192
1,10,6,2,2015,19,13318,3007,16325
1,10,6,2,2015,20,14072,2962,17034
1,10,6,2,2015,21,14330,2903,17233
1,10,6,2,2015,22,14280,2830,17110
1,10,6,2,2015,23,13807,2799,16606
1,10,6,2,2015,24,13877,2804,16681
1,11,6,2,2015,1,13863,2670,16533
1,11,6,2,2015,2,13688,2452,16140
1,11,6,2,2015,3,13392,2304,15696
1,11,6,2,2015,4,13065,2199,15264
1,11,6,2,2015,5,12888,2138,15026
1,11,6,2,2015,6,13233,2143,15376
1,11,6,2,2015,7,13310,2115,15425
1,11,6,2,2015,8,13449,2180,15629
1,11,6,2,2015,9,13343,2536,15879
1,11,6,2,2015,10,14020,2915,16935
1,11,6,2,2015,11,14471,3208,17679
1,11,6,2,2015,12,14561,3247,17808
1,11,6,2,2015,13,14208,3281,17489
1,11,6,2,2015,14,14267,3224,17491
1,11,6,2,2015,15,14618,3281,17899
1,11,6,2,2015,16,14659,3282,17941
1,11,6,2,2015,17,14401,3266,17667
1,11,6,2,2015,18,13059,3147,16206
1,11,6,2,2015,19,12937,2940,15877
1,11,6,2,2015,20,13612,2916,16528
1,11,6,2,2015,21,14097,2880,16977
1,11,6,2,2015,22,13210,2809,16019
1,11,6,2,2015,23,13394,2761,16155
1,11,6,2,2015,24,13349,2642,15991
1,12,6,2,2015,1,12981,2462,15443
1,12,6,2,2015,2,13030,2284,15314
1,12,6,2,2015,3,12655,2144,14799
1,12,6,2,2015,4,12464,2064,14528
1,12,6,2,2015,5,12093,2017,14110
1,12,6,2,2015,6,12603,2036,14639
1,12,6,2,2015,7,12696,2054,14750
1,12,6,2,2015,8,13030,2125,15155
1,12,6,2,2015,9,13012,2332,15344
1,12,6,2,2015,10,13791,2685,16476
1,12,6,2,2015,11,13923,2978,16901
1,12,6,2,2015,12,14152,3076,17228
1,12,6,2,2015,13,13793,3075,16868
1,12,6,2,2015,14,13688,2982,16670
1,12,6,2,2015,15,13961,3033,16994
1,12,6,2,2015,16,13405,3076,16481
1,12,6,2,2015,17,12871,3055,15926
1,12,6,2,2015,18,11276,3005,14281
1,12,6,2,2015,19,12095,2817,14912
1,12,6,2,2015,20,13078,2776,15854
1,12,6,2,2015,21,13317,2754,16071
1,12,6,2,2015,22,12879,2668,15547
1,12,6,2,2015,23,12960,2555,15515
1,12,6,2,2015,24,13379,2494,15873
2,13,6,2,2015,1,13032,2454,15486
2,13,6,2,2015,2,12489,2237,14726
2,13,6,2,2015,3,12564,2099,14663
2,13,6,2,2015,4,12223,1995,14218
2,13,6,2,2015,5,11971,1941,13912
2,13,6,2,2015,6,12192,1954,14146
2,13,6,2,2015,7,12302,1883,14185
2,13,6,2,2015,8,12449,1938,14387
2,13,6,2,2015,9,12930,2132,15062
2,13,6,2,2015,10,13449,2426,15875
2,13,6,2,2015,11,13719,2686,16405
2,13,6,2,2015,12,13775,2723,16498
2,13,6,2,2015,13,13551,2715,16266
2,13,6,2,2015,14,13139,2581,15720
2,13,6,2,2015,15,13386,2560,15946
2,13,6,2,2015,16,13165,2551,15716
2,13,6,2,2015,17,12736,2512,15248
2,13,6,2,2015,18,11782,2477,14259
2,13,6,2,2015,19,12061,2426,14487
2,13,6,2,2015,20,13103,2517,15620
2,13,6,2,2015,21,13251,2528,15779
2,13,6,2,2015,22,12923,2445,15368
2,13,6,2,2015,23,12951,2369,15320
2,13,6,2,2015,24,13152,2324,15476
2,14,6,2,2015,1,12912,2216,15128
2,14,6,2,2015,2,12602,2049,14651
2,14,6,2,2015,3,12346,1964,14310
2,14,6,2,2015,4,12182,1840,14022
2,14,6,2,2015,5,12466,1818,14284
2,14,6,2,2015,6,12648,1856,14504
2,14,6,2,2015,7,12821,1791,14612
2,14,6,2,2015,8,12812,1715,14527
2,14,6,2,2015,9,13249,1796,15045
2,14,6,2,2015,10,13058,1904,14962
2,14,6,2,2015,11,13203,2064,15267
2,14,6,2,2015,12,12911,2099,15010
2,14,6,2,2015,13,12734,2083,14817
2,14,6,2,2015,14,12572,2017,14589
2,14,6,2,2015,15,12338,1941,14279
2,14,6,2,2015,16,12231,1900,14131
2,14,6,2,2015,17,11906,1897,13803
2,14,6,2,2015,18,11154,1903,13057
2,14,6,2,2015,19,11561,1959,13520
2,14,6,2,2015,20,12411,2120,14531
2,14,6,2,2015,21,12675,2188,14863
2,14,6,2,2015,22,12637,2211,14848
2,14,6,2,2015,23,12392,2160,14552
2,14,6,2,2015,24,12130,2109,14239
1,15,6,2,2015,1,11693,1961,13654
1,15,6,2,2015,2,11802,1800,13602
1,15,6,2,2015,3,11887,1703,13590
1,15,6,2,2015,4,11720,1655,13375
1,15,6,2,2015,5,11763,1648,13411
1,15,6,2,2015,6,12180,1742,13922
1,15,6,2,2015,7,12697,1841,14538
1,15,6,2,2015,8,12568,1973,14541
1,15,6,2,2015,9,13318,2197,15515
1,15,6,2,2015,10,13568,2560,16128
1,15,6,2,2015,11,13606,2765,16371
1,15,6,2,2015,12,13416,2841,16257
1,15,6,2,2015,13,13132,2840,15972
1,15,6,2,2015,14,13146,2789,15935
1,15,6,2,2015,15,12516,2783,15299
1,15,6,2,2015,16,12655,2776,15431
1,15,6,2,2015,17,12511,2713,15224
1,15,6,2,2015,18,12081,2658,14739
1,15,6,2,2015,19,12116,2559,14675
1,15,6,2,2015,20,13047,2580,15627
1,15,6,2,2015,21,13133,2500,15633
1,15,6,2,2015,22,13191,2381,15572
1,15,6,2,2015,23,12844,2282,15126
1,15,6,2,2015,24,12545,2122,14667
1,16,6,2,2015,1,12348,1952,14300
1,16,6,2,2015,2,12196,1773,13969
1,16,6,2,2015,3,12128,1688,13816
1,16,6,2,2015,4,11764,1640,13404
1,16,6,2,2015,5,11739,1621,13360
1,16,6,2,2015,6,12313,1710,14023
1,16,6,2,2015,7,12760,1821,14581
1,16,6,2,2015,8,13259,1986,15245
1,16,6,2,2015,9,13313,2338,15651
1,16,6,2,2015,10,13570,2623,16193
1,16,6,2,2015,11,13761,2924,16685
1,16,6,2,2015,12,13619,2967,16586
1,16,6,2,2015,13,13439,2960,16399
1,16,6,2,2015,14,13195,2861,16056
1,16,6,2,2015,15,13347,2891,16238
1,16,6,2,2015,16,12872,2848,15720
1,16,6,2,2015,17,12811,2825,15636
1,16,6,2,2015,18,12105,2789,14894
1,16,6,2,2015,19,12162,2716,14878
1,16,6,2,2015,20,13373,2655,16028
1,16,6,2,2015,21,13298,2546,15844
1,16,6,2,2015,22,12864,2410,15274
1,16,6,2,2015,23,12459,2266,14725
1,16,6,2,2015,24,12604,2116,14720
1,17,6,2,2015,1,12221,1941,14162
1,17,6,2,2015,2,11993,1762,13755
1,17,6,2,2015,3,11944,1676,13620
1,17,6,2,2015,4,11777,1630,13407
1,17,6,2,2015,5,12159,1609,13768
1,17,6,2,2015,6,12255,1699,13954
1,17,6,2,2015,7,12699,1810,14509
1,17,6,2,2015,8,13005,1975,14980
1,17,6,2,2015,9,12604,2326,14930
1,17,6,2,2015,10,13730,2612,16342
1,17,6,2,2015,11,14238,2809,17047
1,17,6,2,2015,12,13260,2890,16150
1,17,6,2,2015,13,12928,2838,15766
1,17,6,2,2015,14,13318,2714,16032
1,17,6,2,2015,15,13369,2706,16075
1,17,6,2,2015,16,13682,2749,16431
1,17,6,2,2015,17,13305,2790,16095
1,17,6,2,2015,18,12402,2728,15130
1,17,6,2,2015,19,11926,2669,14595
1,17,6,2,2015,20,13703,2621,16324
1,17,6,2,2015,21,13560,2567,16127
1,17,6,2,2015,22,13042,2451,15493
1,17,6,2,2015,23,12774,2281,15055
1,17,6,2,2015,24,12720,2136,14856
1,18,6,2,2015,1,12039,1913,13952
1,18,6,2,2015,2,11764,1736,13500
1,18,6,2,2015,3,11967,1651,13618
1,18,6,2,2015,4,11595,1608,13203
1,18,6,2,2015,5,11704,1605,13309
1,18,6,2,2015,6,12179,1696,13875
1,18,6,2,2015,7,12313,1806,14119
1,18,6,2,2015,8,12899,1977,14876
1,18,6,2,2015,9,12871,2282,15153
1,18,6,2,2015,10,13289,2621,15910
1,18,6,2,2015,11,13361,2821,16182
1,18,6,2,2015,12,13145,2868,16013
1,18,6,2,2015,13,12922,2849,15771
1,18,6,2,2015,14,12614,2700,15314
1,18,6,2,2015,15,12677,2696,15373
1,18,6,2,2015,16,12614,2693,15307
1,18,6,2,2015,17,12354,2681,15035
1,18,6,2,2015,18,11550,2652,14202
1,18,6,2,2015,19,11713,2602,14315
1,18,6,2,2015,20,13157,2570,15727
1,18,6,2,2015,21,12605,2472,15077
1,18,6,2,2015,22,12329,2342,14671
1,18,6,2,2015,23,12047,2171,14218
1,18,6,2,2015,24,11787,1974,13761
1,19,6,2,2015,1,11823,1779,13602
1,19,6,2,2015,2,11868,1635,13503
1,19,6,2,2015,3,11564,1560,13124
1,19,6,2,2015,4,11611,1528,13139
1,19,6,2,2015,5,11751,1538,13289
1,19,6,2,2015,6,12129,1601,13730
1,19,6,2,2015,7,12534,1686,14220
1,19,6,2,2015,8,12736,1817,14553
1,19,6,2,2015,9,12961,2037,14998
1,19,6,2,2015,10,12303,2292,14595
1,19,6,2,2015,11,12282,2429,14711
1,19,6,2,2015,12,12140,2489,14629
1,19,6,2,2015,13,11911,2483,14394
1,19,6,2,2015,14,11471,2346,13817
1,19,6,2,2015,15,11974,2276,14250
1,19,6,2,2015,16,11925,2191,14116
1,19,6,2,2015,17,11376,2126,13502
1,19,6,2,2015,18,11323,2092,13415
1,19,6,2,2015,19,11408,2092,13500
1,19,6,2,2015,20,12400,2112,14512
1,19,6,2,2015,21,12532,2119,14651
1,19,6,2,2015,22,12422,2062,14484
1,19,6,2,2015,23,12011,1971,13982
1,19,6,2,2015,24,11701,1852,13553
2,20,6,2,2015,1,11848,1700,13548
2,20,6,2,2015,2,11399,1570,12969
2,20,6,2,2015,3,11488,1515,13003
2,20,6,2,2015,4,11480,1492,12972
2,20,6,2,2015,5,11513,1494,13007
2,20,6,2,2015,6,11744,1550,13294
2,20,6,2,2015,7,12420,1596,14016
2,20,6,2,2015,8,12881,1725,14606
2,20,6,2,2015,9,12906,1967,14873
2,20,6,2,2015,10,13112,2295,15407
2,20,6,2,2015,11,12842,2534,15376
2,20,6,2,2015,12,12703,2616,15319
2,20,6,2,2015,13,12546,2613,15159
2,20,6,2,2015,14,12369,2481,14850
2,20,6,2,2015,15,12559,2419,14978
2,20,6,2,2015,16,12860,2380,15240
2,20,6,2,2015,17,12649,2369,15018
2,20,6,2,2015,18,11965,2367,14332
2,20,6,2,2015,19,11959,2354,14313
2,20,6,2,2015,20,12836,2372,15208
2,20,6,2,2015,21,13129,2270,15399
2,20,6,2,2015,22,12556,2195,14751
2,20,6,2,2015,23,12434,2125,14559
2,20,6,2,2015,24,12323,1967,14290
2,21,6,2,2015,1,12329,1799,14128
2,21,6,2,2015,2,11803,1665,13468
2,21,6,2,2015,3,11687,1589,13276
2,21,6,2,2015,4,11979,1557,13536
2,21,6,2,2015,5,11949,1566,13515
2,21,6,2,2015,6,12214,1600,13814
2,21,6,2,2015,7,12819,1626,14445
2,21,6,2,2015,8,12858,1703,14561
2,21,6,2,2015,9,13047,1820,14867
2,21,6,2,2015,10,12847,1962,14809
2,21,6,2,2015,11,12815,2096,14911
2,21,6,2,2015,12,12658,2120,14778
2,21,6,2,2015,13,12630,2147,14777
2,21,6,2,2015,14,12310,2088,14398
2,21,6,2,2015,15,12061,2014,14075
2,21,6,2,2015,16,12063,1962,14025
2,21,6,2,2015,17,11640,1937,13577
2,21,6,2,2015,18,11495,1957,13452
2,21,6,2,2015,19,11343,2031,13374
2,21,6,2,2015,20,11875,2135,14010
2,21,6,2,2015,21,11749,2177,13926
2,21,6,2,2015,22,11741,2092,13833
2,21,6,2,2015,23,11575,1978,13553
2,21,6,2,2015,24,11128,1941,13069
1,22,6,2,2015,1,10960,1751,12711
1,22,6,2,2015,2,10779,1620,12399
1,22,6,2,2015,3,10530,1561,12091
1,22,6,2,2015,4,10805,1539,12344
1,22,6,2,2015,5,10773,1582,12355
1,22,6,2,2015,6,11111,1676,12787
1,22,6,2,2015,7,11592,1820,13412
1,22,6,2,2015,8,12064,2025,14089
1,22,6,2,2015,9,12017,2324,14341
1,22,6,2,2015,10,12260,2655,14915
1,22,6,2,2015,11,11804,2843,14647
1,22,6,2,2015,12,11894,2908,14802
1,22,6,2,2015,13,11337,2905,14242
1,22,6,2,2015,14,11370,2835,14205
1,22,6,2,2015,15,11017,2831,13848
1,22,6,2,2015,16,11087,2823,13910
1,22,6,2,2015,17,11173,2806,13979
1,22,6,2,2015,18,11049,2796,13845
1,22,6,2,2015,19,11524,2660,14184
1,22,6,2,2015,20,12378,2616,14994
1,22,6,2,2015,21,12132,2549,14681
1,22,6,2,2015,22,12330,2461,14791
1,22,6,2,2015,23,11611,2323,13934
1,22,6,2,2015,24,11532,2120,13652
1,23,6,2,2015,1,11118,1953,13071
1,23,6,2,2015,2,10937,1770,12707
1,23,6,2,2015,3,10899,1676,12575
1,23,6,2,2015,4,11208,1658,12866
1,23,6,2,2015,5,11305,1667,12972
1,23,6,2,2015,6,11585,1748,13333
1,23,6,2,2015,7,12297,1848,14145
1,23,6,2,2015,8,12480,2009,14489
1,23,6,2,2015,9,12368,2308,14676
1,23,6,2,2015,10,11935,2627,14562
1,23,6,2,2015,11,12101,2858,14959
1,23,6,2,2015,12,11883,2923,14806
1,23,6,2,2015,13,10963,2899,13862
1,23,6,2,2015,14,10447,2772,13219
1,23,6,2,2015,15,11053,2750,13803
1,23,6,2,2015,16,10984,2732,13716
1,23,6,2,2015,17,11458,2737,14195
1,23,6,2,2015,18,11317,2706,14023
1,23,6,2,2015,19,12287,2653,14940
1,23,6,2,2015,20,12717,2610,15327
1,23,6,2,2015,21,12967,2510,15477
1,23,6,2,2015,22,12355,2402,14757
1,23,6,2,2015,23,11454,2237,13691
1,23,6,2,2015,24,11106,2087,13193
1,24,6,2,2015,1,10906,1884,12790
1,24,6,2,2015,2,10848,1742,12590
1,24,6,2,2015,3,10481,1670,12151
1,24,6,2,2015,4,10506,1643,12149
1,24,6,2,2015,5,10589,1654,12243
1,24,6,2,2015,6,10631,1770,12401
1,24,6,2,2015,7,11507,1895,13402
1,24,6,2,2015,8,11443,2072,13515
1,24,6,2,2015,9,11729,2408,14137
1,24,6,2,2015,10,11523,2742,14265
1,24,6,2,2015,11,11583,2945,14528
1,24,6,2,2015,12,10974,2984,13958
1,24,6,2,2015,13,10672,2965,13637
1,24,6,2,2015,14,10209,2882,13091
1,24,6,2,2015,15,10133,2868,13001
1,24,6,2,2015,16,10443,2864,13307
1,24,6,2,2015,17,10954,2851,13805
1,24,6,2,2015,18,10857,2809,13666
1,24,6,2,2015,19,11610,2734,14344
1,24,6,2,2015,20,12419,2674,15093
1,24,6,2,2015,21,12459,2597,15056
1,24,6,2,2015,22,12524,2468,14992
1,24,6,2,2015,23,11966,2337,14303
1,24,6,2,2015,24,11531,2187,13718
1,25,6,2,2015,1,11968,1988,13956
1,25,6,2,2015,2,11054,1832,12886
1,25,6,2,2015,3,11128,1743,12871
1,25,6,2,2015,4,11583,1696,13279
1,25,6,2,2015,5,11653,1714,13367
1,25,6,2,2015,6,11800,1790,13590
1,25,6,2,2015,7,12582,1913,14495
1,25,6,2,2015,8,12847,2098,14945
1,25,6,2,2015,9,12682,2429,15111
1,25,6,2,2015,10,12595,2778,15373
1,25,6,2,2015,11,12295,3019,15314
1,25,6,2,2015,12,11932,3027,14959
1,25,6,2,2015,13,11791,3015,14806
1,25,6,2,2015,14,11556,2948,14504
1,25,6,2,2015,15,11638,2960,14598
1,25,6,2,2015,16,11646,2964,14610
1,25,6,2,2015,17,12093,2956,15049
1,25,6,2,2015,18,11489,2879,14368
1,25,6,2,2015,19,11921,2802,14723
1,25,6,2,2015,20,12681,2744,15425
1,25,6,2,2015,21,13127,2701,15828
1,25,6,2,2015,22,12880,2570,15450
1,25,6,2,2015,23,12545,2420,14965
1,25,6,2,2015,24,12268,2271,14539
1,26,6,2,2015,1,12050,2121,14171
1,26,6,2,2015,2,12163,1908,14071
1,26,6,2,2015,3,11630,1823,13453
1,26,6,2,2015,4,11538,1775,13313
1,26,6,2,2015,5,11846,1777,13623
1,26,6,2,2015,6,12440,1875,14315
1,26,6,2,2015,7,13144,1985,15129
1,26,6,2,2015,8,13347,2150,15497
1,26,6,2,2015,9,13413,2463,15876
1,26,6,2,2015,10,12858,2819,15677
1,26,6,2,2015,11,12846,3031,15877
1,26,6,2,2015,12,12271,3045,15316
1,26,6,2,2015,13,12002,3042,15044
1,26,6,2,2015,14,11789,2938,14727
1,26,6,2,2015,15,11559,2993,14552
1,26,6,2,2015,16,11338,3004,14342
1,26,6,2,2015,17,11815,2967,14782
1,26,6,2,2015,18,11390,2891,14281
1,26,6,2,2015,19,11384,2771,14155
1,26,6,2,2015,20,12695,2757,15452
1,26,6,2,2015,21,13335,2683,16018
1,26,6,2,2015,22,12783,2541,15324
1,26,6,2,2015,23,12425,2452,14877
1,26,6,2,2015,24,12330,2339,14669
2,27,6,2,2015,1,12112,2169,14281
2,27,6,2,2015,2,12146,1977,14123
2,27,6,2,2015,3,11705,1868,13573
2,27,6,2,2015,4,11952,1814,13766
2,27,6,2,2015,5,12180,1814,13994
2,27,6,2,2015,6,12747,1872,14619
2,27,6,2,2015,7,13625,1927,15552
2,27,6,2,2015,8,14050,2053,16103
2,27,6,2,2015,9,13842,2295,16137
2,27,6,2,2015,10,13645,2625,16270
2,27,6,2,2015,11,13741,2826,16567
2,27,6,2,2015,12,13637,2876,16513
2,27,6,2,2015,13,13424,2873,16297
2,27,6,2,2015,14,13443,2790,16233
2,27,6,2,2015,15,13900,2799,16699
2,27,6,2,2015,16,13936,2768,16704
2,27,6,2,2015,17,13722,2709,16431
2,27,6,2,2015,18,12671,2648,15319
2,27,6,2,2015,19,12507,2562,15069
2,27,6,2,2015,20,13729,2572,16301
2,27,6,2,2015,21,14160,2596,16756
2,27,6,2,2015,22,13984,2517,16501
2,27,6,2,2015,23,13780,2429,16209
2,27,6,2,2015,24,13654,2352,16006
2,28,6,2,2015,1,13701,2200,15901
2,28,6,2,2015,2,13119,2016,15135
2,28,6,2,2015,3,12546,1895,14441
2,28,6,2,2015,4,12746,1835,14581
2,28,6,2,2015,5,12749,1822,14571
2,28,6,2,2015,6,13253,1864,15117
2,28,6,2,2015,7,13547,1824,15371
2,28,6,2,2015,8,13990,1859,15849
2,28,6,2,2015,9,14232,1979,16211
2,28,6,2,2015,10,14423,2119,16542
2,28,6,2,2015,11,14321,2240,16561
2,28,6,2,2015,12,14447,2240,16687
2,28,6,2,2015,13,14305,2264,16569
2,28,6,2,2015,14,14108,2222,16330
2,28,6,2,2015,15,14183,2204,16387
2,28,6,2,2015,16,13957,2178,16135
2,28,6,2,2015,17,14012,2147,16159
2,28,6,2,2015,18,12664,2133,14797
2,28,6,2,2015,19,12507,2109,14616
2,28,6,2,2015,20,13626,2250,15876
2,28,6,2,2015,21,13513,2323,15836
2,28,6,2,2015,22,13454,2340,15794
2,28,6,2,2015,23,13481,2342,15823
2,28,6,2,2015,24,13596,2327,15923
1,29,6,2,2015,1,13477,2208,15685
1,29,6,2,2015,2,13343,2016,15359
1,29,6,2,2015,3,12797,1917,14714
1,29,6,2,2015,4,13119,1860,14979
1,29,6,2,2015,5,13227,1857,15084
1,29,6,2,2015,6,13827,1941,15768
1,29,6,2,2015,7,14219,2034,16253
1,29,6,2,2015,8,14632,2171,16803
1,29,6,2,2015,9,14956,2505,17461
1,29,6,2,2015,10,14806,2860,17666
1,29,6,2,2015,11,14948,3089,18037
1,29,6,2,2015,12,15126,3122,18248
1,29,6,2,2015,13,14758,3118,17876
1,29,6,2,2015,14,14859,3014,17873
1,29,6,2,2015,15,14979,3062,18041
1,29,6,2,2015,16,15546,3067,18613
1,29,6,2,2015,17,14574,3034,17608
1,29,6,2,2015,18,13664,2925,16589
1,29,6,2,2015,19,12907,2817,15724
1,29,6,2,2015,20,13837,2777,16614
1,29,6,2,2015,21,14225,2708,16933
1,29,6,2,2015,22,13755,2629,16384
1,29,6,2,2015,23,13705,2564,16269
1,29,6,2,2015,24,13696,2481,16177
1,30,6,2,2015,1,13669,2326,15995
1,30,6,2,2015,2,13660,2122,15782
1,30,6,2,2015,3,13417,2006,15423
1,30,6,2,2015,4,13405,1937,15342
1,30,6,2,2015,5,13379,1923,15302
1,30,6,2,2015,6,14249,1998,16247
1,30,6,2,2015,7,15024,2101,17125
1,30,6,2,2015,8,15312,2227,17539
1,30,6,2,2015,9,15452,2478,17930
1,30,6,2,2015,10,15279,2803,18082
1,30,6,2,2015,11,15513,3024,18537
1,30,6,2,2015,12,15376,3090,18466
1,30,6,2,2015,13,15192,3069,18261
1,30,6,2,2015,14,15193,2992,18185
1,30,6,2,2015,15,14997,3051,18048
1,30,6,2,2015,16,14698,3040,17738
1,30,6,2,2015,17,14578,3034,17612
1,30,6,2,2015,18,13607,2956,16563
1,30,6,2,2015,19,12982,2827,15809
1,30,6,2,2015,20,13526,2794,16320
1,30,6,2,2015,21,13795,2780,16575
1,30,6,2,2015,22,13958,2671,16629
1,30,6,2,2015,23,13577,2589,16166
1,30,6,2,2015,24,13406,2511,15917
1,1,7,3,2015,1,13780,2324,16104
1,1,7,3,2015,2,13378,2129,15507
1,1,7,3,2015,3,13193,1983,15176
1,1,7,3,2015,4,13571,1917,15488
1,1,7,3,2015,5,13185,1906,15091
1,1,7,3,2015,6,13981,1982,15963
1,1,7,3,2015,7,14951,2079,17030
1,1,7,3,2015,8,14826,2226,17052
1,1,7,3,2015,9,15158,2542,17700
1,1,7,3,2015,10,15280,2891,18171
1,1,7,3,2015,11,15039,3130,18169
1,1,7,3,2015,12,14854,3143,17997
1,1,7,3,2015,13,14957,3142,18099
1,1,7,3,2015,14,14810,3081,17891
1,1,7,3,2015,15,14875,3120,17995
1,1,7,3,2015,16,14882,3141,18023
1,1,7,3,2015,17,14429,3118,17547
1,1,7,3,2015,18,13088,3035,16123
1,1,7,3,2015,19,12419,2872,15291
1,1,7,3,2015,20,13250,2818,16068
1,1,7,3,2015,21,13812,2789,16601
1,1,7,3,2015,22,13486,2681,16167
1,1,7,3,2015,23,13393,2620,16013
1,1,7,3,2015,24,13492,2560,16052
1,2,7,3,2015,1,13766,2371,16137
1,2,7,3,2015,2,13293,2157,15450
1,2,7,3,2015,3,12986,2017,15003
1,2,7,3,2015,4,13168,1943,15111
1,2,7,3,2015,5,13332,1939,15271
1,2,7,3,2015,6,13833,2004,15837
1,2,7,3,2015,7,14618,2092,16710
1,2,7,3,2015,8,14884,2261,17145
1,2,7,3,2015,9,15063,2563,17626
1,2,7,3,2015,10,14701,2912,17613
1,2,7,3,2015,11,15114,3131,18245
1,2,7,3,2015,12,15174,3205,18379
1,2,7,3,2015,13,14745,3162,17907
1,2,7,3,2015,14,14797,3079,17876
1,2,7,3,2015,15,14865,3145,18010
1,2,7,3,2015,16,15018,3159,18177
1,2,7,3,2015,17,14635,3128,17763
1,2,7,3,2015,18,13279,3022,16301
1,2,7,3,2015,19,12834,2881,15715
1,2,7,3,2015,20,13615,2815,16430
1,2,7,3,2015,21,14172,2776,16948
1,2,7,3,2015,22,13632,2687,16319
1,2,7,3,2015,23,14057,2645,16702
1,2,7,3,2015,24,13906,2602,16508
1,3,7,3,2015,1,14059,2372,16431
1,3,7,3,2015,2,13946,2217,16163
1,3,7,3,2015,3,13904,2073,15977
1,3,7,3,2015,4,13741,1997,15738
1,3,7,3,2015,5,13913,1965,15878
1,3,7,3,2015,6,14121,2041,16162
1,3,7,3,2015,7,15240,2132,17372
1,3,7,3,2015,8,15112,2289,17401
1,3,7,3,2015,9,15033,2575,17608
1,3,7,3,2015,10,15141,2912,18053
1,3,7,3,2015,11,14982,3167,18149
1,3,7,3,2015,12,14687,3192,17879
1,3,7,3,2015,13,14707,3184,17891
1,3,7,3,2015,14,14515,3073,17588
1,3,7,3,2015,15,14875,3143,18018
1,3,7,3,2015,16,14462,3147,17609
1,3,7,3,2015,17,14330,3137,17467
1,3,7,3,2015,18,12708,3039,15747
1,3,7,3,2015,19,12318,2889,15207
1,3,7,3,2015,20,13586,2842,16428
1,3,7,3,2015,21,13955,2790,16745
1,3,7,3,2015,22,13635,2689,16324
1,3,7,3,2015,23,13475,2656,16131
1,3,7,3,2015,24,13918,2608,16526
2,4,7,3,2015,1,14024,2411,16435
2,4,7,3,2015,2,13685,2236,15921
2,4,7,3,2015,3,13811,2097,15908
2,4,7,3,2015,4,13891,2025,15916
2,4,7,3,2015,5,13771,1995,15766
2,4,7,3,2015,6,14400,2047,16447
2,4,7,3,2015,7,15030,2072,17102
2,4,7,3,2015,8,15305,2151,17456
2,4,7,3,2015,9,15080,2374,17454
2,4,7,3,2015,10,14996,2760,17756
2,4,7,3,2015,11,15239,2977,18216
2,4,7,3,2015,12,15100,3035,18135
2,4,7,3,2015,13,15275,3005,18280
2,4,7,3,2015,14,15161,2932,18093
2,4,7,3,2015,15,15264,2954,18218
2,4,7,3,2015,16,15263,2947,18210
2,4,7,3,2015,17,14715,2892,17607
2,4,7,3,2015,18,13582,2804,16386
2,4,7,3,2015,19,12916,2692,15608
2,4,7,3,2015,20,13756,2730,16486
2,4,7,3,2015,21,14155,2725,16880
2,4,7,3,2015,22,13631,2643,16274
2,4,7,3,2015,23,13849,2580,16429
2,4,7,3,2015,24,13919,2529,16448
2,5,7,3,2015,1,14539,2479,17018
2,5,7,3,2015,2,14191,2268,16459
2,5,7,3,2015,3,13943,2105,16048
2,5,7,3,2015,4,14035,2017,16052
2,5,7,3,2015,5,14206,1996,16202
2,5,7,3,2015,6,14252,2023,16275
2,5,7,3,2015,7,14987,2018,17005
2,5,7,3,2015,8,15375,1972,17347
2,5,7,3,2015,9,15185,2044,17229
2,5,7,3,2015,10,15326,2159,17485
2,5,7,3,2015,11,15054,2262,17316
2,5,7,3,2015,12,14897,2293,17190
2,5,7,3,2015,13,14653,2307,16960
2,5,7,3,2015,14,14692,2247,16939
2,5,7,3,2015,15,14745,2244,16989
2,5,7,3,2015,16,14550,2247,16797
2,5,7,3,2015,17,14701,2229,16930
2,5,7,3,2015,18,13092,2192,15284
2,5,7,3,2015,19,12342,2191,14533
2,5,7,3,2015,20,13195,2299,15494
2,5,7,3,2015,21,13591,2423,16014
2,5,7,3,2015,22,13882,2468,16350
2,5,7,3,2015,23,13568,2456,16024
2,5,7,3,2015,24,14073,2487,16560
1,6,7,3,2015,1,14031,2359,16390
1,6,7,3,2015,2,14033,2175,16208
1,6,7,3,2015,3,13697,2031,15728
1,6,7,3,2015,4,13749,1958,15707
1,6,7,3,2015,5,13826,1947,15773
1,6,7,3,2015,6,14141,2014,16155
1,6,7,3,2015,7,15092,2093,17185
1,6,7,3,2015,8,15566,2244,17810
1,6,7,3,2015,9,15562,2552,18114
1,6,7,3,2015,10,15245,2960,18205
1,6,7,3,2015,11,15106,3155,18261
1,6,7,3,2015,12,15321,3197,18518
1,6,7,3,2015,13,15023,3182,18205
1,6,7,3,2015,14,14540,3129,17669
1,6,7,3,2015,15,15068,3168,18236
1,6,7,3,2015,16,14724,3153,17877
1,6,7,3,2015,17,14604,3131,17735
1,6,7,3,2015,18,13118,3056,16174
1,6,7,3,2015,19,13071,2844,15915
1,6,7,3,2015,20,13871,2821,16692
1,6,7,3,2015,21,14147,2779,16926
1,6,7,3,2015,22,13787,2692,16479
1,6,7,3,2015,23,13979,2653,16632
1,6,7,3,2015,24,14275,2613,16888
1,7,7,3,2015,1,14293,2426,16719
1,7,7,3,2015,2,14016,2223,16239
1,7,7,3,2015,3,14103,2110,16213
1,7,7,3,2015,4,14016,2018,16034
1,7,7,3,2015,5,14181,2006,16187
1,7,7,3,2015,6,14685,2081,16766
1,7,7,3,2015,7,15228,2157,17385
1,7,7,3,2015,8,15932,2294,18226
1,7,7,3,2015,9,16158,2585,18743
1,7,7,3,2015,10,15878,2945,18823
1,7,7,3,2015,11,15856,3170,19026
1,7,7,3,2015,12,15913,3189,19102
1,7,7,3,2015,13,15178,3202,18380
1,7,7,3,2015,14,15271,3111,18382
1,7,7,3,2015,15,15190,3154,18344
1,7,7,3,2015,16,15370,3172,18542
1,7,7,3,2015,17,15092,3171,18263
1,7,7,3,2015,18,13641,3077,16718
1,7,7,3,2015,19,13335,2928,16263
1,7,7,3,2015,20,14247,2881,17128
1,7,7,3,2015,21,14696,2794,17490
1,7,7,3,2015,22,14255,2674,16929
1,7,7,3,2015,23,14133,2694,16827
1,7,7,3,2015,24,14282,2596,16878
1,8,7,3,2015,1,14579,2446,17025
1,8,7,3,2015,2,14034,2257,16291
1,8,7,3,2015,3,14333,2117,16450
1,8,7,3,2015,4,14098,2013,16111
1,8,7,3,2015,5,14261,2000,16261
1,8,7,3,2015,6,14700,2066,16766
1,8,7,3,2015,7,15344,2134,17478
1,8,7,3,2015,8,15826,2288,18114
1,8,7,3,2015,9,15936,2580,18516
1,8,7,3,2015,10,15693,2926,18619
1,8,7,3,2015,11,16108,3183,19291
1,8,7,3,2015,12,16104,3208,19312
1,8,7,3,2015,13,15681,3192,18873
1,8,7,3,2015,14,15157,3100,18257
1,8,7,3,2015,15,15467,3117,18584
1,8,7,3,2015,16,15351,3141,18492
1,8,7,3,2015,17,15209,3148,18357
1,8,7,3,2015,18,13833,3058,16891
1,8,7,3,2015,19,13163,2905,16068
1,8,7,3,2015,20,14200,2846,17046
1,8,7,3,2015,21,14781,2817,17598
1,8,7,3,2015,22,14040,2713,16753
1,8,7,3,2015,23,13937,2669,16606
1,8,7,3,2015,24,13913,2619,16532
1,9,7,3,2015,1,14430,2447,16877
1,9,7,3,2015,2,14096,2243,16339
1,9,7,3,2015,3,13734,2110,15844
1,9,7,3,2015,4,13771,2007,15778
1,9,7,3,2015,5,14041,2005,16046
1,9,7,3,2015,6,14551,2070,16621
1,9,7,3,2015,7,15143,2131,17274
1,9,7,3,2015,8,15567,2274,17841
1,9,7,3,2015,9,15512,2598,18110
1,9,7,3,2015,10,15637,2903,18540
1,9,7,3,2015,11,15623,3162,18785
1,9,7,3,2015,12,15118,3196,18314
1,9,7,3,2015,13,15408,3186,18594
1,9,7,3,2015,14,14738,3097,17835
1,9,7,3,2015,15,14739,3140,17879
1,9,7,3,2015,16,14757,3141,17898
1,9,7,3,2015,17,14276,3118,17394
1,9,7,3,2015,18,13523,3052,16575
1,9,7,3,2015,19,13206,2874,16080
1,9,7,3,2015,20,14075,2840,16915
1,9,7,3,2015,21,14151,2832,16983
1,9,7,3,2015,22,13761,2725,16486
1,9,7,3,2015,23,14047,2713,16760
1,9,7,3,2015,24,14204,2664,16868
1,10,7,3,2015,1,14285,2446,16731
1,10,7,3,2015,2,13934,2239,16173
1,10,7,3,2015,3,13826,2110,15936
1,10,7,3,2015,4,13892,2018,15910
1,10,7,3,2015,5,13889,1995,15884
1,10,7,3,2015,6,14323,2063,16386
1,10,7,3,2015,7,15440,2121,17561
1,10,7,3,2015,8,15251,2250,17501
1,10,7,3,2015,9,15432,2542,17974
1,10,7,3,2015,10,14926,2948,17874
1,10,7,3,2015,11,14829,3157,17986
1,10,7,3,2015,12,14743,3208,17951
1,10,7,3,2015,13,14746,3191,17937
1,10,7,3,2015,14,14748,3073,17821
1,10,7,3,2015,15,14974,3133,18107
1,10,7,3,2015,16,14371,3153,17524
1,10,7,3,2015,17,14258,3122,17380
1,10,7,3,2015,18,13247,3051,16298
1,10,7,3,2015,19,12563,2895,15458
1,10,7,3,2015,20,13417,2844,16261
1,10,7,3,2015,21,13722,2754,16476
1,10,7,3,2015,22,13587,2657,16244
1,10,7,3,2015,23,14020,2590,16610
1,10,7,3,2015,24,13328,2548,15876
2,11,7,3,2015,1,13517,2412,15929
2,11,7,3,2015,2,13684,2204,15888
2,11,7,3,2015,3,13646,2062,15708
2,11,7,3,2015,4,13316,2024,15340
2,11,7,3,2015,5,13275,1988,15263
2,11,7,3,2015,6,14158,2038,16196
2,11,7,3,2015,7,14771,2028,16799
2,11,7,3,2015,8,15106,2085,17191
2,11,7,3,2015,9,15246,2319,17565
2,11,7,3,2015,10,15178,2639,17817
2,11,7,3,2015,11,15332,2862,18194
2,11,7,3,2015,12,15368,2918,18286
2,11,7,3,2015,13,15069,2953,18022
2,11,7,3,2015,14,14887,2874,17761
2,11,7,3,2015,15,15050,2886,17936
2,11,7,3,2015,16,15099,2869,17968
2,11,7,3,2015,17,14901,2813,17714
2,11,7,3,2015,18,13897,2705,16602
2,11,7,3,2015,19,13792,2646,16438
2,11,7,3,2015,20,13939,2690,16629
2,11,7,3,2015,21,14403,2678,17081
2,11,7,3,2015,22,13946,2627,16573
2,11,7,3,2015,23,13947,2548,16495
2,11,7,3,2015,24,14161,2513,16674
2,12,7,3,2015,1,14784,2390,17174
2,12,7,3,2015,2,14267,2213,16480
2,12,7,3,2015,3,13910,2099,16009
2,12,7,3,2015,4,13933,2036,15969
2,12,7,3,2015,5,14037,2006,16043
2,12,7,3,2015,6,14763,2018,16781
2,12,7,3,2015,7,15392,1955,17347
2,12,7,3,2015,8,15609,1972,17581
2,12,7,3,2015,9,15574,2047,17621
2,12,7,3,2015,10,15839,2172,18011
2,12,7,3,2015,11,15401,2283,17684
2,12,7,3,2015,12,15874,2334,18208
2,12,7,3,2015,13,15743,2341,18084
2,12,7,3,2015,14,15064,2303,17367
2,12,7,3,2015,15,15657,2305,17962
2,12,7,3,2015,16,15774,2283,18057
2,12,7,3,2015,17,15123,2244,17367
2,12,7,3,2015,18,13992,2217,16209
2,12,7,3,2015,19,13261,2192,15453
2,12,7,3,2015,20,13644,2331,15975
2,12,7,3,2015,21,13989,2444,16433
2,12,7,3,2015,22,14000,2467,16467
2,12,7,3,2015,23,13950,2495,16445
2,12,7,3,2015,24,14264,2513,16777
1,13,7,3,2015,1,14560,2369,16929
1,13,7,3,2015,2,14417,2177,16594
1,13,7,3,2015,3,14187,2074,16261
1,13,7,3,2015,4,14118,2017,16135
1,13,7,3,2015,5,14011,1995,16006
1,13,7,3,2015,6,14898,2035,16933
1,13,7,3,2015,7,15495,2110,17605
1,13,7,3,2015,8,16152,2263,18415
1,13,7,3,2015,9,16019,2573,18592
1,13,7,3,2015,10,16365,2926,19291
1,13,7,3,2015,11,16765,3172,19937
1,13,7,3,2015,12,16743,3226,19969
1,13,7,3,2015,13,16906,3197,20103
1,13,7,3,2015,14,16331,3102,19433
1,13,7,3,2015,15,16582,3192,19774
1,13,7,3,2015,16,16332,3235,19567
1,13,7,3,2015,17,15849,3195,19044
1,13,7,3,2015,18,15261,3087,18348
1,13,7,3,2015,19,14304,2888,17192
1,13,7,3,2015,20,14347,2862,17209
1,13,7,3,2015,21,14886,2796,17682
1,13,7,3,2015,22,14525,2686,17211
1,13,7,3,2015,23,14480,2748,17228
1,13,7,3,2015,24,14779,2628,17407
1,14,7,3,2015,1,15052,2487,17539
1,14,7,3,2015,2,15287,2254,17541
1,14,7,3,2015,3,14415,2138,16553
1,14,7,3,2015,4,14468,2034,16502
1,14,7,3,2015,5,14695,2022,16717
1,14,7,3,2015,6,15482,2075,17557
1,14,7,3,2015,7,16161,2144,18305
1,14,7,3,2015,8,16759,2269,19028
1,14,7,3,2015,9,16309,2580,18889
1,14,7,3,2015,10,16918,2927,19845
1,14,7,3,2015,11,16952,3160,20112
1,14,7,3,2015,12,16891,3250,20141
1,14,7,3,2015,13,16663,3205,19868
1,14,7,3,2015,14,16673,3113,19786
1,14,7,3,2015,15,16572,3186,19758
1,14,7,3,2015,16,16953,3187,20140
1,14,7,3,2015,17,15988,3163,19151
1,14,7,3,2015,18,15558,3059,18617
1,14,7,3,2015,19,14717,2912,17629
1,14,7,3,2015,20,14760,2849,17609
1,14,7,3,2015,21,15177,2832,18009
1,14,7,3,2015,22,14723,2700,17423
1,14,7,3,2015,23,14470,2798,17268
1,14,7,3,2015,24,15076,2634,17710
1,15,7,3,2015,1,15121,2489,17610
1,15,7,3,2015,2,14940,2289,17229
1,15,7,3,2015,3,15357,2164,17521
1,15,7,3,2015,4,14856,2095,16951
1,15,7,3,2015,5,15251,2084,17335
1,15,7,3,2015,6,15265,2119,17384
1,15,7,3,2015,7,16074,2171,18245
1,15,7,3,2015,8,16483,2290,18773
1,15,7,3,2015,9,16719,2587,19306
1,15,7,3,2015,10,16532,2937,19469
1,15,7,3,2015,11,16442,3191,19633
1,15,7,3,2015,12,16690,3237,19927
1,15,7,3,2015,13,16683,3236,19919
1,15,7,3,2015,14,16127,3169,19296
1,15,7,3,2015,15,16525,3214,19739
1,15,7,3,2015,16,15971,3228,19199
1,15,7,3,2015,17,15893,3213,19106
1,15,7,3,2015,18,14601,3117,17718
1,15,7,3,2015,19,14691,2960,17651
1,15,7,3,2015,20,15111,2918,18029
1,15,7,3,2015,21,15107,2877,17984
1,15,7,3,2015,22,14684,2724,17408
1,15,7,3,2015,23,14852,2720,17572
1,15,7,3,2015,24,15077,2642,17719
1,16,7,3,2015,1,15074,2522,17596
1,16,7,3,2015,2,15206,2326,17532
1,16,7,3,2015,3,14801,2185,16986
1,16,7,3,2015,4,15166,2103,17269
1,16,7,3,2015,5,14238,2074,16312
1,16,7,3,2015,6,15118,2134,17252
1,16,7,3,2015,7,15816,2191,18007
1,16,7,3,2015,8,16208,2310,18518
1,16,7,3,2015,9,16301,2590,18891
1,16,7,3,2015,10,16244,2959,19203
1,16,7,3,2015,11,16327,3206,19533
1,16,7,3,2015,12,16461,3228,19689
1,16,7,3,2015,13,15697,3225,18922
1,16,7,3,2015,14,15618,3150,18768
1,16,7,3,2015,15,15935,3205,19140
1,16,7,3,2015,16,15911,3224,19135
1,16,7,3,2015,17,15587,3190,18777
1,16,7,3,2015,18,14469,3098,17567
1,16,7,3,2015,19,14254,2943,17197
1,16,7,3,2015,20,14342,2895,17237
1,16,7,3,2015,21,14920,2854,17774
1,16,7,3,2015,22,14427,2727,17154
1,16,7,3,2015,23,14593,2689,17282
1,16,7,3,2015,24,14706,2641,17347
1,17,7,3,2015,1,14852,2473,17325
1,17,7,3,2015,2,14686,2302,16988
1,17,7,3,2015,3,14628,2197,16825
1,17,7,3,2015,4,14710,2128,16838
1,17,7,3,2015,5,14873,2107,16980
1,17,7,3,2015,6,15332,2133,17465
1,17,7,3,2015,7,15766,2160,17926
1,17,7,3,2015,8,15988,2262,18250
1,17,7,3,2015,9,16059,2558,18617
1,17,7,3,2015,10,16070,2895,18965
1,17,7,3,2015,11,16118,3141,19259
1,17,7,3,2015,12,15734,3207,18941
1,17,7,3,2015,13,15492,3178,18670
1,17,7,3,2015,14,15262,3080,18342
1,17,7,3,2015,15,14940,3130,18070
1,17,7,3,2015,16,14986,3161,18147
1,17,7,3,2015,17,14984,3143,18127
1,17,7,3,2015,18,13842,3051,16893
1,17,7,3,2015,19,13498,2925,16423
1,17,7,3,2015,20,14091,2934,17025
1,17,7,3,2015,21,14267,2784,17051
1,17,7,3,2015,22,14088,2676,16764
1,17,7,3,2015,23,14127,2660,16787
1,17,7,3,2015,24,14296,2601,16897
3,18,7,3,2015,1,14257,2453,16710
3,18,7,3,2015,2,14150,2293,16443
3,18,7,3,2015,3,13823,2162,15985
3,18,7,3,2015,4,14040,2086,16126
3,18,7,3,2015,5,13857,2053,15910
3,18,7,3,2015,6,14598,2097,16695
3,18,7,3,2015,7,15348,2099,17447
3,18,7,3,2015,8,15627,2128,17755
3,18,7,3,2015,9,15826,2288,18114
3,18,7,3,2015,10,15784,2512,18296
3,18,7,3,2015,11,15742,2702,18444
3,18,7,3,2015,12,15526,2759,18285
3,18,7,3,2015,13,15183,2758,17941
3,18,7,3,2015,14,14936,2675,17611
3,18,7,3,2015,15,14923,2678,17601
3,18,7,3,2015,16,14873,2662,17535
3,18,7,3,2015,17,14444,2615,17059
3,18,7,3,2015,18,13666,2553,16219
3,18,7,3,2015,19,12844,2500,15344
3,18,7,3,2015,20,13413,2562,15975
3,18,7,3,2015,21,13825,2542,16367
3,18,7,3,2015,22,13542,2488,16030
3,18,7,3,2015,23,13501,2463,15964
3,18,7,3,2015,24,13290,2443,15733
2,19,7,3,2015,1,13770,2355,16125
2,19,7,3,2015,2,13416,2206,15622
2,19,7,3,2015,3,13203,2109,15312
2,19,7,3,2015,4,12940,2010,14950
2,19,7,3,2015,5,13132,1970,15102
2,19,7,3,2015,6,13358,1991,15349
2,19,7,3,2015,7,13831,1948,15779
2,19,7,3,2015,8,14278,1942,16220
2,19,7,3,2015,9,14448,2029,16477
2,19,7,3,2015,10,14017,2115,16132
2,19,7,3,2015,11,14176,2203,16379
2,19,7,3,2015,12,14114,2216,16330
2,19,7,3,2015,13,13925,2222,16147
2,19,7,3,2015,14,13159,2202,15361
2,19,7,3,2015,15,13425,2188,15613
2,19,7,3,2015,16,13061,2145,15206
2,19,7,3,2015,17,12821,2106,14927
2,19,7,3,2015,18,12191,2099,14290
2,19,7,3,2015,19,12165,2122,14287
2,19,7,3,2015,20,13179,2293,15472
2,19,7,3,2015,21,13459,2330,15789
2,19,7,3,2015,22,12867,2362,15229
2,19,7,3,2015,23,12895,2391,15286
2,19,7,3,2015,24,12871,2385,15256
1,20,7,3,2015,1,13152,2289,15441
1,20,7,3,2015,2,12972,2119,15091
1,20,7,3,2015,3,12942,2014,14956
1,20,7,3,2015,4,12303,1947,14250
1,20,7,3,2015,5,12629,1931,14560
1,20,7,3,2015,6,13047,1978,15025
1,20,7,3,2015,7,14138,2080,16218
1,20,7,3,2015,8,14118,2223,16341
1,20,7,3,2015,9,14276,2488,16764
1,20,7,3,2015,10,14183,2766,16949
1,20,7,3,2015,11,14053,3006,17059
1,20,7,3,2015,12,14025,3110,17135
1,20,7,3,2015,13,13371,3106,16477
1,20,7,3,2015,14,13580,3049,16629
1,20,7,3,2015,15,13186,3050,16236
1,20,7,3,2015,16,13432,3043,16475
1,20,7,3,2015,17,13191,3016,16207
1,20,7,3,2015,18,12857,2955,15812
1,20,7,3,2015,19,12524,2848,15372
1,20,7,3,2015,20,13125,2812,15937
1,20,7,3,2015,21,13378,2731,16109
1,20,7,3,2015,22,12969,2618,15587
1,20,7,3,2015,23,12879,2543,15422
1,20,7,3,2015,24,12484,2479,14963
1,21,7,3,2015,1,12560,2297,14857
1,21,7,3,2015,2,12340,2104,14444
1,21,7,3,2015,3,12070,1981,14051
1,21,7,3,2015,4,11783,1896,13679
1,21,7,3,2015,5,11974,1871,13845
1,21,7,3,2015,6,12565,1947,14512
1,21,7,3,2015,7,13258,2030,15288
1,21,7,3,2015,8,13725,2184,15909
1,21,7,3,2015,9,13601,2466,16067
1,21,7,3,2015,10,13635,2761,16396
1,21,7,3,2015,11,13789,2926,16715
1,21,7,3,2015,12,13787,2992,16779
1,21,7,3,2015,13,13354,2975,16329
1,21,7,3,2015,14,13158,2925,16083
1,21,7,3,2015,15,13197,2937,16134
1,21,7,3,2015,16,13149,2921,16070
1,21,7,3,2015,17,12787,2901,15688
1,21,7,3,2015,18,12987,2856,15843
1,21,7,3,2015,19,12706,2780,15486
1,21,7,3,2015,20,13501,2762,16263
1,21,7,3,2015,21,13237,2677,15914
1,21,7,3,2015,22,13105,2541,15646
1,21,7,3,2015,23,12797,2408,15205
1,21,7,3,2015,24,12860,2275,15135
1,22,7,3,2015,1,12862,2103,14965
1,22,7,3,2015,2,12491,1935,14426
1,22,7,3,2015,3,12350,1846,14196
1,22,7,3,2015,4,12334,1795,14129
1,22,7,3,2015,5,12488,1786,14274
1,22,7,3,2015,6,12885,1883,14768
1,22,7,3,2015,7,13698,2018,15716
1,22,7,3,2015,8,14100,2189,16289
1,22,7,3,2015,9,14408,2502,16910
1,22,7,3,2015,10,14092,2811,16903
1,22,7,3,2015,11,14073,3035,17108
1,22,7,3,2015,12,14003,3038,17041
1,22,7,3,2015,13,14138,3003,17141
1,22,7,3,2015,14,13654,2886,16540
1,22,7,3,2015,15,13795,2872,16667
1,22,7,3,2015,16,13785,2866,16651
1,22,7,3,2015,17,13701,2853,16554
1,22,7,3,2015,18,12703,2841,15544
1,22,7,3,2015,19,13024,2770,15794
1,22,7,3,2015,20,13450,2748,16198
1,22,7,3,2015,21,13821,2654,16475
1,22,7,3,2015,22,13313,2506,15819
1,22,7,3,2015,23,13067,2383,15450
1,22,7,3,2015,24,12869,2148,15017
1,23,7,3,2015,1,12745,2034,14779
1,23,7,3,2015,2,12662,1873,14535
1,23,7,3,2015,3,12724,1781,14505
1,23,7,3,2015,4,12466,1717,14183
1,23,7,3,2015,5,12567,1722,14289
1,23,7,3,2015,6,13227,1821,15048
1,23,7,3,2015,7,13952,1967,15919
1,23,7,3,2015,8,14320,2147,16467
1,23,7,3,2015,9,14397,2448,16845
1,23,7,3,2015,10,14623,2815,17438
1,23,7,3,2015,11,14221,3041,17262
1,23,7,3,2015,12,13871,3069,16940
1,23,7,3,2015,13,13733,2898,16631
1,23,7,3,2015,14,13362,2907,16269
1,23,7,3,2015,15,13578,2910,16488
1,23,7,3,2015,16,13311,2917,16228
1,23,7,3,2015,17,13541,2874,16415
1,23,7,3,2015,18,13092,2819,15911
1,23,7,3,2015,19,12902,2763,15665
1,23,7,3,2015,20,13774,2750,16524
1,23,7,3,2015,21,13700,2643,16343
1,23,7,3,2015,22,13343,2474,15817
1,23,7,3,2015,23,12832,2389,15221
1,23,7,3,2015,24,12716,2249,14965
1,24,7,3,2015,1,11950,2066,14016
1,24,7,3,2015,2,11692,1871,13563
1,24,7,3,2015,3,11390,1766,13156
1,24,7,3,2015,4,11334,1716,13050
1,24,7,3,2015,5,11682,1714,13396
1,24,7,3,2015,6,11810,1809,13619
1,24,7,3,2015,7,12769,1981,14750
1,24,7,3,2015,8,13606,2166,15772
1,24,7,3,2015,9,14340,2434,16774
1,24,7,3,2015,10,14046,2833,16879
1,24,7,3,2015,11,13797,3050,16847
1,24,7,3,2015,12,13928,3108,17036
1,24,7,3,2015,13,13421,3082,16503
1,24,7,3,2015,14,13410,2927,16337
1,24,7,3,2015,15,13439,2923,16362
1,24,7,3,2015,16,13031,2884,15915
1,24,7,3,2015,17,13078,2817,15895
1,24,7,3,2015,18,12416,2821,15237
1,24,7,3,2015,19,12452,2788,15240
1,24,7,3,2015,20,13044,2750,15794
1,24,7,3,2015,21,13054,2649,15703
1,24,7,3,2015,22,12665,2527,15192
1,24,7,3,2015,23,12529,2409,14938
1,24,7,3,2015,24,12372,2282,14654
2,25,7,3,2015,1,12274,2093,14367
2,25,7,3,2015,2,11523,1909,13432
2,25,7,3,2015,3,11330,1802,13132
2,25,7,3,2015,4,11655,1743,13398
2,25,7,3,2015,5,11471,1722,13193
2,25,7,3,2015,6,12142,1816,13958
2,25,7,3,2015,7,13056,1893,14949
2,25,7,3,2015,8,13390,2030,15420
2,25,7,3,2015,9,13512,2261,15773
2,25,7,3,2015,10,13883,2589,16472
2,25,7,3,2015,11,13388,2835,16223
2,25,7,3,2015,12,13439,2857,16296
2,25,7,3,2015,13,12942,2838,15780
2,25,7,3,2015,14,12506,2730,15236
2,25,7,3,2015,15,12743,2703,15446
2,25,7,3,2015,16,12611,2657,15268
2,25,7,3,2015,17,12485,2630,15115
2,25,7,3,2015,18,11929,2592,14521
2,25,7,3,2015,19,11995,2571,14566
2,25,7,3,2015,20,12996,2606,15602
2,25,7,3,2015,21,13129,2615,15744
2,25,7,3,2015,22,12727,2459,15186
2,25,7,3,2015,23,12599,2295,14894
2,25,7,3,2015,24,12631,2200,14831
2,26,7,3,2015,1,12451,2055,14506
2,26,7,3,2015,2,12123,1912,14035
2,26,7,3,2015,3,12055,1819,13874
2,26,7,3,2015,4,11732,1769,13501
2,26,7,3,2015,5,12016,1752,13768
2,26,7,3,2015,6,12405,1795,14200
2,26,7,3,2015,7,12878,1799,14677
2,26,7,3,2015,8,13422,1850,15272
2,26,7,3,2015,9,13662,1949,15611
2,26,7,3,2015,10,13811,2076,15887
2,26,7,3,2015,11,13595,2209,15804
2,26,7,3,2015,12,13610,2243,15853
2,26,7,3,2015,13,13049,2266,15315
2,26,7,3,2015,14,12369,2173,14542
2,26,7,3,2015,15,12487,2129,14616
2,26,7,3,2015,16,12496,2088,14584
2,26,7,3,2015,17,12137,2067,14204
2,26,7,3,2015,18,11375,2046,13421
2,26,7,3,2015,19,11886,2085,13971
2,26,7,3,2015,20,12796,2203,14999
2,26,7,3,2015,21,12715,2286,15001
2,26,7,3,2015,22,12353,2282,14635
2,26,7,3,2015,23,12365,2267,14632
2,26,7,3,2015,24,12138,2216,14354
1,27,7,3,2015,1,12423,2008,14431
1,27,7,3,2015,2,11900,1873,13773
1,27,7,3,2015,3,11832,1798,13630
1,27,7,3,2015,4,12003,1725,13728
1,27,7,3,2015,5,11969,1724,13693
1,27,7,3,2015,6,12785,1839,14624
1,27,7,3,2015,7,13305,1958,15263
1,27,7,3,2015,8,13739,2123,15862
1,27,7,3,2015,9,14013,2449,16462
1,27,7,3,2015,10,13792,2712,16504
1,27,7,3,2015,11,13774,2922,16696
1,27,7,3,2015,12,13389,2994,16383
1,27,7,3,2015,13,13132,2933,16065
1,27,7,3,2015,14,12765,2827,15592
1,27,7,3,2015,15,13012,2827,15839
1,27,7,3,2015,16,12958,2766,15724
1,27,7,3,2015,17,12596,2771,15367
1,27,7,3,2015,18,12012,2759,14771
1,27,7,3,2015,19,12249,2724,14973
1,27,7,3,2015,20,13073,2699,15772
1,27,7,3,2015,21,13077,2609,15686
1,27,7,3,2015,22,12762,2475,15237
1,27,7,3,2015,23,12432,2337,14769
1,27,7,3,2015,24,12320,2209,14529
1,28,7,3,2015,1,12215,2033,14248
1,28,7,3,2015,2,12184,1844,14028
1,28,7,3,2015,3,11898,1756,13654
1,28,7,3,2015,4,11755,1705,13460
1,28,7,3,2015,5,12020,1709,13729
1,28,7,3,2015,6,12842,1805,14647
1,28,7,3,2015,7,13215,1948,15163
1,28,7,3,2015,8,13619,2133,15752
1,28,7,3,2015,9,13648,2452,16100
1,28,7,3,2015,10,13610,2793,16403
1,28,7,3,2015,11,13266,2994,16260
1,28,7,3,2015,12,13467,3030,16497
1,28,7,3,2015,13,12819,2991,15810
1,28,7,3,2015,14,12736,2864,15600
1,28,7,3,2015,15,13009,2856,15865
1,28,7,3,2015,16,12699,2775,15474
1,28,7,3,2015,17,12751,2822,15573
1,28,7,3,2015,18,11916,2807,14723
1,28,7,3,2015,19,11988,2741,14729
1,28,7,3,2015,20,13108,2711,15819
1,28,7,3,2015,21,13200,2612,15812
1,28,7,3,2015,22,12873,2483,15356
1,28,7,3,2015,23,12778,2336,15114
1,28,7,3,2015,24,12321,2185,14506
1,29,7,3,2015,1,12431,1992,14423
1,29,7,3,2015,2,12199,1835,14034
1,29,7,3,2015,3,12388,1743,14131
1,29,7,3,2015,4,11919,1696,13615
1,29,7,3,2015,5,12258,1679,13937
1,29,7,3,2015,6,12820,1799,14619
1,29,7,3,2015,7,13377,1953,15330
1,29,7,3,2015,8,13929,2121,16050
1,29,7,3,2015,9,13766,2454,16220
1,29,7,3,2015,10,13855,2728,16583
1,29,7,3,2015,11,13748,2996,16744
1,29,7,3,2015,12,13392,3017,16409
1,29,7,3,2015,13,13086,3004,16090
1,29,7,3,2015,14,12968,2839,15807
1,29,7,3,2015,15,13039,2814,15853
1,29,7,3,2015,16,12915,2830,15745
1,29,7,3,2015,17,12894,2829,15723
1,29,7,3,2015,18,12083,2777,14860
1,29,7,3,2015,19,12287,2712,14999
1,29,7,3,2015,20,13394,2687,16081
1,29,7,3,2015,21,13260,2587,15847
1,29,7,3,2015,22,12954,2429,15383
1,29,7,3,2015,23,12682,2273,14955
1,29,7,3,2015,24,12437,2133,14570
1,30,7,3,2015,1,12632,1959,14591
1,30,7,3,2015,2,12536,1810,14346
1,30,7,3,2015,3,12032,1730,13762
1,30,7,3,2015,4,12166,1665,13831
1,30,7,3,2015,5,12307,1665,13972
1,30,7,3,2015,6,12766,1759,14525
1,30,7,3,2015,7,13574,1911,15485
1,30,7,3,2015,8,13759,2105,15864
1,30,7,3,2015,9,14080,2435,16515
1,30,7,3,2015,10,13910,2776,16686
1,30,7,3,2015,11,13682,2981,16663
1,30,7,3,2015,12,13502,2981,16483
1,30,7,3,2015,13,13381,2980,16361
1,30,7,3,2015,14,13022,2860,15882
1,30,7,3,2015,15,12809,2872,15681
1,30,7,3,2015,16,12980,2861,15841
1,30,7,3,2015,17,12941,2876,15817
1,30,7,3,2015,18,12165,2823,14988
1,30,7,3,2015,19,11960,2745,14705
1,30,7,3,2015,20,13482,2723,16205
1,30,7,3,2015,21,13820,2616,16436
1,30,7,3,2015,22,12973,2479,15452
1,30,7,3,2015,23,12866,2354,15220
1,30,7,3,2015,24,13136,2213,15349
1,31,7,3,2015,1,12742,2007,14749
1,31,7,3,2015,2,12565,1846,14411
1,31,7,3,2015,3,12673,1750,14423
1,31,7,3,2015,4,12353,1701,14054
1,31,7,3,2015,5,12373,1715,14088
1,31,7,3,2015,6,13087,1824,14911
1,31,7,3,2015,7,13640,1963,15603
1,31,7,3,2015,8,14293,2144,16437
1,31,7,3,2015,9,13992,2472,16464
1,31,7,3,2015,10,13792,2793,16585
1,31,7,3,2015,11,13423,3010,16433
1,31,7,3,2015,12,13592,3068,16660
1,31,7,3,2015,13,13180,3056,16236
1,31,7,3,2015,14,12639,2929,15568
1,31,7,3,2015,15,13020,2918,15938
1,31,7,3,2015,16,12969,2945,15914
1,31,7,3,2015,17,13024,2932,15956
1,31,7,3,2015,18,11940,2887,14827
1,31,7,3,2015,19,11686,2769,14455
1,31,7,3,2015,20,13083,2763,15846
1,31,7,3,2015,21,13072,2653,15725
1,31,7,3,2015,22,12562,2545,15107
1,31,7,3,2015,23,13034,2398,15432
1,31,7,3,2015,24,12350,2266,14616
2,1,8,3,2015,1,12493,2066,14559
2,1,8,3,2015,2,12512,1901,14413
2,1,8,3,2015,3,12367,1810,14177
2,1,8,3,2015,4,11973,1757,13730
2,1,8,3,2015,5,12209,1741,13950
2,1,8,3,2015,6,12879,1812,14691
2,1,8,3,2015,7,13052,1897,14949
2,1,8,3,2015,8,13827,2021,15848
2,1,8,3,2015,9,13995,2273,16268
2,1,8,3,2015,10,14012,2586,16598
2,1,8,3,2015,11,14271,2829,17100
2,1,8,3,2015,12,13936,2917,16853
2,1,8,3,2015,13,13931,2905,16836
2,1,8,3,2015,14,13453,2802,16255
2,1,8,3,2015,15,13604,2796,16400
2,1,8,3,2015,16,13440,2780,16220
2,1,8,3,2015,17,13577,2734,16311
2,1,8,3,2015,18,12466,2680,15146
2,1,8,3,2015,19,11876,2589,14465
2,1,8,3,2015,20,13394,2644,16038
2,1,8,3,2015,21,13652,2624,16276
2,1,8,3,2015,22,13310,2520,15830
2,1,8,3,2015,23,13430,2427,15857
2,1,8,3,2015,24,13117,2270,15387
2,2,8,3,2015,1,13301,2110,15411
2,2,8,3,2015,2,12993,1943,14936
2,2,8,3,2015,3,12642,1838,14480
2,2,8,3,2015,4,13103,1770,14873
2,2,8,3,2015,5,12720,1759,14479
2,2,8,3,2015,6,13153,1820,14973
2,2,8,3,2015,7,13697,1810,15507
2,2,8,3,2015,8,14383,1845,16228
2,2,8,3,2015,9,14409,1957,16366
2,2,8,3,2015,10,14525,2106,16631
2,2,8,3,2015,11,14739,2224,16963
2,2,8,3,2015,12,14489,2253,16742
2,2,8,3,2015,13,14352,2252,16604
2,2,8,3,2015,14,13862,2218,16080
2,2,8,3,2015,15,14146,2180,16326
2,2,8,3,2015,16,13681,2144,15825
2,2,8,3,2015,17,13330,2118,15448
2,2,8,3,2015,18,12203,2101,14304
2,2,8,3,2015,19,12076,2126,14202
2,2,8,3,2015,20,13199,2251,15450
2,2,8,3,2015,21,13041,2341,15382
2,2,8,3,2015,22,12947,2365,15312
2,2,8,3,2015,23,12813,2323,15136
2,2,8,3,2015,24,13007,2268,15275
1,3,8,3,2015,1,13149,2126,15275
1,3,8,3,2015,2,12884,1949,14833
1,3,8,3,2015,3,12966,1842,14808
1,3,8,3,2015,4,12933,1779,14712
1,3,8,3,2015,5,12793,1771,14564
1,3,8,3,2015,6,13375,1878,15253
1,3,8,3,2015,7,14054,2028,16082
1,3,8,3,2015,8,14699,2197,16896
1,3,8,3,2015,9,14885,2493,17378
1,3,8,3,2015,10,14838,2849,17687
1,3,8,3,2015,11,14665,3088,17753
1,3,8,3,2015,12,15209,3111,18320
1,3,8,3,2015,13,14555,3055,17610
1,3,8,3,2015,14,14357,2940,17297
1,3,8,3,2015,15,14079,2941,17020
1,3,8,3,2015,16,14104,2959,17063
1,3,8,3,2015,17,13721,2957,16678
1,3,8,3,2015,18,13365,2909,16274
1,3,8,3,2015,19,12648,2818,15466
1,3,8,3,2015,20,13241,2798,16039
1,3,8,3,2015,21,13694,2721,16415
1,3,8,3,2015,22,13103,2615,15718
1,3,8,3,2015,23,13137,2477,15614
1,3,8,3,2015,24,12878,2369,15247
1,4,8,3,2015,1,13103,2181,15284
1,4,8,3,2015,2,12767,1985,14752
1,4,8,3,2015,3,12513,1862,14375
1,4,8,3,2015,4,12497,1792,14289
1,4,8,3,2015,5,12485,1788,14273
1,4,8,3,2015,6,13422,1905,15327
1,4,8,3,2015,7,13917,2046,15963
1,4,8,3,2015,8,14888,2215,17103
1,4,8,3,2015,9,14603,2523,17126
1,4,8,3,2015,10,14526,2858,17384
1,4,8,3,2015,11,14417,3094,17511
1,4,8,3,2015,12,13426,3117,16543
1,4,8,3,2015,13,13184,3084,16268
1,4,8,3,2015,14,13080,2956,16036
1,4,8,3,2015,15,12339,2995,15334
1,4,8,3,2015,16,12489,2983,15472
1,4,8,3,2015,17,12434,2963,15397
1,4,8,3,2015,18,11602,2910,14512
1,4,8,3,2015,19,12422,2846,15268
1,4,8,3,2015,20,12633,2800,15433
1,4,8,3,2015,21,12689,2692,15381
1,4,8,3,2015,22,12272,2559,14831
1,4,8,3,2015,23,11894,2451,14345
1,4,8,3,2015,24,11503,2318,13821
1,5,8,3,2015,1,11404,2132,13536
1,5,8,3,2015,2,10969,1962,12931
1,5,8,3,2015,3,10997,1867,12864
1,5,8,3,2015,4,10806,1815,12621
1,5,8,3,2015,5,10857,1801,12658
1,5,8,3,2015,6,11129,1902,13031
1,5,8,3,2015,7,11749,2031,13780
1,5,8,3,2015,8,12356,2199,14555
1,5,8,3,2015,9,12624,2451,15075
1,5,8,3,2015,10,12915,2857,15772
1,5,8,3,2015,11,12808,3068,15876
1,5,8,3,2015,12,12798,3074,15872
1,5,8,3,2015,13,12085,3022,15107
1,5,8,3,2015,14,12008,2901,14909
1,5,8,3,2015,15,11694,2913,14607
1,5,8,3,2015,16,12082,2917,14999
1,5,8,3,2015,17,11948,2911,14859
1,5,8,3,2015,18,11581,2883,14464
1,5,8,3,2015,19,12299,2806,15105
1,5,8,3,2015,20,12618,2788,15406
1,5,8,3,2015,21,12622,2703,15325
1,5,8,3,2015,22,12000,2571,14571
1,5,8,3,2015,23,11854,2444,14298
1,5,8,3,2015,24,11505,2310,13815
1,6,8,3,2015,1,11634,2112,13746
1,6,8,3,2015,2,11230,1934,13164
1,6,8,3,2015,3,11233,1850,13083
1,6,8,3,2015,4,11006,1787,12793
1,6,8,3,2015,5,11144,1792,12936
1,6,8,3,2015,6,11540,1893,13433
1,6,8,3,2015,7,12318,2033,14351
1,6,8,3,2015,8,12744,2211,14955
1,6,8,3,2015,9,12892,2478,15370
1,6,8,3,2015,10,13085,2854,15939
1,6,8,3,2015,11,12926,3025,15951
1,6,8,3,2015,12,12333,3089,15422
1,6,8,3,2015,13,12131,3062,15193
1,6,8,3,2015,14,11495,2957,14452
1,6,8,3,2015,15,11830,2989,14819
1,6,8,3,2015,16,11469,2981,14450
1,6,8,3,2015,17,11380,2961,14341
1,6,8,3,2015,18,11218,2898,14116
1,6,8,3,2015,19,11825,2808,14633
1,6,8,3,2015,20,12577,2800,15377
1,6,8,3,2015,21,12645,2734,15379
1,6,8,3,2015,22,12318,2598,14916
1,6,8,3,2015,23,12374,2477,14851
1,6,8,3,2015,24,11930,2362,14292
1,7,8,3,2015,1,11869,2143,14012
1,7,8,3,2015,2,11727,1956,13683
1,7,8,3,2015,3,11721,1847,13568
1,7,8,3,2015,4,11573,1783,13356
1,7,8,3,2015,5,11588,1779,13367
1,7,8,3,2015,6,12295,1872,14167
1,7,8,3,2015,7,12879,2083,14962
1,7,8,3,2015,8,13538,2225,15763
1,7,8,3,2015,9,14224,2523,16747
1,7,8,3,2015,10,13585,2892,16477
1,7,8,3,2015,11,13569,3096,16665
1,7,8,3,2015,12,12872,3146,16018
1,7,8,3,2015,13,12562,3135,15697
1,7,8,3,2015,14,12088,3003,15091
1,7,8,3,2015,15,12507,3049,15556
1,7,8,3,2015,16,12411,3046,15457
1,7,8,3,2015,17,11641,3004,14645
1,7,8,3,2015,18,11259,2946,14205
1,7,8,3,2015,19,11579,2859,14438
1,7,8,3,2015,20,13039,2841,15880
1,7,8,3,2015,21,13061,2767,15828
1,7,8,3,2015,22,12704,2656,15360
1,7,8,3,2015,23,12629,2465,15094
1,7,8,3,2015,24,12541,2335,14876
2,8,8,3,2015,1,12177,2170,14347
2,8,8,3,2015,2,12075,1996,14071
2,8,8,3,2015,3,12126,1881,14007
2,8,8,3,2015,4,12202,1809,14011
2,8,8,3,2015,5,12267,1804,14071
2,8,8,3,2015,6,12824,1891,14715
2,8,8,3,2015,7,13542,1970,15512
2,8,8,3,2015,8,13621,2090,15711
2,8,8,3,2015,9,14220,2320,16540
2,8,8,3,2015,10,13792,2617,16409
2,8,8,3,2015,11,13788,2818,16606
2,8,8,3,2015,12,13661,2841,16502
2,8,8,3,2015,13,13560,2835,16395
2,8,8,3,2015,14,13172,2712,15884
2,8,8,3,2015,15,13243,2674,15917
2,8,8,3,2015,16,13442,2635,16077
2,8,8,3,2015,17,13107,2633,15740
2,8,8,3,2015,18,12337,2615,14952
2,8,8,3,2015,19,12535,2590,15125
2,8,8,3,2015,20,13779,2647,16426
2,8,8,3,2015,21,13472,2595,16067
2,8,8,3,2015,22,12814,2477,15291
2,8,8,3,2015,23,13012,2301,15313
2,8,8,3,2015,24,13158,2222,15380
2,9,8,3,2015,1,12568,2062,14630
2,9,8,3,2015,2,12635,1893,14528
2,9,8,3,2015,3,12462,1792,14254
2,9,8,3,2015,4,12422,1735,14157
2,9,8,3,2015,5,12552,1724,14276
2,9,8,3,2015,6,12968,1776,14744
2,9,8,3,2015,7,13280,1803,15083
2,9,8,3,2015,8,13976,1850,15826
2,9,8,3,2015,9,13776,1972,15748
2,9,8,3,2015,10,14208,2111,16319
2,9,8,3,2015,11,13977,2232,16209
2,9,8,3,2015,12,14162,2235,16397
2,9,8,3,2015,13,14110,2242,16352
2,9,8,3,2015,14,13180,2171,15351
2,9,8,3,2015,15,13401,2108,15509
2,9,8,3,2015,16,13406,2058,15464
2,9,8,3,2015,17,13001,2043,15044
2,9,8,3,2015,18,11637,2045,13682
2,9,8,3,2015,19,11644,2087,13731
2,9,8,3,2015,20,13263,2246,15509
2,9,8,3,2015,21,13305,2313,15618
2,9,8,3,2015,22,12582,2306,14888
2,9,8,3,2015,23,12627,2273,14900
2,9,8,3,2015,24,13053,2162,15215
1,10,8,3,2015,1,12728,2011,14739
1,10,8,3,2015,2,12431,1838,14269
1,10,8,3,2015,3,12579,1727,14306
1,10,8,3,2015,4,12144,1669,13813
1,10,8,3,2015,5,12447,1672,14119
1,10,8,3,2015,6,13083,1791,14874
1,10,8,3,2015,7,14004,1951,15955
1,10,8,3,2015,8,14180,2152,16332
1,10,8,3,2015,9,14537,2439,16976
1,10,8,3,2015,10,14674,2756,17430
1,10,8,3,2015,11,14596,2989,17585
1,10,8,3,2015,12,14562,2991,17553
1,10,8,3,2015,13,14644,2987,17631
1,10,8,3,2015,14,14051,2869,16920
1,10,8,3,2015,15,14021,2861,16882
1,10,8,3,2015,16,13639,2856,16495
1,10,8,3,2015,17,13780,2850,16630
1,10,8,3,2015,18,12741,2809,15550
1,10,8,3,2015,19,12766,2743,15509
1,10,8,3,2015,20,13693,2715,16408
1,10,8,3,2015,21,13615,2626,16241
1,10,8,3,2015,22,12996,2485,15481
1,10,8,3,2015,23,13308,2341,15649
1,10,8,3,2015,24,12881,2174,15055
1,11,8,3,2015,1,13107,1983,15090
1,11,8,3,2015,2,12942,1813,14755
1,11,8,3,2015,3,12790,1733,14523
1,11,8,3,2015,4,12385,1678,14063
1,11,8,3,2015,5,12458,1675,14133
1,11,8,3,2015,6,12991,1789,14780
1,11,8,3,2015,7,13990,1956,15946
1,11,8,3,2015,8,14630,2141,16771
1,11,8,3,2015,9,14164,2437,16601
1,11,8,3,2015,10,14728,2771,17499
1,11,8,3,2015,11,14197,3006,17203
1,11,8,3,2015,12,14229,3035,17264
1,11,8,3,2015,13,14046,3010,17056
1,11,8,3,2015,14,13880,2860,16740
1,11,8,3,2015,15,13681,2916,16597
1,11,8,3,2015,16,13593,2927,16520
1,11,8,3,2015,17,13147,2908,16055
1,11,8,3,2015,18,12453,2835,15288
1,11,8,3,2015,19,12763,2753,15516
1,11,8,3,2015,20,13529,2778,16307
1,11,8,3,2015,21,13358,2671,16029
1,11,8,3,2015,22,12689,2501,15190
1,11,8,3,2015,23,12941,2386,15327
1,11,8,3,2015,24,12511,2282,14793
1,12,8,3,2015,1,12463,1986,14449
1,12,8,3,2015,2,12377,1820,14197
1,12,8,3,2015,3,12171,1727,13898
1,12,8,3,2015,4,12278,1687,13965
1,12,8,3,2015,5,12476,1690,14166
1,12,8,3,2015,6,12947,1787,14734
1,12,8,3,2015,7,13287,1959,15246
1,12,8,3,2015,8,13852,2133,15985
1,12,8,3,2015,9,13558,2434,15992
1,12,8,3,2015,10,14147,2776,16923
1,12,8,3,2015,11,13908,2995,16903
1,12,8,3,2015,12,13774,3056,16830
1,12,8,3,2015,13,13265,3041,16306
1,12,8,3,2015,14,12717,2853,15570
1,12,8,3,2015,15,13253,2849,16102
1,12,8,3,2015,16,13154,2882,16036
1,12,8,3,2015,17,13594,2890,16484
1,12,8,3,2015,18,12106,2858,14964
1,12,8,3,2015,19,12706,2797,15503
1,12,8,3,2015,20,13721,2806,16527
1,12,8,3,2015,21,13094,2660,15754
1,12,8,3,2015,22,12637,2581,15218
1,12,8,3,2015,23,12620,2420,15040
1,12,8,3,2015,24,12447,2216,14663
1,13,8,3,2015,1,12456,2063,14519
1,13,8,3,2015,2,12340,1885,14225
1,13,8,3,2015,3,12218,1783,14001
1,13,8,3,2015,4,12111,1721,13832
1,13,8,3,2015,5,11923,1735,13658
1,13,8,3,2015,6,12631,1832,14463
1,13,8,3,2015,7,13429,1972,15401
1,13,8,3,2015,8,13895,2144,16039
1,13,8,3,2015,9,13979,2455,16434
1,13,8,3,2015,10,13896,2817,16713
1,13,8,3,2015,11,13971,3057,17028
1,13,8,3,2015,12,13795,3083,16878
1,13,8,3,2015,13,13249,3074,16323
1,13,8,3,2015,14,12890,2918,15808
1,13,8,3,2015,15,12891,2883,15774
1,13,8,3,2015,16,13027,2891,15918
1,13,8,3,2015,17,12703,2891,15594
1,13,8,3,2015,18,11964,2861,14825
1,13,8,3,2015,19,12285,2770,15055
1,13,8,3,2015,20,13461,2797,16258
1,13,8,3,2015,21,13410,2684,16094
1,13,8,3,2015,22,13033,2597,15630
1,13,8,3,2015,23,12604,2439,15043
1,13,8,3,2015,24,13017,2231,15248
1,14,8,3,2015,1,12488,2071,14559
1,14,8,3,2015,2,12342,1904,14246
1,14,8,3,2015,3,12167,1809,13976
1,14,8,3,2015,4,12197,1754,13951
1,14,8,3,2015,5,12100,1753,13853
1,14,8,3,2015,6,12554,1862,14416
1,14,8,3,2015,7,13688,2013,15701
1,14,8,3,2015,8,14123,2192,16315
1,14,8,3,2015,9,14132,2496,16628
1,14,8,3,2015,10,13823,2837,16660
1,14,8,3,2015,11,13668,3090,16758
1,14,8,3,2015,12,13469,3133,16602
1,14,8,3,2015,13,12919,3121,16040
1,14,8,3,2015,14,12856,2934,15790
1,14,8,3,2015,15,12487,2980,15467
1,14,8,3,2015,16,12721,2982,15703
1,14,8,3,2015,17,12137,2962,15099
1,14,8,3,2015,18,11591,2876,14467
1,14,8,3,2015,19,11603,2778,14381
1,14,8,3,2015,20,13248,2793,16041
1,14,8,3,2015,21,12926,2690,15616
1,14,8,3,2015,22,12642,2560,15202
1,14,8,3,2015,23,12438,2433,14871
1,14,8,3,2015,24,12589,2299,14888
3,15,8,3,2015,1,12412,2121,14533
3,15,8,3,2015,2,12044,1929,13973
3,15,8,3,2015,3,12140,1833,13973
3,15,8,3,2015,4,12280,1767,14047
3,15,8,3,2015,5,12276,1758,14034
3,15,8,3,2015,6,13047,1832,14879
3,15,8,3,2015,7,12863,1877,14740
3,15,8,3,2015,8,12683,1927,14610
3,15,8,3,2015,9,12770,1992,14762
3,15,8,3,2015,10,12429,2078,14507
3,15,8,3,2015,11,12763,2174,14937
3,15,8,3,2015,12,12083,2179,14262
3,15,8,3,2015,13,12289,2214,14503
3,15,8,3,2015,14,11690,2144,13834
3,15,8,3,2015,15,11531,2112,13643
3,15,8,3,2015,16,11476,2110,13586
3,15,8,3,2015,17,11135,2094,13229
3,15,8,3,2015,18,10052,2103,12155
3,15,8,3,2015,19,10482,2145,12627
3,15,8,3,2015,20,11695,2307,14002
3,15,8,3,2015,21,11811,2328,14139
3,15,8,3,2015,22,11488,2295,13783
3,15,8,3,2015,23,11546,2208,13754
3,15,8,3,2015,24,11505,2153,13658
2,16,8,3,2015,1,11426,2036,13462
2,16,8,3,2015,2,11019,1883,12902
2,16,8,3,2015,3,11278,1799,13077
2,16,8,3,2015,4,11272,1736,13008
2,16,8,3,2015,5,11577,1715,13292
2,16,8,3,2015,6,11760,1783,13543
2,16,8,3,2015,7,12401,1806,14207
2,16,8,3,2015,8,13282,1879,15161
2,16,8,3,2015,9,13834,2009,15843
2,16,8,3,2015,10,14099,2151,16250
2,16,8,3,2015,11,13605,2269,15874
2,16,8,3,2015,12,13685,2284,15969
2,16,8,3,2015,13,13827,2273,16100
2,16,8,3,2015,14,13168,2214,15382
2,16,8,3,2015,15,13466,2188,15654
2,16,8,3,2015,16,13214,2149,15363
2,16,8,3,2015,17,13048,2122,15170
2,16,8,3,2015,18,11929,2127,14056
2,16,8,3,2015,19,11754,2179,13933
2,16,8,3,2015,20,13063,2314,15377
2,16,8,3,2015,21,13204,2339,15543
2,16,8,3,2015,22,12178,2328,14506
2,16,8,3,2015,23,12357,2273,14630
2,16,8,3,2015,24,12657,2194,14851
1,17,8,3,2015,1,12489,2054,14543
1,17,8,3,2015,2,12216,1885,14101
1,17,8,3,2015,3,12070,1800,13870
1,17,8,3,2015,4,12028,1750,13778
1,17,8,3,2015,5,12142,1748,13890
1,17,8,3,2015,6,12631,1854,14485
1,17,8,3,2015,7,13478,2034,15512
1,17,8,3,2015,8,14001,2220,16221
1,17,8,3,2015,9,14214,2526,16740
1,17,8,3,2015,10,14531,2881,17412
1,17,8,3,2015,11,14470,2979,17449
1,17,8,3,2015,12,14620,3059,17679
1,17,8,3,2015,13,14365,3035,17400
1,17,8,3,2015,14,14230,2924,17154
1,17,8,3,2015,15,13938,2946,16884
1,17,8,3,2015,16,14205,2961,17166
1,17,8,3,2015,17,13688,2952,16640
1,17,8,3,2015,18,12762,2896,15658
1,17,8,3,2015,19,12672,2792,15464
1,17,8,3,2015,20,14124,2785,16909
1,17,8,3,2015,21,13575,2666,16241
1,17,8,3,2015,22,13363,2515,15878
1,17,8,3,2015,23,13269,2433,15702
1,17,8,3,2015,24,13003,2345,15348
3,18,8,3,2015,1,13147,2115,15262
3,18,8,3,2015,2,13028,1935,14963
3,18,8,3,2015,3,12916,1832,14748
3,18,8,3,2015,4,13023,1771,14794
3,18,8,3,2015,5,12868,1766,14634
3,18,8,3,2015,6,13110,1845,14955
3,18,8,3,2015,7,13674,1931,15605
3,18,8,3,2015,8,14588,2095,16683
3,18,8,3,2015,9,14675,2379,17054
3,18,8,3,2015,10,14925,2793,17718
3,18,8,3,2015,11,15082,3012,18094
3,18,8,3,2015,12,14874,3027,17901
3,18,8,3,2015,13,14910,2995,17905
3,18,8,3,2015,14,14258,2854,17112
3,18,8,3,2015,15,14637,2868,17505
3,18,8,3,2015,16,14410,2877,17287
3,18,8,3,2015,17,14304,2862,17166
3,18,8,3,2015,18,12944,2827,15771
3,18,8,3,2015,19,12954,2736,15690
3,18,8,3,2015,20,14245,2793,17038
3,18,8,3,2015,21,13769,2689,16458
3,18,8,3,2015,22,13435,2588,16023
3,18,8,3,2015,23,13427,2469,15896
3,18,8,3,2015,24,13385,2380,15765
1,19,8,3,2015,1,13877,2165,16042
1,19,8,3,2015,2,13491,1991,15482
1,19,8,3,2015,3,12889,1887,14776
1,19,8,3,2015,4,13391,1830,15221
1,19,8,3,2015,5,12930,1819,14749
1,19,8,3,2015,6,13795,1920,15715
1,19,8,3,2015,7,14221,2054,16275
1,19,8,3,2015,8,14745,2210,16955
1,19,8,3,2015,9,14830,2496,17326
1,19,8,3,2015,10,14827,2852,17679
1,19,8,3,2015,11,15290,3043,18333
1,19,8,3,2015,12,15182,3123,18305
1,19,8,3,2015,13,14904,3121,18025
1,19,8,3,2015,14,14335,3024,17359
1,19,8,3,2015,15,14583,3061,17644
1,19,8,3,2015,16,14482,3089,17571
1,19,8,3,2015,17,13962,3084,17046
1,19,8,3,2015,18,13187,3014,16201
1,19,8,3,2015,19,12800,2877,15677
1,19,8,3,2015,20,14047,2880,16927
1,19,8,3,2015,21,13560,2804,16364
1,19,8,3,2015,22,13218,2681,15899
1,19,8,3,2015,23,13427,2577,16004
1,19,8,3,2015,24,13099,2460,15559
1,20,8,3,2015,1,13256,2256,15512
1,20,8,3,2015,2,13332,2066,15398
1,20,8,3,2015,3,12987,1959,14946
1,20,8,3,2015,4,12979,1888,14867
1,20,8,3,2015,5,13089,1867,14956
1,20,8,3,2015,6,13536,1964,15500
1,20,8,3,2015,7,13697,2094,15791
1,20,8,3,2015,8,14127,2261,16388
1,20,8,3,2015,9,14784,2585,17369
1,20,8,3,2015,10,14846,2884,17730
1,20,8,3,2015,11,15004,3162,18166
1,20,8,3,2015,12,15193,3184,18377
1,20,8,3,2015,13,15149,3161,18310
1,20,8,3,2015,14,14554,3030,17584
1,20,8,3,2015,15,14611,3091,17702
1,20,8,3,2015,16,14619,3093,17712
1,20,8,3,2015,17,14222,3072,17294
1,20,8,3,2015,18,13001,3009,16010
1,20,8,3,2015,19,12951,2903,15854
1,20,8,3,2015,20,14050,2883,16933
1,20,8,3,2015,21,13908,2781,16689
1,20,8,3,2015,22,13339,2645,15984
1,20,8,3,2015,23,12956,2555,15511
1,20,8,3,2015,24,13822,2436,16258
1,21,8,3,2015,1,13848,2259,16107
1,21,8,3,2015,2,13354,2063,15417
1,21,8,3,2015,3,13720,1963,15683
1,21,8,3,2015,4,13267,1889,15156
1,21,8,3,2015,5,13468,1876,15344
1,21,8,3,2015,6,14169,1953,16122
1,21,8,3,2015,7,14365,2085,16450
1,21,8,3,2015,8,14762,2237,16999
1,21,8,3,2015,9,14801,2599,17400
1,21,8,3,2015,10,14707,2905,17612
1,21,8,3,2015,11,15325,3133,18458
1,21,8,3,2015,12,14343,3198,17541
1,21,8,3,2015,13,14791,3192,17983
1,21,8,3,2015,14,13932,3049,16981
1,21,8,3,2015,15,14344,3092,17436
1,21,8,3,2015,16,14488,3108,17596
1,21,8,3,2015,17,13875,3090,16965
1,21,8,3,2015,18,12707,3010,15717
1,21,8,3,2015,19,12560,2884,15444
1,21,8,3,2015,20,13839,2891,16730
1,21,8,3,2015,21,13743,2767,16510
1,21,8,3,2015,22,13275,2665,15940
1,21,8,3,2015,23,13578,2497,16075
1,21,8,3,2015,24,13145,2477,15622
2,22,8,3,2015,1,13621,2283,15904
2,22,8,3,2015,2,13184,2082,15266
2,22,8,3,2015,3,13361,1978,15339
2,22,8,3,2015,4,12944,1896,14840
2,22,8,3,2015,5,13198,1877,15075
2,22,8,3,2015,6,13675,1949,15624
2,22,8,3,2015,7,14039,2007,16046
2,22,8,3,2015,8,14620,2127,16747
2,22,8,3,2015,9,14548,2365,16913
2,22,8,3,2015,10,14698,2621,17319
2,22,8,3,2015,11,14586,2900,17486
2,22,8,3,2015,12,14982,2953,17935
2,22,8,3,2015,13,14531,2952,17483
2,22,8,3,2015,14,14362,2819,17181
2,22,8,3,2015,15,14656,2815,17471
2,22,8,3,2015,16,14697,2805,17502
2,22,8,3,2015,17,14153,2782,16935
2,22,8,3,2015,18,12889,2719,15608
2,22,8,3,2015,19,12573,2680,15253
2,22,8,3,2015,20,14145,2743,16888
2,22,8,3,2015,21,14009,2668,16677
2,22,8,3,2015,22,13625,2587,16212
2,22,8,3,2015,23,13321,2450,15771
2,22,8,3,2015,24,13658,2369,16027
2,23,8,3,2015,1,13676,2257,15933
2,23,8,3,2015,2,13465,2092,15557
2,23,8,3,2015,3,13355,1978,15333
2,23,8,3,2015,4,13325,1896,15221
2,23,8,3,2015,5,13346,1862,15208
2,23,8,3,2015,6,13693,1909,15602
2,23,8,3,2015,7,14194,1906,16100
2,23,8,3,2015,8,14655,1953,16608
2,23,8,3,2015,9,14976,2027,17003
2,23,8,3,2015,10,14993,2197,17190
2,23,8,3,2015,11,15087,2322,17409
2,23,8,3,2015,12,15473,2326,17799
2,23,8,3,2015,13,14972,2322,17294
2,23,8,3,2015,14,14791,2263,17054
2,23,8,3,2015,15,14651,2205,16856
2,23,8,3,2015,16,14856,2212,17068
2,23,8,3,2015,17,14329,2187,16516
2,23,8,3,2015,18,12838,2158,14996
2,23,8,3,2015,19,12474,2176,14650
2,23,8,3,2015,20,13718,2323,16041
2,23,8,3,2015,21,13691,2374,16065
2,23,8,3,2015,22,13335,2373,15708
2,23,8,3,2015,23,13324,2365,15689
2,23,8,3,2015,24,13676,2337,16013
1,24,8,3,2015,1,13551,2194,15745
1,24,8,3,2015,2,13463,2004,15467
1,24,8,3,2015,3,13133,1888,15021
1,24,8,3,2015,4,13044,1822,14866
1,24,8,3,2015,5,13152,1799,14951
1,24,8,3,2015,6,13934,1912,15846
1,24,8,3,2015,7,15072,2056,17128
1,24,8,3,2015,8,15210,2233,17443
1,24,8,3,2015,9,15526,2482,18008
1,24,8,3,2015,10,15364,2906,18270
1,24,8,3,2015,11,15807,3142,18949
1,24,8,3,2015,12,15690,3168,18858
1,24,8,3,2015,13,15772,3159,18931
1,24,8,3,2015,14,15384,3037,18421
1,24,8,3,2015,15,15554,3081,18635
1,24,8,3,2015,16,15294,3084,18378
1,24,8,3,2015,17,14887,3054,17941
1,24,8,3,2015,18,13794,2979,16773
1,24,8,3,2015,19,13441,2878,16319
1,24,8,3,2015,20,14443,2874,17317
1,24,8,3,2015,21,14270,2729,16999
1,24,8,3,2015,22,14251,2602,16853
1,24,8,3,2015,23,13873,2491,16364
1,24,8,3,2015,24,13494,2412,15906
1,25,8,3,2015,1,14126,2223,16349
1,25,8,3,2015,2,13638,2026,15664
1,25,8,3,2015,3,13748,1917,15665
1,25,8,3,2015,4,14081,1857,15938
1,25,8,3,2015,5,13534,1843,15377
1,25,8,3,2015,6,14046,1933,15979
1,25,8,3,2015,7,15192,2065,17257
1,25,8,3,2015,8,15583,2211,17794
1,25,8,3,2015,9,15634,2564,18198
1,25,8,3,2015,10,15437,2871,18308
1,25,8,3,2015,11,15748,3079,18827
1,25,8,3,2015,12,15579,3085,18664
1,25,8,3,2015,13,14971,3071,18042
1,25,8,3,2015,14,14649,2928,17577
1,25,8,3,2015,15,14901,2959,17860
1,25,8,3,2015,16,14640,2941,17581
1,25,8,3,2015,17,14523,2938,17461
1,25,8,3,2015,18,13510,2896,16406
1,25,8,3,2015,19,13721,2829,16550
1,25,8,3,2015,20,14342,2799,17141
1,25,8,3,2015,21,14057,2688,16745
1,25,8,3,2015,22,14133,2566,16699
1,25,8,3,2015,23,13636,2405,16041
1,25,8,3,2015,24,13537,2288,15825
1,26,8,3,2015,1,13846,2081,15927
1,26,8,3,2015,2,13655,1930,15585
1,26,8,3,2015,3,13574,1840,15414
1,26,8,3,2015,4,13392,1782,15174
1,26,8,3,2015,5,13491,1770,15261
1,26,8,3,2015,6,14149,1886,16035
1,26,8,3,2015,7,15082,2035,17117
1,26,8,3,2015,8,15325,2180,17505
1,26,8,3,2015,9,15776,2545,18321
1,26,8,3,2015,10,15751,2877,18628
1,26,8,3,2015,11,15797,3118,18915
1,26,8,3,2015,12,15846,3136,18982
1,26,8,3,2015,13,15247,3120,18367
1,26,8,3,2015,14,15395,2989,18384
1,26,8,3,2015,15,15035,3025,18060
1,26,8,3,2015,16,15366,3032,18398
1,26,8,3,2015,17,14996,3021,18017
1,26,8,3,2015,18,13737,2950,16687
1,26,8,3,2015,19,13416,2821,16237
1,26,8,3,2015,20,14760,2848,17608
1,26,8,3,2015,21,14301,2842,17143
1,26,8,3,2015,22,13774,2633,16407
1,26,8,3,2015,23,14084,2512,16596
1,26,8,3,2015,24,13812,2420,16232
1,27,8,3,2015,1,14197,2228,16425
1,27,8,3,2015,2,13942,2027,15969
1,27,8,3,2015,3,14108,1909,16017
1,27,8,3,2015,4,13967,1845,15812
1,27,8,3,2015,5,14079,1823,15902
1,27,8,3,2015,6,14652,1918,16570
1,27,8,3,2015,7,14793,2047,16840
1,27,8,3,2015,8,15275,2249,17524
1,27,8,3,2015,9,15727,2528,18255
1,27,8,3,2015,10,16019,2875,18894
1,27,8,3,2015,11,15649,3118,18767
1,27,8,3,2015,12,15469,3145,18614
1,27,8,3,2015,13,15291,3076,18367
1,27,8,3,2015,14,15331,3010,18341
1,27,8,3,2015,15,14902,3048,17950
1,27,8,3,2015,16,15116,3068,18184
1,27,8,3,2015,17,14550,3020,17570
1,27,8,3,2015,18,13469,3004,16473
1,27,8,3,2015,19,13300,2836,16136
1,27,8,3,2015,20,14436,2898,17334
1,27,8,3,2015,21,14434,2773,17207
1,27,8,3,2015,22,13940,2666,16606
1,27,8,3,2015,23,13867,2513,16380
1,27,8,3,2015,24,13906,2370,16276
1,28,8,3,2015,1,14088,2245,16333
1,28,8,3,2015,2,14036,2035,16071
1,28,8,3,2015,3,13634,1916,15550
1,28,8,3,2015,4,13420,1856,15276
1,28,8,3,2015,5,13606,1834,15440
1,28,8,3,2015,6,14183,1924,16107
1,28,8,3,2015,7,14686,2052,16738
1,28,8,3,2015,8,15303,2215,17518
1,28,8,3,2015,9,15291,2520,17811
1,28,8,3,2015,10,15389,2803,18192
1,28,8,3,2015,11,14916,3051,17967
1,28,8,3,2015,12,15001,3084,18085
1,28,8,3,2015,13,14595,3056,17651
1,28,8,3,2015,14,14202,2892,17094
1,28,8,3,2015,15,14334,2902,17236
1,28,8,3,2015,16,14141,2922,17063
1,28,8,3,2015,17,13699,2906,16605
1,28,8,3,2015,18,12557,2858,15415
1,28,8,3,2015,19,13099,2793,15892
1,28,8,3,2015,20,13676,2790,16466
1,28,8,3,2015,21,13478,2687,16165
1,28,8,3,2015,22,13223,2556,15779
1,28,8,3,2015,23,12957,2429,15386
1,28,8,3,2015,24,13295,2321,15616
2,29,8,3,2015,1,13215,2135,15350
2,29,8,3,2015,2,13050,2036,15086
2,29,8,3,2015,3,13036,1953,14989
2,29,8,3,2015,4,12986,1885,14871
2,29,8,3,2015,5,12927,1857,14784
2,29,8,3,2015,6,13341,1922,15263
2,29,8,3,2015,7,14302,1885,16187
2,29,8,3,2015,8,14764,1995,16759
2,29,8,3,2015,9,14836,2230,17066
2,29,8,3,2015,10,14452,2492,16944
2,29,8,3,2015,11,14733,2713,17446
2,29,8,3,2015,12,14623,2746,17369
2,29,8,3,2015,13,14610,2704,17314
2,29,8,3,2015,14,14170,2566,16736
2,29,8,3,2015,15,14234,2516,16750
2,29,8,3,2015,16,14147,2473,16620
2,29,8,3,2015,17,13855,2482,16337
2,29,8,3,2015,18,12479,2437,14916
2,29,8,3,2015,19,12601,2415,15016
2,29,8,3,2015,20,13313,2536,15849
2,29,8,3,2015,21,13240,2522,15762
2,29,8,3,2015,22,12722,2464,15186
2,29,8,3,2015,23,12892,2387,15279
2,29,8,3,2015,24,13073,2304,15377
2,30,8,3,2015,1,13083,2068,15151
2,30,8,3,2015,2,12868,1894,14762
2,30,8,3,2015,3,12994,1795,14789
2,30,8,3,2015,4,12880,1732,14612
2,30,8,3,2015,5,12942,1715,14657
2,30,8,3,2015,6,13244,1766,15010
2,30,8,3,2015,7,13430,1763,15193
2,30,8,3,2015,8,14270,1808,16078
2,30,8,3,2015,9,14443,1913,16356
2,30,8,3,2015,10,14796,2058,16854
2,30,8,3,2015,11,14763,2179,16942
2,30,8,3,2015,12,15210,2196,17406
2,30,8,3,2015,13,14480,2209,16689
2,30,8,3,2015,14,14417,2137,16554
2,30,8,3,2015,15,14421,2088,16509
2,30,8,3,2015,16,14074,2058,16132
2,30,8,3,2015,17,13382,2030,15412
2,30,8,3,2015,18,12415,1999,14414
2,30,8,3,2015,19,12462,2051,14513
2,30,8,3,2015,20,13718,2215,15933
2,30,8,3,2015,21,13096,2257,15353
2,30,8,3,2015,22,12812,2246,15058
2,30,8,3,2015,23,12694,2179,14873
2,30,8,3,2015,24,13032,2093,15125
1,31,8,3,2015,1,12894,1939,14833
1,31,8,3,2015,2,13054,1770,14824
1,31,8,3,2015,3,12958,1684,14642
1,31,8,3,2015,4,13161,1639,14800
1,31,8,3,2015,5,12965,1632,14597
1,31,8,3,2015,6,13667,1752,15419
1,31,8,3,2015,7,14180,1924,16104
1,31,8,3,2015,8,14839,2111,16950
1,31,8,3,2015,9,15255,2421,17676
1,31,8,3,2015,10,15271,2805,18076
1,31,8,3,2015,11,14913,3001,17914
1,31,8,3,2015,12,15171,3043,18214
1,31,8,3,2015,13,14951,3042,17993
1,31,8,3,2015,14,14764,2915,17679
1,31,8,3,2015,15,14779,2935,17714
1,31,8,3,2015,16,14802,2948,17750
1,31,8,3,2015,17,14196,2931,17127
1,31,8,3,2015,18,13067,2883,15950
1,31,8,3,2015,19,13310,2764,16074
1,31,8,3,2015,20,14539,2771,17310
1,31,8,3,2015,21,13962,2665,16627
1,31,8,3,2015,22,13713,2548,16261
1,31,8,3,2015,23,13318,2405,15723
1,31,8,3,2015,24,13699,2286,15985
1,1,9,3,2015,1,13567,2092,15659
1,1,9,3,2015,2,13444,1910,15354
1,1,9,3,2015,3,13099,1800,14899
1,1,9,3,2015,4,13073,1747,14820
1,1,9,3,2015,5,13448,1729,15177
1,1,9,3,2015,6,13856,1837,15693
1,1,9,3,2015,7,14969,1987,16956
1,1,9,3,2015,8,15113,2157,17270
1,1,9,3,2015,9,15099,2407,17506
1,1,9,3,2015,10,15455,2808,18263
1,1,9,3,2015,11,15523,3033,18556
1,1,9,3,2015,12,15243,3071,18314
1,1,9,3,2015,13,15553,3037,18590
1,1,9,3,2015,14,15181,2945,18126
1,1,9,3,2015,15,15076,2960,18036
1,1,9,3,2015,16,15329,2982,18311
1,1,9,3,2015,17,14850,2964,17814
1,1,9,3,2015,18,13569,2893,16462
1,1,9,3,2015,19,13463,2792,16255
1,1,9,3,2015,20,14692,2798,17490
1,1,9,3,2015,21,14562,2690,17252
1,1,9,3,2015,22,13659,2514,16173
1,1,9,3,2015,23,13641,2443,16084
1,1,9,3,2015,24,13851,2357,16208
1,2,9,3,2015,1,13827,2122,15949
1,2,9,3,2015,2,13806,1918,15724
1,2,9,3,2015,3,13897,1816,15713
1,2,9,3,2015,4,13843,1741,15584
1,2,9,3,2015,5,13658,1716,15374
1,2,9,3,2015,6,14283,1831,16114
1,2,9,3,2015,7,15018,1980,16998
1,2,9,3,2015,8,15305,2135,17440
1,2,9,3,2015,9,15499,2424,17923
1,2,9,3,2015,10,15704,2757,18461
1,2,9,3,2015,11,15642,2971,18613
1,2,9,3,2015,12,15954,2994,18948
1,2,9,3,2015,13,15381,2991,18372
1,2,9,3,2015,14,15286,2900,18186
1,2,9,3,2015,15,15366,2945,18311
1,2,9,3,2015,16,15441,2953,18394
1,2,9,3,2015,17,15025,2947,17972
1,2,9,3,2015,18,13809,2892,16701
1,2,9,3,2015,19,13403,2803,16206
1,2,9,3,2015,20,14653,2821,17474
1,2,9,3,2015,21,14063,2701,16764
1,2,9,3,2015,22,13592,2592,16184
1,2,9,3,2015,23,13771,2435,16206
1,2,9,3,2015,24,13935,2306,16241
1,3,9,3,2015,1,13962,2113,16075
1,3,9,3,2015,2,13935,1933,15868
1,3,9,3,2015,3,13215,1834,15049
1,3,9,3,2015,4,13787,1766,15553
1,3,9,3,2015,5,13529,1740,15269
1,3,9,3,2015,6,13967,1837,15804
1,3,9,3,2015,7,15069,1985,17054
1,3,9,3,2015,8,15023,2148,17171
1,3,9,3,2015,9,15711,2480,18191
1,3,9,3,2015,10,16155,2802,18957
1,3,9,3,2015,11,16283,2984,19267
1,3,9,3,2015,12,16082,3040,19122
1,3,9,3,2015,13,15759,3014,18773
1,3,9,3,2015,14,15544,2909,18453
1,3,9,3,2015,15,15657,2960,18617
1,3,9,3,2015,16,15833,2987,18820
1,3,9,3,2015,17,15264,2965,18229
1,3,9,3,2015,18,14005,2904,16909
1,3,9,3,2015,19,13942,2790,16732
1,3,9,3,2015,20,15317,2817,18134
1,3,9,3,2015,21,14939,2715,17654
1,3,9,3,2015,22,14154,2561,16715
1,3,9,3,2015,23,14113,2453,16566
1,3,9,3,2015,24,14246,2365,16611
1,4,9,3,2015,1,14377,2165,16542
1,4,9,3,2015,2,14063,1964,16027
1,4,9,3,2015,3,14042,1856,15898
1,4,9,3,2015,4,14165,1799,15964
1,4,9,3,2015,5,14157,1789,15946
1,4,9,3,2015,6,14468,1871,16339
1,4,9,3,2015,7,15453,1993,17446
1,4,9,3,2015,8,15549,2171,17720
1,4,9,3,2015,9,15598,2461,18059
1,4,9,3,2015,10,15652,2778,18430
1,4,9,3,2015,11,15559,2994,18553
1,4,9,3,2015,12,15363,3046,18409
1,4,9,3,2015,13,15087,3045,18132
1,4,9,3,2015,14,15043,2913,17956
1,4,9,3,2015,15,14832,2958,17790
1,4,9,3,2015,16,15062,2982,18044
1,4,9,3,2015,17,14610,2965,17575
1,4,9,3,2015,18,13486,2910,16396
1,4,9,3,2015,19,13458,2783,16241
1,4,9,3,2015,20,14588,2831,17419
1,4,9,3,2015,21,14201,2711,16912
1,4,9,3,2015,22,13934,2564,16498
1,4,9,3,2015,23,13919,2447,16366
1,4,9,3,2015,24,13653,2366,16019
2,5,9,3,2015,1,14034,2189,16223
2,5,9,3,2015,2,14011,1997,16008
2,5,9,3,2015,3,14288,1889,16177
2,5,9,3,2015,4,13902,1817,15719
2,5,9,3,2015,5,14011,1795,15806
2,5,9,3,2015,6,14316,1876,16192
2,5,9,3,2015,7,15043,1932,16975
2,5,9,3,2015,8,15623,2057,17680
2,5,9,3,2015,9,15426,2310,17736
2,5,9,3,2015,10,15822,2628,18450
2,5,9,3,2015,11,15912,2884,18796
2,5,9,3,2015,12,16280,2892,19172
2,5,9,3,2015,13,15881,2892,18773
2,5,9,3,2015,14,16162,2779,18941
2,5,9,3,2015,15,16067,2795,18862
2,5,9,3,2015,16,16241,2802,19043
2,5,9,3,2015,17,15609,2769,18378
2,5,9,3,2015,18,14137,2678,16815
2,5,9,3,2015,19,14414,2629,17043
2,5,9,3,2015,20,14897,2769,17666
2,5,9,3,2015,21,14463,2641,17104
2,5,9,3,2015,22,14203,2516,16719
2,5,9,3,2015,23,14337,2427,16764
2,5,9,3,2015,24,14522,2341,16863
2,6,9,3,2015,1,14631,2169,16800
2,6,9,3,2015,2,14441,2093,16534
2,6,9,3,2015,3,14396,1964,16360
2,6,9,3,2015,4,14119,1870,15989
2,6,9,3,2015,5,13904,1830,15734
2,6,9,3,2015,6,14344,1876,16220
2,6,9,3,2015,7,14442,1868,16310
2,6,9,3,2015,8,14953,1911,16864
2,6,9,3,2015,9,15715,2008,17723
2,6,9,3,2015,10,15724,2109,17833
2,6,9,3,2015,11,15522,2165,17687
2,6,9,3,2015,12,15891,2167,18058
2,6,9,3,2015,13,15642,2184,17826
2,6,9,3,2015,14,15302,2146,17448
2,6,9,3,2015,15,15179,2116,17295
2,6,9,3,2015,16,15030,2086,17116
2,6,9,3,2015,17,14053,2055,16108
2,6,9,3,2015,18,13124,2037,15161
2,6,9,3,2015,19,12981,2059,15040
2,6,9,3,2015,20,13964,2296,16260
2,6,9,3,2015,21,13835,2337,16172
2,6,9,3,2015,22,13493,2332,15825
2,6,9,3,2015,23,13658,2333,15991
2,6,9,3,2015,24,13571,2312,15883
1,7,9,3,2015,1,14283,2144,16427
1,7,9,3,2015,2,14249,1947,16196
1,7,9,3,2015,3,13664,1823,15487
1,7,9,3,2015,4,13425,1774,15199
1,7,9,3,2015,5,13792,1776,15568
1,7,9,3,2015,6,14114,1852,15966
1,7,9,3,2015,7,14848,2004,16852
1,7,9,3,2015,8,15330,2167,17497
1,7,9,3,2015,9,15473,2493,17966
1,7,9,3,2015,10,15754,2871,18625
1,7,9,3,2015,11,15782,3033,18815
1,7,9,3,2015,12,16332,3087,19419
1,7,9,3,2015,13,15645,3085,18730
1,7,9,3,2015,14,15419,2957,18376
1,7,9,3,2015,15,15437,2979,18416
1,7,9,3,2015,16,15079,3001,18080
1,7,9,3,2015,17,15214,3001,18215
1,7,9,3,2015,18,13474,2923,16397
1,7,9,3,2015,19,14229,2821,17050
1,7,9,3,2015,20,15102,2849,17951
1,7,9,3,2015,21,14190,2742,16932
1,7,9,3,2015,22,14019,2579,16598
1,7,9,3,2015,23,13955,2473,16428
1,7,9,3,2015,24,13889,2437,16326
1,8,9,3,2015,1,14280,2209,16489
1,8,9,3,2015,2,13958,2009,15967
1,8,9,3,2015,3,13715,1854,15569
1,8,9,3,2015,4,13449,1774,15223
1,8,9,3,2015,5,13410,1777,15187
1,8,9,3,2015,6,13984,1850,15834
1,8,9,3,2015,7,14820,2034,16854
1,8,9,3,2015,8,15065,2234,17299
1,8,9,3,2015,9,15042,2485,17527
1,8,9,3,2015,10,15437,2876,18313
1,8,9,3,2015,11,15301,3080,18381
1,8,9,3,2015,12,15532,3111,18643
1,8,9,3,2015,13,15087,3102,18189
1,8,9,3,2015,14,14999,2993,17992
1,8,9,3,2015,15,14915,3034,17949
1,8,9,3,2015,16,15063,3051,18114
1,8,9,3,2015,17,14543,3035,17578
1,8,9,3,2015,18,13791,2975,16766
1,8,9,3,2015,19,13907,2841,16748
1,8,9,3,2015,20,14895,2879,17774
1,8,9,3,2015,21,14064,2719,16783
1,8,9,3,2015,22,13977,2654,16631
1,8,9,3,2015,23,13854,2575,16429
1,8,9,3,2015,24,13698,2466,16164
1,9,9,3,2015,1,13695,2303,15998
1,9,9,3,2015,2,13597,2076,15673
1,9,9,3,2015,3,13649,1967,15616
1,9,9,3,2015,4,13581,1888,15469
1,9,9,3,2015,5,13533,1873,15406
1,9,9,3,2015,6,13863,1967,15830
1,9,9,3,2015,7,14319,2084,16403
1,9,9,3,2015,8,14803,2211,17014
1,9,9,3,2015,9,15025,2515,17540
1,9,9,3,2015,10,15058,2849,17907
1,9,9,3,2015,11,15138,3084,18222
1,9,9,3,2015,12,15105,3103,18208
1,9,9,3,2015,13,14922,3094,18016
1,9,9,3,2015,14,13874,2961,16835
1,9,9,3,2015,15,14083,3020,17103
1,9,9,3,2015,16,13930,3049,16979
1,9,9,3,2015,17,13524,3029,16553
1,9,9,3,2015,18,13339,2963,16302
1,9,9,3,2015,19,13493,2904,16397
1,9,9,3,2015,20,14497,2916,17413
1,9,9,3,2015,21,13729,2707,16436
1,9,9,3,2015,22,13291,2644,15935
1,9,9,3,2015,23,13466,2642,16108
1,9,9,3,2015,24,13122,2438,15560
1,10,9,3,2015,1,13038,2244,15282
1,10,9,3,2015,2,12800,2050,14850
1,10,9,3,2015,3,12824,1927,14751
1,10,9,3,2015,4,12904,1852,14756
1,10,9,3,2015,5,12746,1822,14568
1,10,9,3,2015,6,13055,1920,14975
1,10,9,3,2015,7,13579,2034,15613
1,10,9,3,2015,8,13538,2185,15723
1,10,9,3,2015,9,13843,2501,16344
1,10,9,3,2015,10,14026,2836,16862
1,10,9,3,2015,11,14070,3048,17118
1,10,9,3,2015,12,13938,3086,17024
1,10,9,3,2015,13,13717,3073,16790
1,10,9,3,2015,14,13189,2965,16154
1,10,9,3,2015,15,13709,2946,16655
1,10,9,3,2015,16,13582,2962,16544
1,10,9,3,2015,17,13524,3000,16524
1,10,9,3,2015,18,13070,2978,16048
1,10,9,3,2015,19,13640,2922,16562
1,10,9,3,2015,20,14538,2877,17415
1,10,9,3,2015,21,14217,2754,16971
1,10,9,3,2015,22,13806,2581,16387
1,10,9,3,2015,23,13376,2568,15944
1,10,9,3,2015,24,13297,2318,15615
1,11,9,3,2015,1,12998,2163,15161
1,11,9,3,2015,2,12705,1971,14676
1,11,9,3,2015,3,12563,1862,14425
1,11,9,3,2015,4,12345,1795,14140
1,11,9,3,2015,5,12817,1791,14608
1,11,9,3,2015,6,13249,1892,15141
1,11,9,3,2015,7,13838,2045,15883
1,11,9,3,2015,8,14002,2185,16187
1,11,9,3,2015,9,13870,2490,16360
1,11,9,3,2015,10,13934,2889,16823
1,11,9,3,2015,11,13870,3064,16934
1,11,9,3,2015,12,13779,3116,16895
1,11,9,3,2015,13,13406,3103,16509
1,11,9,3,2015,14,13129,3059,16188
1,11,9,3,2015,15,12925,3076,16001
1,11,9,3,2015,16,12861,3085,15946
1,11,9,3,2015,17,13098,3082,16180
1,11,9,3,2015,18,12623,3007,15630
1,11,9,3,2015,19,13411,2942,16353
1,11,9,3,2015,20,14084,2970,17054
1,11,9,3,2015,21,13936,2859,16795
1,11,9,3,2015,22,13412,2704,16116
1,11,9,3,2015,23,13315,2647,15962
1,11,9,3,2015,24,12610,2502,15112
2,12,9,3,2015,1,12808,2284,15092
2,12,9,3,2015,2,12719,2073,14792
2,12,9,3,2015,3,12390,1930,14320
2,12,9,3,2015,4,12284,1876,14160
2,12,9,3,2015,5,12590,1856,14446
2,12,9,3,2015,6,12986,1906,14892
2,12,9,3,2015,7,12861,1961,14822
2,12,9,3,2015,8,13149,2076,15225
2,12,9,3,2015,9,13592,2299,15891
2,12,9,3,2015,10,13928,2587,16515
2,12,9,3,2015,11,14127,2816,16943
2,12,9,3,2015,12,14302,2879,17181
2,12,9,3,2015,13,14492,2872,17364
2,12,9,3,2015,14,14305,2788,17093
2,12,9,3,2015,15,14021,2825,16846
2,12,9,3,2015,16,13431,2818,16249
2,12,9,3,2015,17,12507,2779,15286
2,12,9,3,2015,18,12200,2756,14956
2,12,9,3,2015,19,12629,2774,15403
2,12,9,3,2015,20,13256,2805,16061
2,12,9,3,2015,21,13297,2645,15942
2,12,9,3,2015,22,13080,2535,15615
2,12,9,3,2015,23,12466,2446,14912
2,12,9,3,2015,24,12376,2332,14708
2,13,9,3,2015,1,12513,2196,14709
2,13,9,3,2015,2,12208,2026,14234
2,13,9,3,2015,3,11868,1910,13778
2,13,9,3,2015,4,11640,1829,13469
2,13,9,3,2015,5,11660,1802,13462
2,13,9,3,2015,6,12079,1850,13929
2,13,9,3,2015,7,12230,1858,14088
2,13,9,3,2015,8,12672,1889,14561
2,13,9,3,2015,9,12826,1995,14821
2,13,9,3,2015,10,12820,2124,14944
2,13,9,3,2015,11,13068,2248,15316
2,13,9,3,2015,12,13185,2313,15498
2,13,9,3,2015,13,13034,2310,15344
2,13,9,3,2015,14,12986,2258,15244
2,13,9,3,2015,15,13003,2213,15216
2,13,9,3,2015,16,13053,2172,15225
2,13,9,3,2015,17,12622,2136,14758
2,13,9,3,2015,18,12246,2134,14380
2,13,9,3,2015,19,13010,2220,15230
2,13,9,3,2015,20,13409,2362,15771
2,13,9,3,2015,21,13268,2384,15652
2,13,9,3,2015,22,12779,2380,15159
2,13,9,3,2015,23,12757,2254,15011
2,13,9,3,2015,24,12521,2333,14854
1,14,9,3,2015,1,12180,2126,14306
1,14,9,3,2015,2,12177,1948,14125
1,14,9,3,2015,3,11840,1844,13684
1,14,9,3,2015,4,11751,1785,13536
1,14,9,3,2015,5,11878,1774,13652
1,14,9,3,2015,6,12483,1865,14348
1,14,9,3,2015,7,13178,2003,15181
1,14,9,3,2015,8,13561,2159,15720
1,14,9,3,2015,9,13677,2484,16161
1,14,9,3,2015,10,13754,2826,16580
1,14,9,3,2015,11,14150,3047,17197
1,14,9,3,2015,12,13899,3098,16997
1,14,9,3,2015,13,13389,3089,16478
1,14,9,3,2015,14,13665,3000,16665
1,14,9,3,2015,15,13368,3043,16411
1,14,9,3,2015,16,12781,3033,15814
1,14,9,3,2015,17,12705,2992,15697
1,14,9,3,2015,18,12709,2940,15649
1,14,9,3,2015,19,12997,2925,15922
1,14,9,3,2015,20,13957,2848,16805
1,14,9,3,2015,21,13565,2761,16326
1,14,9,3,2015,22,13163,2619,15782
1,14,9,3,2015,23,12853,2533,15386
1,14,9,3,2015,24,12150,2425,14575
1,15,9,3,2015,1,12293,2223,14516
1,15,9,3,2015,2,12033,2030,14063
1,15,9,3,2015,3,12180,1921,14101
1,15,9,3,2015,4,11898,1833,13731
1,15,9,3,2015,5,11842,1794,13636
1,15,9,3,2015,6,12068,1895,13963
1,15,9,3,2015,7,12538,2021,14559
1,15,9,3,2015,8,13339,2183,15522
1,15,9,3,2015,9,13311,2473,15784
1,15,9,3,2015,10,13455,2795,16250
1,15,9,3,2015,11,13511,3053,16564
1,15,9,3,2015,12,13545,3092,16637
1,15,9,3,2015,13,13528,3061,16589
1,15,9,3,2015,14,13439,2953,16392
1,15,9,3,2015,15,13635,2977,16612
1,15,9,3,2015,16,13174,2983,16157
1,15,9,3,2015,17,12906,2963,15869
1,15,9,3,2015,18,12822,2911,15733
1,15,9,3,2015,19,13157,2852,16009
1,15,9,3,2015,20,13714,2861,16575
1,15,9,3,2015,21,13346,2734,16080
1,15,9,3,2015,22,12817,2608,15425
1,15,9,3,2015,23,13017,2523,15540
1,15,9,3,2015,24,11957,2335,14292
1,16,9,3,2015,1,12301,2256,14557
1,16,9,3,2015,2,11648,2055,13703
1,16,9,3,2015,3,11772,1933,13705
1,16,9,3,2015,4,11560,1838,13398
1,16,9,3,2015,5,11806,1818,13624
1,16,9,3,2015,6,12269,1807,14076
1,16,9,3,2015,7,12210,2011,14221
1,16,9,3,2015,8,13293,2150,15443
1,16,9,3,2015,9,12827,2452,15279
1,16,9,3,2015,10,13398,2802,16200
1,16,9,3,2015,11,12685,3036,15721
1,16,9,3,2015,12,13305,3108,16413
1,16,9,3,2015,13,12927,3089,16016
1,16,9,3,2015,14,12900,3017,15917
1,16,9,3,2015,15,13108,3010,16118
1,16,9,3,2015,16,12646,3010,15656
1,16,9,3,2015,17,12626,2989,15615
1,16,9,3,2015,18,12455,2957,15412
1,16,9,3,2015,19,13236,2925,16161
1,16,9,3,2015,20,13350,2888,16238
1,16,9,3,2015,21,13258,2757,16015
1,16,9,3,2015,22,12771,2627,15398
1,16,9,3,2015,23,12258,2563,14821
1,16,9,3,2015,24,12309,2413,14722
3,17,9,3,2015,1,11724,2363,14087
3,17,9,3,2015,2,11537,2151,13688
3,17,9,3,2015,3,11526,2017,13543
3,17,9,3,2015,4,11460,1936,13396
3,17,9,3,2015,5,10896,1897,12793
3,17,9,3,2015,6,12150,1951,14101
3,17,9,3,2015,7,11931,1976,13907
3,17,9,3,2015,8,12373,2003,14376
3,17,9,3,2015,9,12323,2079,14402
3,17,9,3,2015,10,11800,2197,13997
3,17,9,3,2015,11,11511,2297,13808
3,17,9,3,2015,12,11103,2326,13429
3,17,9,3,2015,13,10752,2326,13078
3,17,9,3,2015,14,10718,2236,12954
3,17,9,3,2015,15,10681,2242,12923
3,17,9,3,2015,16,10829,2233,13062
3,17,9,3,2015,17,10362,2195,12557
3,17,9,3,2015,18,10477,2174,12651
3,17,9,3,2015,19,11405,2303,13708
3,17,9,3,2015,20,11837,2440,14277
3,17,9,3,2015,21,11528,2438,13966
3,17,9,3,2015,22,11542,2434,13976
3,17,9,3,2015,23,10804,2426,13230
3,17,9,3,2015,24,10413,2378,12791
1,18,9,3,2015,1,10250,2246,12496
1,18,9,3,2015,2,10077,2063,12140
1,18,9,3,2015,3,9959,1951,11910
1,18,9,3,2015,4,9210,1878,11088
1,18,9,3,2015,5,9725,1853,11578
1,18,9,3,2015,6,9845,1926,11771
1,18,9,3,2015,7,10461,1991,12452
1,18,9,3,2015,8,11066,2136,13202
1,18,9,3,2015,9,11199,2459,13658
1,18,9,3,2015,10,11399,2825,14224
1,18,9,3,2015,11,10959,3019,13978
1,18,9,3,2015,12,10649,3070,13719
1,18,9,3,2015,13,10401,3034,13435
1,18,9,3,2015,14,10313,2873,13186
1,18,9,3,2015,15,10246,2884,13130
1,18,9,3,2015,16,10417,2874,13291
1,18,9,3,2015,17,10308,2848,13156
1,18,9,3,2015,18,10943,2803,13746
1,18,9,3,2015,19,12022,2818,14840
1,18,9,3,2015,20,12412,2795,15207
1,18,9,3,2015,21,12388,2736,15124
1,18,9,3,2015,22,11846,2626,14472
1,18,9,3,2015,23,11514,2567,14081
1,18,9,3,2015,24,11366,2365,13731
2,19,9,3,2015,1,10697,2251,12948
2,19,9,3,2015,2,10815,2072,12887
2,19,9,3,2015,3,10929,1950,12879
2,19,9,3,2015,4,10501,1882,12383
2,19,9,3,2015,5,10839,1864,12703
2,19,9,3,2015,6,10864,1918,12782
2,19,9,3,2015,7,11970,1950,13920
2,19,9,3,2015,8,11882,2038,13920
2,19,9,3,2015,9,12280,2255,14535
2,19,9,3,2015,10,11831,2616,14447
2,19,9,3,2015,11,11798,2853,14651
2,19,9,3,2015,12,11483,2905,14388
2,19,9,3,2015,13,11453,2893,14346
2,19,9,3,2015,14,11440,2784,14224
2,19,9,3,2015,15,11618,2786,14404
2,19,9,3,2015,16,11469,2756,14225
2,19,9,3,2015,17,11645,2731,14376
2,19,9,3,2015,18,11652,2696,14348
2,19,9,3,2015,19,13272,2685,15957
2,19,9,3,2015,20,13225,2727,15952
2,19,9,3,2015,21,13160,2597,15757
2,19,9,3,2015,22,12590,2443,15033
2,19,9,3,2015,23,12167,2352,14519
2,19,9,3,2015,24,12082,2278,14360
2,20,9,3,2015,1,11599,2158,13757
2,20,9,3,2015,2,11675,1985,13660
2,20,9,3,2015,3,11622,1848,13470
2,20,9,3,2015,4,11478,1774,13252
2,20,9,3,2015,5,11569,1748,13317
2,20,9,3,2015,6,12116,1790,13906
2,20,9,3,2015,7,12554,1796,14350
2,20,9,3,2015,8,12767,1831,14598
2,20,9,3,2015,9,13032,1918,14950
2,20,9,3,2015,10,13003,2010,15013
2,20,9,3,2015,11,12299,2140,14439
2,20,9,3,2015,12,12347,2186,14533
2,20,9,3,2015,13,12031,2201,14232
2,20,9,3,2015,14,11977,2121,14098
2,20,9,3,2015,15,12208,2083,14291
2,20,9,3,2015,16,11995,2012,14007
2,20,9,3,2015,17,11723,1987,13710
2,20,9,3,2015,18,11369,2026,13395
2,20,9,3,2015,19,12567,2158,14725
2,20,9,3,2015,20,13293,2324,15617
2,20,9,3,2015,21,12577,2345,14922
2,20,9,3,2015,22,12405,2290,14695
2,20,9,3,2015,23,12070,2199,14269
2,20,9,3,2015,24,12064,2163,14227
1,21,9,3,2015,1,11483,2089,13572
1,21,9,3,2015,2,11249,1922,13171
1,21,9,3,2015,3,11355,1817,13172
1,21,9,3,2015,4,11577,1752,13329
1,21,9,3,2015,5,11558,1749,13307
1,21,9,3,2015,6,11815,1824,13639
1,21,9,3,2015,7,12556,1925,14481
1,21,9,3,2015,8,12958,2080,15038
1,21,9,3,2015,9,13138,2367,15505
1,21,9,3,2015,10,13424,2778,16202
1,21,9,3,2015,11,13044,3004,16048
1,21,9,3,2015,12,12762,3047,15809
1,21,9,3,2015,13,12787,3027,15814
1,21,9,3,2015,14,12589,2921,15510
1,21,9,3,2015,15,12623,2940,15563
1,21,9,3,2015,16,12615,2932,15547
1,21,9,3,2015,17,11908,2874,14782
1,21,9,3,2015,18,12133,2818,14951
1,21,9,3,2015,19,12894,2822,15716
1,21,9,3,2015,20,13898,2772,16670
1,21,9,3,2015,21,13075,2627,15702
1,21,9,3,2015,22,13212,2525,15737
1,21,9,3,2015,23,12699,2450,15149
1,21,9,3,2015,24,12289,2348,14637
1,22,9,3,2015,1,12011,2160,14171
1,22,9,3,2015,2,11997,1977,13974
1,22,9,3,2015,3,11885,1870,13755
1,22,9,3,2015,4,11731,1821,13552
1,22,9,3,2015,5,11744,1787,13531
1,22,9,3,2015,6,12568,1867,14435
1,22,9,3,2015,7,13159,1985,15144
1,22,9,3,2015,8,13481,2136,15617
1,22,9,3,2015,9,13976,2370,16346
1,22,9,3,2015,10,13805,2776,16581
1,22,9,3,2015,11,13724,3011,16735
1,22,9,3,2015,12,13598,3068,16666
1,22,9,3,2015,13,13880,3036,16916
1,22,9,3,2015,14,12836,2921,15757
1,22,9,3,2015,15,13469,2954,16423
1,22,9,3,2015,16,13362,2962,16324
1,22,9,3,2015,17,13471,2952,16423
1,22,9,3,2015,18,12803,2905,15708
1,22,9,3,2015,19,13770,2889,16659
1,22,9,3,2015,20,14741,2923,17664
1,22,9,3,2015,21,14268,2770,17038
1,22,9,3,2015,22,13490,2625,16115
1,22,9,3,2015,23,13088,2505,15593
1,22,9,3,2015,24,12916,2378,15294
1,23,9,3,2015,1,12654,2197,14851
1,23,9,3,2015,2,12560,2012,14572
1,23,9,3,2015,3,12662,1903,14565
1,23,9,3,2015,4,12238,1842,14080
1,23,9,3,2015,5,12363,1830,14193
1,23,9,3,2015,6,12936,1906,14842
1,23,9,3,2015,7,14696,2033,16729
1,23,9,3,2015,8,14567,2168,16735
1,23,9,3,2015,9,14401,2468,16869
1,23,9,3,2015,10,14623,2813,17436
1,23,9,3,2015,11,14370,3046,17416
1,23,9,3,2015,12,14464,3103,17567
1,23,9,3,2015,13,14225,3089,17314
1,23,9,3,2015,14,13718,2995,16713
1,23,9,3,2015,15,14323,3023,17346
1,23,9,3,2015,16,14218,3028,17246
1,23,9,3,2015,17,13694,3015,16709
1,23,9,3,2015,18,13366,2943,16309
1,23,9,3,2015,19,13929,2902,16831
1,23,9,3,2015,20,14859,2919,17778
1,23,9,3,2015,21,14453,2779,17232
1,23,9,3,2015,22,13856,2632,16488
1,23,9,3,2015,23,13559,2533,16092
1,23,9,3,2015,24,13567,2449,16016
1,24,9,3,2015,1,13307,2254,15561
1,24,9,3,2015,2,13136,2055,15191
1,24,9,3,2015,3,12998,1939,14937
1,24,9,3,2015,4,12888,1862,14750
1,24,9,3,2015,5,13236,1844,15080
1,24,9,3,2015,6,13565,1924,15489
1,24,9,3,2015,7,14454,2041,16495
1,24,9,3,2015,8,15048,2182,17230
1,24,9,3,2015,9,15049,2489,17538
1,24,9,3,2015,10,14708,2826,17534
1,24,9,3,2015,11,15032,3035,18067
1,24,9,3,2015,12,14983,3082,18065
1,24,9,3,2015,13,14673,3080,17753
1,24,9,3,2015,14,14506,2968,17474
1,24,9,3,2015,15,14489,2994,17483
1,24,9,3,2015,16,14684,3013,17697
1,24,9,3,2015,17,14143,2985,17128
1,24,9,3,2015,18,13362,2925,16287
1,24,9,3,2015,19,13834,2887,16721
1,24,9,3,2015,20,14765,2891,17656
1,24,9,3,2015,21,14394,2737,17131
1,24,9,3,2015,22,13470,2568,16038
1,24,9,3,2015,23,13727,2476,16203
1,24,9,3,2015,24,13241,2453,15694
3,25,9,3,2015,1,13237,2260,15497
3,25,9,3,2015,2,13112,2063,15175
3,25,9,3,2015,3,13164,1939,15103
3,25,9,3,2015,4,13096,1875,14971
3,25,9,3,2015,5,13100,1852,14952
3,25,9,3,2015,6,13644,1928,15572
3,25,9,3,2015,7,14553,1997,16550
3,25,9,3,2015,8,15007,2086,17093
3,25,9,3,2015,9,14928,2290,17218
3,25,9,3,2015,10,14747,2532,17279
3,25,9,3,2015,11,14717,2717,17434
3,25,9,3,2015,12,14638,2770,17408
3,25,9,3,2015,13,14441,2767,17208
3,25,9,3,2015,14,14811,2650,17461
3,25,9,3,2015,15,14492,2680,17172
3,25,9,3,2015,16,14778,2674,17452
3,25,9,3,2015,17,13881,2669,16550
3,25,9,3,2015,18,12864,2609,15473
3,25,9,3,2015,19,13289,2609,15898
3,25,9,3,2015,20,14254,2701,16955
3,25,9,3,2015,21,13770,2554,16324
3,25,9,3,2015,22,13491,2507,15998
3,25,9,3,2015,23,13147,2341,15488
3,25,9,3,2015,24,13231,2304,15535
2,26,9,3,2015,1,13269,2188,15457
2,26,9,3,2015,2,13045,2011,15056
2,26,9,3,2015,3,13009,1892,14901
2,26,9,3,2015,4,12917,1827,14744
2,26,9,3,2015,5,13100,1810,14910
2,26,9,3,2015,6,13807,1874,15681
2,26,9,3,2015,7,14639,1913,16552
2,26,9,3,2015,8,15133,1994,17127
2,26,9,3,2015,9,15125,2188,17313
2,26,9,3,2015,10,14851,2473,17324
2,26,9,3,2015,11,14803,2669,17472
2,26,9,3,2015,12,15065,2721,17786
2,26,9,3,2015,13,15210,2720,17930
2,26,9,3,2015,14,14866,2596,17462
2,26,9,3,2015,15,14794,2604,17398
2,26,9,3,2015,16,14940,2578,17518
2,26,9,3,2015,17,14380,2563,16943
2,26,9,3,2015,18,13548,2521,16069
2,26,9,3,2015,19,13696,2557,16253
2,26,9,3,2015,20,14520,2661,17181
2,26,9,3,2015,21,13601,2522,16123
2,26,9,3,2015,22,13272,2476,15748
2,26,9,3,2015,23,13158,2401,15559
2,26,9,3,2015,24,13265,2291,15556
2,27,9,3,2015,1,13647,2131,15778
2,27,9,3,2015,2,13329,1987,15316
2,27,9,3,2015,3,13245,1891,15136
2,27,9,3,2015,4,13297,1819,15116
2,27,9,3,2015,5,13074,1791,14865
2,27,9,3,2015,6,13793,1842,15635
2,27,9,3,2015,7,14551,1823,16374
2,27,9,3,2015,8,14736,1833,16569
2,27,9,3,2015,9,14649,1914,16563
2,27,9,3,2015,10,14495,2030,16525
2,27,9,3,2015,11,14437,2121,16558
2,27,9,3,2015,12,14681,2163,16844
2,27,9,3,2015,13,14490,2169,16659
2,27,9,3,2015,14,14358,2122,16480
2,27,9,3,2015,15,14324,2084,16408
2,27,9,3,2015,16,14286,2052,16338
2,27,9,3,2015,17,13598,2002,15600
2,27,9,3,2015,18,12352,1965,14317
2,27,9,3,2015,19,12479,2024,14503
2,27,9,3,2015,20,13346,2153,15499
2,27,9,3,2015,21,12909,2192,15101
2,27,9,3,2015,22,12711,2211,14922
2,27,9,3,2015,23,13121,2215,15336
2,27,9,3,2015,24,13000,2210,15210
1,28,9,3,2015,1,12788,2105,14893
1,28,9,3,2015,2,12796,1954,14750
1,28,9,3,2015,3,12474,1851,14325
1,28,9,3,2015,4,12507,1790,14297
1,28,9,3,2015,5,12683,1771,14454
1,28,9,3,2015,6,13066,1867,14933
1,28,9,3,2015,7,14235,1979,16214
1,28,9,3,2015,8,14905,2126,17031
1,28,9,3,2015,9,15216,2445,17661
1,28,9,3,2015,10,15538,2792,18330
1,28,9,3,2015,11,15317,3043,18360
1,28,9,3,2015,12,15824,3113,18937
1,28,9,3,2015,13,15594,3094,18688
1,28,9,3,2015,14,15778,3033,18811
1,28,9,3,2015,15,15868,3096,18964
1,28,9,3,2015,16,16339,3116,19455
1,28,9,3,2015,17,15255,3111,18366
1,28,9,3,2015,18,14224,3036,17260
1,28,9,3,2015,19,14387,2955,17342
1,28,9,3,2015,20,15095,2982,18077
1,28,9,3,2015,21,14685,2824,17509
1,28,9,3,2015,22,14352,2687,17039
1,28,9,3,2015,23,13988,2603,16591
1,28,9,3,2015,24,13839,2514,16353
1,29,9,3,2015,1,14088,2330,16418
1,29,9,3,2015,2,14179,2115,16294
1,29,9,3,2015,3,14030,1989,16019
1,29,9,3,2015,4,14020,1918,15938
1,29,9,3,2015,5,13769,1893,15662
1,29,9,3,2015,6,14612,1969,16581
1,29,9,3,2015,7,15262,2069,17331
1,29,9,3,2015,8,15530,2216,17746
1,29,9,3,2015,9,15955,2521,18476
1,29,9,3,2015,10,15813,2852,18665
1,29,9,3,2015,11,15934,3159,19093
1,29,9,3,2015,12,16461,3220,19681
1,29,9,3,2015,13,15941,3223,19164
1,29,9,3,2015,14,15910,3136,19046
1,29,9,3,2015,15,15983,3227,19210
1,29,9,3,2015,16,16048,3236,19284
1,29,9,3,2015,17,15903,3234,19137
1,29,9,3,2015,18,14585,3148,17733
1,29,9,3,2015,19,14682,3100,17782
1,29,9,3,2015,20,15524,3094,18618
1,29,9,3,2015,21,14437,2934,17371
1,29,9,3,2015,22,14380,2814,17194
1,29,9,3,2015,23,14117,2743,16860
1,29,9,3,2015,24,14569,2700,17269
1,30,9,3,2015,1,14373,2475,16848
1,30,9,3,2015,2,14309,2254,16563
1,30,9,3,2015,3,14165,2092,16257
1,30,9,3,2015,4,14022,2002,16024
1,30,9,3,2015,5,13561,1946,15507
1,30,9,3,2015,6,14287,2017,16304
1,30,9,3,2015,7,15441,2107,17548
1,30,9,3,2015,8,15366,2247,17613
1,30,9,3,2015,9,15992,2502,18494
1,30,9,3,2015,10,15882,2946,18828
1,30,9,3,2015,11,16244,3184,19428
1,30,9,3,2015,12,16305,3245,19550
1,30,9,3,2015,13,15940,3267,19207
1,30,9,3,2015,14,15803,3171,18974
1,30,9,3,2015,15,15559,3256,18815
1,30,9,3,2015,16,15682,3302,18984
1,30,9,3,2015,17,15484,3301,18785
1,30,9,3,2015,18,14267,3247,17514
1,30,9,3,2015,19,14713,3176,17889
1,30,9,3,2015,20,15083,3163,18246
1,30,9,3,2015,21,14909,3047,17956
1,30,9,3,2015,22,14053,2968,17021
1,30,9,3,2015,23,14126,2952,17078
1,30,9,3,2015,24,14202,2872,17074
1,1,10,1,2015,1,14333,2611,16944
1,1,10,1,2015,2,14208,2386,16594
1,1,10,1,2015,3,14072,2231,16303
1,1,10,1,2015,4,13964,2105,16069
1,1,10,1,2015,5,14031,2067,16098
1,1,10,1,2015,6,14635,2089,16724
1,1,10,1,2015,7,15517,2175,17692
1,1,10,1,2015,8,15301,2294,17595
1,1,10,1,2015,9,15899,2557,18456
1,1,10,1,2015,10,16312,2950,19262
1,1,10,1,2015,11,16281,3175,19456
1,1,10,1,2015,12,16668,3265,19933
1,1,10,1,2015,13,16178,3329,19507
1,1,10,1,2015,14,16133,3239,19372
1,1,10,1,2015,15,16051,3325,19376
1,1,10,1,2015,16,15855,3333,19188
1,1,10,1,2015,17,15289,3328,18617
1,1,10,1,2015,18,14476,3238,17714
1,1,10,1,2015,19,14652,3166,17818
1,1,10,1,2015,20,14828,3134,17962
1,1,10,1,2015,21,14028,3044,17072
1,1,10,1,2015,22,13917,2866,16783
1,1,10,1,2015,23,13522,2763,16285
1,1,10,1,2015,24,13601,2735,16336
3,2,10,1,2015,1,13772,2581,16353
3,2,10,1,2015,2,13527,2371,15898
3,2,10,1,2015,3,13564,2238,15802
3,2,10,1,2015,4,13333,2142,15475
3,2,10,1,2015,5,13291,2100,15391
3,2,10,1,2015,6,13658,2116,15774
3,2,10,1,2015,7,14486,2101,16587
3,2,10,1,2015,8,14533,2119,16652
3,2,10,1,2015,9,14837,2253,17090
3,2,10,1,2015,10,14760,2484,17244
3,2,10,1,2015,11,14895,2696,17591
3,2,10,1,2015,12,15457,2792,18249
3,2,10,1,2015,13,15349,2793,18142
3,2,10,1,2015,14,15165,2736,17901
3,2,10,1,2015,15,14984,2797,17781
3,2,10,1,2015,16,14170,2788,16958
3,2,10,1,2015,17,12913,2745,15658
3,2,10,1,2015,18,13555,2742,16297
3,2,10,1,2015,19,13741,2793,16534
3,2,10,1,2015,20,14141,2798,16939
3,2,10,1,2015,21,13471,2785,16256
3,2,10,1,2015,22,13012,2688,15700
3,2,10,1,2015,23,12755,2646,15401
3,2,10,1,2015,24,12614,2598,15212
2,3,10,1,2015,1,12579,2411,14990
2,3,10,1,2015,2,12930,2203,15133
2,3,10,1,2015,3,12442,2068,14510
2,3,10,1,2015,4,12253,1976,14229
2,3,10,1,2015,5,12698,1948,14646
2,3,10,1,2015,6,12862,2003,14865
2,3,10,1,2015,7,13746,2051,15797
2,3,10,1,2015,8,14139,2124,16263
2,3,10,1,2015,9,14157,2377,16534
2,3,10,1,2015,10,14492,2719,17211
2,3,10,1,2015,11,14676,2994,17670
2,3,10,1,2015,12,14935,3059,17994
2,3,10,1,2015,13,14645,3052,17697
2,3,10,1,2015,14,14485,2959,17444
2,3,10,1,2015,15,14083,2982,17065
2,3,10,1,2015,16,14090,2996,17086
2,3,10,1,2015,17,13529,2948,16477
2,3,10,1,2015,18,13475,2876,16351
2,3,10,1,2015,19,14070,2891,16961
2,3,10,1,2015,20,14096,2839,16935
2,3,10,1,2015,21,13718,2669,16387
2,3,10,1,2015,22,13343,2519,15862
2,3,10,1,2015,23,12836,2423,15259
2,3,10,1,2015,24,12636,2343,14979
2,4,10,1,2015,1,12924,2221,15145
2,4,10,1,2015,2,12828,2055,14883
2,4,10,1,2015,3,12699,1943,14642
2,4,10,1,2015,4,12587,1877,14464
2,4,10,1,2015,5,12945,1862,14807
2,4,10,1,2015,6,13304,1896,15200
2,4,10,1,2015,7,13624,1890,15514
2,4,10,1,2015,8,14044,1908,15952
2,4,10,1,2015,9,14234,1989,16223
2,4,10,1,2015,10,14183,2129,16312
2,4,10,1,2015,11,14483,2258,16741
2,4,10,1,2015,12,14521,2272,16793
2,4,10,1,2015,13,14247,2320,16567
2,4,10,1,2015,14,13989,2293,16282
2,4,10,1,2015,15,13974,2283,16257
2,4,10,1,2015,16,13836,2285,16121
2,4,10,1,2015,17,13563,2236,15799
2,4,10,1,2015,18,12992,2213,15205
2,4,10,1,2015,19,13647,2320,15967
2,4,10,1,2015,20,13898,2450,16348
2,4,10,1,2015,21,13487,2490,15977
2,4,10,1,2015,22,12926,2481,15407
2,4,10,1,2015,23,12818,2454,15272
2,4,10,1,2015,24,12940,2357,15297
1,5,10,1,2015,1,13042,2280,15322
1,5,10,1,2015,2,12853,2053,14906
1,5,10,1,2015,3,12831,1903,14734
1,5,10,1,2015,4,12707,1821,14528
1,5,10,1,2015,5,12854,1808,14662
1,5,10,1,2015,6,13132,1956,15088
1,5,10,1,2015,7,13795,2022,15817
1,5,10,1,2015,8,14096,2159,16255
1,5,10,1,2015,9,14352,2541,16893
1,5,10,1,2015,10,14373,2818,17191
1,5,10,1,2015,11,14182,3190,17372
1,5,10,1,2015,12,14381,3219,17600
1,5,10,1,2015,13,14127,3252,17379
1,5,10,1,2015,14,14260,3190,17450
1,5,10,1,2015,15,14266,3248,17514
1,5,10,1,2015,16,14313,3255,17568
1,5,10,1,2015,17,14426,3220,17646
1,5,10,1,2015,18,13796,3127,16923
1,5,10,1,2015,19,14255,3152,17407
1,5,10,1,2015,20,14850,3005,17855
1,5,10,1,2015,21,14488,2828,17316
1,5,10,1,2015,22,14163,2618,16781
1,5,10,1,2015,23,13529,2605,16134
1,5,10,1,2015,24,13209,2492,15701
1,6,10,1,2015,1,13524,2308,15832
1,6,10,1,2015,2,13367,2102,15469
1,6,10,1,2015,3,13562,1994,15556
1,6,10,1,2015,4,13341,1920,15261
1,6,10,1,2015,5,13312,1898,15210
1,6,10,1,2015,6,13628,1976,15604
1,6,10,1,2015,7,14358,2090,16448
1,6,10,1,2015,8,14973,2224,17197
1,6,10,1,2015,9,15067,2542,17609
1,6,10,1,2015,10,15034,2919,17953
1,6,10,1,2015,11,15131,3214,18345
1,6,10,1,2015,12,15315,3266,18581
1,6,10,1,2015,13,14889,3269,18158
1,6,10,1,2015,14,14811,3218,18029
1,6,10,1,2015,15,14908,3316,18224
1,6,10,1,2015,16,14574,3319,17893
1,6,10,1,2015,17,14598,3295,17893
1,6,10,1,2015,18,14104,3202,17306
1,6,10,1,2015,19,14578,3181,17759
1,6,10,1,2015,20,15294,3125,18419
1,6,10,1,2015,21,14902,2977,17879
1,6,10,1,2015,22,14294,2828,17122
1,6,10,1,2015,23,14209,2793,17002
1,6,10,1,2015,24,14000,2765,16765
1,7,10,1,2015,1,14087,2533,16620
1,7,10,1,2015,2,14138,2276,16414
1,7,10,1,2015,3,13834,2140,15974
1,7,10,1,2015,4,13820,2040,15860
1,7,10,1,2015,5,14129,1992,16121
1,7,10,1,2015,6,14479,2064,16543
1,7,10,1,2015,7,15159,2152,17311
1,7,10,1,2015,8,15570,2272,17842
1,7,10,1,2015,9,15470,2581,18051
1,7,10,1,2015,10,15611,2980,18591
1,7,10,1,2015,11,15876,3238,19114
1,7,10,1,2015,12,15771,3322,19093
1,7,10,1,2015,13,15546,3347,18893
1,7,10,1,2015,14,15421,3295,18716
1,7,10,1,2015,15,15216,3350,18566
1,7,10,1,2015,16,15540,3351,18891
1,7,10,1,2015,17,15196,3306,18502
1,7,10,1,2015,18,14514,3224,17738
1,7,10,1,2015,19,14978,3146,18124
1,7,10,1,2015,20,15654,3127,18781
1,7,10,1,2015,21,15366,3002,18368
1,7,10,1,2015,22,14786,2896,17682
1,7,10,1,2015,23,14440,2832,17272
1,7,10,1,2015,24,14346,2802,17148
1,8,10,1,2015,1,14391,2602,16993
1,8,10,1,2015,2,13840,2337,16177
1,8,10,1,2015,3,14178,2206,16384
1,8,10,1,2015,4,13903,2105,16008
1,8,10,1,2015,5,13971,2064,16035
1,8,10,1,2015,6,14654,2098,16752
1,8,10,1,2015,7,15221,2181,17402
1,8,10,1,2015,8,15811,2237,18048
1,8,10,1,2015,9,15417,2637,18054
1,8,10,1,2015,10,15859,2944,18803
1,8,10,1,2015,11,15897,3278,19175
1,8,10,1,2015,12,15995,3394,19389
1,8,10,1,2015,13,15711,3398,19109
1,8,10,1,2015,14,15635,3320,18955
1,8,10,1,2015,15,15871,3412,19283
1,8,10,1,2015,16,15882,3416,19298
1,8,10,1,2015,17,15705,3380,19085
1,8,10,1,2015,18,14442,3279,17721
1,8,10,1,2015,19,15116,3243,18359
1,8,10,1,2015,20,15299,3189,18488
1,8,10,1,2015,21,15190,3065,18255
1,8,10,1,2015,22,14780,2968,17748
1,8,10,1,2015,23,14544,2935,17479
1,8,10,1,2015,24,14621,2875,17496
1,9,10,1,2015,1,14891,2657,17548
1,9,10,1,2015,2,14519,2409,16928
1,9,10,1,2015,3,14272,2250,16522
1,9,10,1,2015,4,14445,2152,16597
1,9,10,1,2015,5,14288,2093,16381
1,9,10,1,2015,6,14935,2154,17089
1,9,10,1,2015,7,15554,2254,17808
1,9,10,1,2015,8,16052,2346,18398
1,9,10,1,2015,9,15799,2672,18471
1,9,10,1,2015,10,15900,2995,18895
1,9,10,1,2015,11,15689,3297,18986
1,9,10,1,2015,12,16184,3353,19537
1,9,10,1,2015,13,15813,3339,19152
1,9,10,1,2015,14,15552,3244,18796
1,9,10,1,2015,15,15707,3319,19026
1,9,10,1,2015,16,15792,3341,19133
1,9,10,1,2015,17,15314,3284,18598
1,9,10,1,2015,18,14313,3204,17517
1,9,10,1,2015,19,14790,3164,17954
1,9,10,1,2015,20,15151,3112,18263
1,9,10,1,2015,21,15257,2989,18246
1,9,10,1,2015,22,14808,2850,17658
1,9,10,1,2015,23,14327,2782,17109
1,9,10,1,2015,24,14160,2751,16911
2,10,10,1,2015,1,14490,2590,17080
2,10,10,1,2015,2,14350,2368,16718
2,10,10,1,2015,3,14113,2211,16324
2,10,10,1,2015,4,14193,2115,16308
2,10,10,1,2015,5,14189,2071,16260
2,10,10,1,2015,6,14749,2115,16864
2,10,10,1,2015,7,15562,2115,17677
2,10,10,1,2015,8,16278,2170,18448
2,10,10,1,2015,9,16256,2344,18600
2,10,10,1,2015,10,15840,2671,18511
2,10,10,1,2015,11,16415,2946,19361
2,10,10,1,2015,12,17048,3039,20087
2,10,10,1,2015,13,16238,3047,19285
2,10,10,1,2015,14,16459,2936,19395
2,10,10,1,2015,15,16737,2961,19698
2,10,10,1,2015,16,16858,2992,19850
2,10,10,1,2015,17,16182,2939,19121
2,10,10,1,2015,18,15254,2865,18119
2,10,10,1,2015,19,15397,2894,18291
2,10,10,1,2015,20,15393,2915,18308
2,10,10,1,2015,21,15224,2855,18079
2,10,10,1,2015,22,14668,2706,17374
2,10,10,1,2015,23,14357,2689,17046
2,10,10,1,2015,24,14325,2684,17009
2,11,10,1,2015,1,14861,2526,17387
2,11,10,1,2015,2,14754,2331,17085
2,11,10,1,2015,3,14514,2188,16702
2,11,10,1,2015,4,14379,2090,16469
2,11,10,1,2015,5,14392,2049,16441
2,11,10,1,2015,6,14881,2060,16941
2,11,10,1,2015,7,15608,2032,17640
2,11,10,1,2015,8,15709,2013,17722
2,11,10,1,2015,9,15982,2092,18074
2,11,10,1,2015,10,16057,2193,18250
2,11,10,1,2015,11,16305,2298,18603
2,11,10,1,2015,12,16674,2358,19032
2,11,10,1,2015,13,16317,2375,18692
2,11,10,1,2015,14,16731,2363,19094
2,11,10,1,2015,15,16557,2382,18939
2,11,10,1,2015,16,16429,2384,18813
2,11,10,1,2015,17,15866,2336,18202
2,11,10,1,2015,18,14658,2279,16937
2,11,10,1,2015,19,15087,2364,17451
2,11,10,1,2015,20,14851,2506,17357
2,11,10,1,2015,21,14647,2529,17176
2,11,10,1,2015,22,13930,2772,16702
2,11,10,1,2015,23,13995,2472,16467
2,11,10,1,2015,24,14198,2466,16664
1,12,10,1,2015,1,14623,2405,17028
1,12,10,1,2015,2,14214,2202,16416
1,12,10,1,2015,3,13995,2092,16087
1,12,10,1,2015,4,13778,2004,15782
1,12,10,1,2015,5,13989,1961,15950
1,12,10,1,2015,6,14784,2027,16811
1,12,10,1,2015,7,15153,2092,17245
1,12,10,1,2015,8,16057,2194,18251
1,12,10,1,2015,9,15979,2486,18465
1,12,10,1,2015,10,16059,2866,18925
1,12,10,1,2015,11,16593,3159,19752
1,12,10,1,2015,12,16685,3205,19890
1,12,10,1,2015,13,16579,3203,19782
1,12,10,1,2015,14,16772,3160,19932
1,12,10,1,2015,15,17067,3202,20269
1,12,10,1,2015,16,16272,3206,19478
1,12,10,1,2015,17,16165,3185,19350
1,12,10,1,2015,18,14803,3121,17924
1,12,10,1,2015,19,15092,3105,18197
1,12,10,1,2015,20,15210,3068,18278
1,12,10,1,2015,21,15126,2923,18049
1,12,10,1,2015,22,15002,2819,17821
1,12,10,1,2015,23,14694,2724,17418
1,12,10,1,2015,24,14758,2654,17412
1,13,10,1,2015,1,14437,2525,16962
1,13,10,1,2015,2,14435,2288,16723
1,13,10,1,2015,3,14432,2149,16581
1,13,10,1,2015,4,14258,2066,16324
1,13,10,1,2015,5,13911,2015,15926
1,13,10,1,2015,6,14967,2077,17044
1,13,10,1,2015,7,15906,2175,18081
1,13,10,1,2015,8,16034,2303,18337
1,13,10,1,2015,9,16439,2585,19024
1,13,10,1,2015,10,16438,2944,19382
1,13,10,1,2015,11,16675,3173,19848
1,13,10,1,2015,12,17107,3270,20377
1,13,10,1,2015,13,16852,3289,20141
1,13,10,1,2015,14,16933,3220,20153
1,13,10,1,2015,15,16833,3317,20150
1,13,10,1,2015,16,16544,3329,19873
1,13,10,1,2015,17,16192,3324,19516
1,13,10,1,2015,18,15330,3232,18562
1,13,10,1,2015,19,15583,3253,18836
1,13,10,1,2015,20,15526,3220,18746
1,13,10,1,2015,21,15294,3076,18370
1,13,10,1,2015,22,14918,2979,17897
1,13,10,1,2015,23,14630,2902,17532
1,13,10,1,2015,24,14454,2834,17288
1,14,10,1,2015,1,14971,2604,17575
1,14,10,1,2015,2,14898,2329,17227
1,14,10,1,2015,3,14472,2156,16628
1,14,10,1,2015,4,14301,2057,16358
1,14,10,1,2015,5,14689,2036,16725
1,14,10,1,2015,6,15578,2085,17663
1,14,10,1,2015,7,16071,2160,18231
1,14,10,1,2015,8,16780,2272,19052
1,14,10,1,2015,9,16615,2541,19156
1,14,10,1,2015,10,16279,2996,19275
1,14,10,1,2015,11,16882,3193,20075
1,14,10,1,2015,12,17217,3275,20492
1,14,10,1,2015,13,17164,3271,20435
1,14,10,1,2015,14,16882,3223,20105
1,14,10,1,2015,15,16779,3320,20099
1,14,10,1,2015,16,17007,3405,20412
1,14,10,1,2015,17,16483,3380,19863
1,14,10,1,2015,18,15091,3307,18398
1,14,10,1,2015,19,16064,3316,19380
1,14,10,1,2015,20,16363,3334,19697
1,14,10,1,2015,21,15574,3209,18783
1,14,10,1,2015,22,15066,3098,18164
1,14,10,1,2015,23,15028,3061,18089
1,14,10,1,2015,24,15059,2986,18045
1,15,10,1,2015,1,15154,2755,17909
1,15,10,1,2015,2,15020,2499,17519
1,15,10,1,2015,3,14799,2353,17152
1,15,10,1,2015,4,14753,2236,16989
1,15,10,1,2015,5,15113,2141,17254
1,15,10,1,2015,6,15555,2182,17737
1,15,10,1,2015,7,16414,2237,18651
1,15,10,1,2015,8,17269,2329,19598
1,15,10,1,2015,9,16729,2630,19359
1,15,10,1,2015,10,16890,3000,19890
1,15,10,1,2015,11,17609,3248,20857
1,15,10,1,2015,12,17192,3343,20535
1,15,10,1,2015,13,17109,3365,20474
1,15,10,1,2015,14,17013,3305,20318
1,15,10,1,2015,15,17278,3379,20657
1,15,10,1,2015,16,17160,3380,20540
1,15,10,1,2015,17,16740,3377,20117
1,15,10,1,2015,18,15362,3293,18655
1,15,10,1,2015,19,15892,3334,19226
1,15,10,1,2015,20,15933,3323,19256
1,15,10,1,2015,21,15617,3143,18760
1,15,10,1,2015,22,14982,3005,17987
1,15,10,1,2015,23,14704,2921,17625
1,15,10,1,2015,24,15028,2887,17915
1,16,10,1,2015,1,15149,2557,17706
1,16,10,1,2015,2,14991,2446,17437
1,16,10,1,2015,3,14944,2279,17223
1,16,10,1,2015,4,14998,2163,17161
1,16,10,1,2015,5,15074,2112,17186
1,16,10,1,2015,6,15650,2152,17802
1,16,10,1,2015,7,16465,2209,18674
1,16,10,1,2015,8,16781,2285,19066
1,16,10,1,2015,9,16891,2557,19448
1,16,10,1,2015,10,16509,2936,19445
1,16,10,1,2015,11,17012,3206,20218
1,16,10,1,2015,12,17085,3317,20402
1,16,10,1,2015,13,16689,3332,20021
1,16,10,1,2015,14,16826,3271,20097
1,16,10,1,2015,15,16568,3357,19925
1,16,10,1,2015,16,16582,3368,19950
1,16,10,1,2015,17,16255,3367,19622
1,16,10,1,2015,18,14657,3304,17961
1,16,10,1,2015,19,15428,3337,18765
1,16,10,1,2015,20,15899,3290,19189
1,16,10,1,2015,21,15114,3122,18236
1,16,10,1,2015,22,14756,2983,17739
1,16,10,1,2015,23,14556,2887,17443
1,16,10,1,2015,24,14857,2904,17761
2,17,10,1,2015,1,14979,2762,17741
2,17,10,1,2015,2,14732,2514,17246
2,17,10,1,2015,3,15036,2346,17382
2,17,10,1,2015,4,14642,2236,16878
2,17,10,1,2015,5,14925,2165,17090
2,17,10,1,2015,6,15548,2191,17739
2,17,10,1,2015,7,16543,2245,18788
2,17,10,1,2015,8,16478,2262,18740
2,17,10,1,2015,9,16913,2467,19380
2,17,10,1,2015,10,16809,2808,19617
2,17,10,1,2015,11,17110,3072,20182
2,17,10,1,2015,12,17341,3148,20489
2,17,10,1,2015,13,17426,3183,20609
2,17,10,1,2015,14,17187,3107,20294
2,17,10,1,2015,15,17406,3149,20555
2,17,10,1,2015,16,17156,3199,20355
2,17,10,1,2015,17,16624,3163,19787
2,17,10,1,2015,18,15125,3067,18192
2,17,10,1,2015,19,15822,3162,18984
2,17,10,1,2015,20,15926,3151,19077
2,17,10,1,2015,21,15674,3059,18733
2,17,10,1,2015,22,14992,2929,17921
2,17,10,1,2015,23,15183,2860,18043
2,17,10,1,2015,24,15155,2863,18018
2,18,10,1,2015,1,15540,2737,18277
2,18,10,1,2015,2,15264,2584,17848
2,18,10,1,2015,3,15017,2414,17431
2,18,10,1,2015,4,14918,2276,17194
2,18,10,1,2015,5,15098,2196,17294
2,18,10,1,2015,6,15771,2198,17969
2,18,10,1,2015,7,16256,2158,18414
2,18,10,1,2015,8,16821,2131,18952
2,18,10,1,2015,9,16768,2185,18953
2,18,10,1,2015,10,16733,2283,19016
2,18,10,1,2015,11,17086,2460,19546
2,18,10,1,2015,12,17619,2496,20115
2,18,10,1,2015,13,17216,2504,19720
2,18,10,1,2015,14,17235,2515,19750
2,18,10,1,2015,15,17129,2585,19714
2,18,10,1,2015,16,17294,2632,19926
2,18,10,1,2015,17,16365,2562,18927
2,18,10,1,2015,18,15209,2501,17710
2,18,10,1,2015,19,15563,2663,18226
2,18,10,1,2015,20,15841,2770,18611
2,18,10,1,2015,21,15537,2777,18314
2,18,10,1,2015,22,14899,2785,17684
2,18,10,1,2015,23,14969,2810,17779
2,18,10,1,2015,24,15123,2851,17974
1,19,10,1,2015,1,15438,2720,18158
1,19,10,1,2015,2,15400,2470,17870
1,19,10,1,2015,3,15131,2309,17440
1,19,10,1,2015,4,15307,2186,17493
1,19,10,1,2015,5,15288,2133,17421
1,19,10,1,2015,6,15709,2177,17886
1,19,10,1,2015,7,16730,2227,18957
1,19,10,1,2015,8,17273,2336,19609
1,19,10,1,2015,9,17221,2562,19783
1,19,10,1,2015,10,17305,2982,20287
1,19,10,1,2015,11,17435,3270,20705
1,19,10,1,2015,12,18046,3368,21414
1,19,10,1,2015,13,17847,3378,21225
1,19,10,1,2015,14,17293,3313,20606
1,19,10,1,2015,15,17892,3403,21295
1,19,10,1,2015,16,17451,3414,20865
1,19,10,1,2015,17,17185,3405,20590
1,19,10,1,2015,18,15517,3314,18831
1,19,10,1,2015,19,16162,3319,19481
1,19,10,1,2015,20,16512,3288,19800
1,19,10,1,2015,21,15774,3116,18890
1,19,10,1,2015,22,15525,3028,18553
1,19,10,1,2015,23,15512,2958,18470
1,19,10,1,2015,24,15767,2958,18725
1,20,10,1,2015,1,15741,2752,18493
1,20,10,1,2015,2,15775,2562,18337
1,20,10,1,2015,3,15607,2433,18040
1,20,10,1,2015,4,15674,2302,17976
1,20,10,1,2015,5,15775,2193,17968
1,20,10,1,2015,6,16293,2207,18500
1,20,10,1,2015,7,16923,2239,19162
1,20,10,1,2015,8,17124,2333,19457
1,20,10,1,2015,9,17466,2582,20048
1,20,10,1,2015,10,17420,2832,20252
1,20,10,1,2015,11,17532,3241,20773
1,20,10,1,2015,12,17676,3344,21020
1,20,10,1,2015,13,17926,3341,21267
1,20,10,1,2015,14,17595,3267,20862
1,20,10,1,2015,15,17714,3356,21070
1,20,10,1,2015,16,17370,3377,20747
1,20,10,1,2015,17,17051,3358,20409
1,20,10,1,2015,18,15386,3232,18618
1,20,10,1,2015,19,16490,3220,19710
1,20,10,1,2015,20,16153,3192,19345
1,20,10,1,2015,21,16074,3040,19114
1,20,10,1,2015,22,15473,2954,18427
1,20,10,1,2015,23,15312,2902,18214
1,20,10,1,2015,24,15687,2812,18499
1,21,10,1,2015,1,15917,2726,18643
1,21,10,1,2015,2,15931,2498,18429
1,21,10,1,2015,3,15702,2328,18030
1,21,10,1,2015,4,15688,2216,17904
1,21,10,1,2015,5,15751,2165,17916
1,21,10,1,2015,6,16584,2196,18780
1,21,10,1,2015,7,16997,2229,19226
1,21,10,1,2015,8,17433,2304,19737
1,21,10,1,2015,9,17161,2570,19731
1,21,10,1,2015,10,17359,2924,20283
1,21,10,1,2015,11,17648,3213,20861
1,21,10,1,2015,12,18054,3334,21388
1,21,10,1,2015,13,17470,3314,20784
1,21,10,1,2015,14,17242,3237,20479
1,21,10,1,2015,15,17384,3334,20718
1,21,10,1,2015,16,17024,3340,20364
1,21,10,1,2015,17,16320,3337,19657
1,21,10,1,2015,18,15377,3210,18587
1,21,10,1,2015,19,15688,3205,18893
1,21,10,1,2015,20,15778,3263,19041
1,21,10,1,2015,21,15489,3107,18596
1,21,10,1,2015,22,15094,2952,18046
1,21,10,1,2015,23,14999,2899,17898
1,21,10,1,2015,24,15397,2815,18212
3,22,10,1,2015,1,15897,2783,18680
3,22,10,1,2015,2,15943,2597,18540
3,22,10,1,2015,3,15628,2419,18047
3,22,10,1,2015,4,15290,2288,17578
3,22,10,1,2015,5,15597,2214,17811
3,22,10,1,2015,6,16130,2215,18345
3,22,10,1,2015,7,16564,2168,18732
3,22,10,1,2015,8,16364,2123,18487
3,22,10,1,2015,9,16344,2171,18515
3,22,10,1,2015,10,15863,2255,18118
3,22,10,1,2015,11,15969,2384,18353
3,22,10,1,2015,12,16151,2475,18626
3,22,10,1,2015,13,15967,2511,18478
3,22,10,1,2015,14,15882,2524,18406
3,22,10,1,2015,15,15976,2590,18566
3,22,10,1,2015,16,15758,2603,18361
3,22,10,1,2015,17,14716,2536,17252
3,22,10,1,2015,18,13449,2459,15908
3,22,10,1,2015,19,14112,2629,16741
3,22,10,1,2015,20,13752,2741,16493
3,22,10,1,2015,21,13589,2793,16382
3,22,10,1,2015,22,13406,2793,16199
3,22,10,1,2015,23,13257,2813,16070
3,22,10,1,2015,24,13924,2838,16762
1,23,10,1,2015,1,14052,2731,16783
1,23,10,1,2015,2,13887,2513,16400
1,23,10,1,2015,3,13888,2353,16241
1,23,10,1,2015,4,13825,2247,16072
1,23,10,1,2015,5,14276,2184,16460
1,23,10,1,2015,6,14518,2212,16730
1,23,10,1,2015,7,15587,2211,17798
1,23,10,1,2015,8,16599,2279,18878
1,23,10,1,2015,9,16810,2513,19323
1,23,10,1,2015,10,16851,2955,19806
1,23,10,1,2015,11,17429,3217,20646
1,23,10,1,2015,12,17542,3340,20882
1,23,10,1,2015,13,17118,3349,20467
1,23,10,1,2015,14,17381,3279,20660
1,23,10,1,2015,15,16871,3335,20206
1,23,10,1,2015,16,16894,3352,20246
1,23,10,1,2015,17,16284,3337,19621
1,23,10,1,2015,18,14813,3257,18070
1,23,10,1,2015,19,15358,3253,18611
1,23,10,1,2015,20,15455,3156,18611
1,23,10,1,2015,21,15329,3013,18342
1,23,10,1,2015,22,14526,2883,17409
1,23,10,1,2015,23,14572,2851,17423
1,23,10,1,2015,24,15228,2855,18083
3,24,10,1,2015,1,15576,2746,18322
3,24,10,1,2015,2,15295,2513,17808
3,24,10,1,2015,3,15269,2352,17621
3,24,10,1,2015,4,15356,2245,17601
3,24,10,1,2015,5,15462,2188,17650
3,24,10,1,2015,6,16163,2197,18360
3,24,10,1,2015,7,16889,2172,19061
3,24,10,1,2015,8,17031,2177,19208
3,24,10,1,2015,9,17101,2319,19420
3,24,10,1,2015,10,17320,2584,19904
3,24,10,1,2015,11,17508,2822,20330
3,24,10,1,2015,12,17769,2943,20712
3,24,10,1,2015,13,17923,2962,20885
3,24,10,1,2015,14,17777,2898,20675
3,24,10,1,2015,15,17667,2962,20629
3,24,10,1,2015,16,17369,2964,20333
3,24,10,1,2015,17,16799,2947,19746
3,24,10,1,2015,18,15537,2877,18414
3,24,10,1,2015,19,15611,2940,18551
3,24,10,1,2015,20,15774,2947,18721
3,24,10,1,2015,21,15225,2869,18094
3,24,10,1,2015,22,15004,2784,17788
3,24,10,1,2015,23,14839,2764,17603
3,24,10,1,2015,24,15101,2791,17892
2,25,10,1,2015,1,15860,2663,18523
2,25,10,1,2015,2,15763,2500,18263
2,25,10,1,2015,3,15140,2351,17491
2,25,10,1,2015,4,15464,2252,17716
2,25,10,1,2015,5,15118,2190,17308
2,25,10,1,2015,6,15657,2202,17859
2,25,10,1,2015,7,16410,2153,18563
2,25,10,1,2015,8,16643,2111,18754
2,25,10,1,2015,9,16924,2175,19099
2,25,10,1,2015,10,16785,2300,19085
2,25,10,1,2015,11,17297,2442,19739
2,25,10,1,2015,12,17182,2535,19717
2,25,10,1,2015,13,17472,2593,20065
2,25,10,1,2015,14,17096,2602,19698
2,25,10,1,2015,15,17414,2634,20048
2,25,10,1,2015,16,17000,2606,19606
2,25,10,1,2015,17,15777,2472,18249
2,25,10,1,2015,18,14915,2307,17222
2,25,10,1,2015,19,14666,2440,17106
2,25,10,1,2015,20,15443,2524,17967
2,25,10,1,2015,21,14837,2501,17338
2,25,10,1,2015,22,14182,2456,16638
2,25,10,1,2015,23,14487,2502,16989
2,25,10,1,2015,24,14505,2511,17016
1,26,10,1,2015,1,15262,2472,17734
1,26,10,1,2015,2,14967,2276,17243
1,26,10,1,2015,3,15051,2135,17186
1,26,10,1,2015,4,14929,2047,16976
1,26,10,1,2015,5,14782,1998,16780
1,26,10,1,2015,6,15677,2059,17736
1,26,10,1,2015,7,16205,2141,18346
1,26,10,1,2015,8,16813,2243,19056
1,26,10,1,2015,9,16915,2538,19453
1,26,10,1,2015,10,17043,2901,19944
1,26,10,1,2015,11,17493,3186,20679
1,26,10,1,2015,12,17288,3267,20555
1,26,10,1,2015,13,17921,3266,21187
1,26,10,1,2015,14,17464,3229,20693
1,26,10,1,2015,15,17445,3276,20721
1,26,10,1,2015,16,17438,3254,20692
1,26,10,1,2015,17,16508,3260,19768
1,26,10,1,2015,18,15353,3189,18542
1,26,10,1,2015,19,15869,3177,19046
1,26,10,1,2015,20,15612,3115,18727
1,26,10,1,2015,21,15277,2995,18272
1,26,10,1,2015,22,14689,2864,17553
1,26,10,1,2015,23,14806,2803,17609
1,26,10,1,2015,24,14984,2829,17813
1,27,10,1,2015,1,15512,2596,18108
1,27,10,1,2015,2,15075,2362,17437
1,27,10,1,2015,3,15297,2208,17505
1,27,10,1,2015,4,15232,2110,17342
1,27,10,1,2015,5,15265,2050,17315
1,27,10,1,2015,6,15890,2087,17977
1,27,10,1,2015,7,16390,2160,18550
1,27,10,1,2015,8,17059,2265,19324
1,27,10,1,2015,9,16921,2555,19476
1,27,10,1,2015,10,17231,2897,20128
1,27,10,1,2015,11,17697,3155,20852
1,27,10,1,2015,12,17745,3209,20954
1,27,10,1,2015,13,17472,3213,20685
1,27,10,1,2015,14,17475,3143,20618
1,27,10,1,2015,15,17213,3194,20407
1,27,10,1,2015,16,17415,3214,20629
1,27,10,1,2015,17,16823,3189,20012
1,27,10,1,2015,18,15459,3164,18623
1,27,10,1,2015,19,15966,3180,19146
1,27,10,1,2015,20,15884,3091,18975
1,27,10,1,2015,21,15560,2936,18496
1,27,10,1,2015,22,15050,2804,17854
1,27,10,1,2015,23,14859,2774,17633
1,27,10,1,2015,24,15302,2753,18055
1,28,10,1,2015,1,15371,2605,17976
1,28,10,1,2015,2,15254,2350,17604
1,28,10,1,2015,3,15151,2208,17359
1,28,10,1,2015,4,15472,2116,17588
1,28,10,1,2015,5,15494,2057,17551
1,28,10,1,2015,6,15893,2113,18006
1,28,10,1,2015,7,16506,2173,18679
1,28,10,1,2015,8,16393,2285,18678
1,28,10,1,2015,9,16787,2562,19349
1,28,10,1,2015,10,17191,2862,20053
1,28,10,1,2015,11,17030,3003,20033
1,28,10,1,2015,12,17504,3117,20621
1,28,10,1,2015,13,17335,3234,20569
1,28,10,1,2015,14,17118,3211,20329
1,28,10,1,2015,15,17199,3240,20439
1,28,10,1,2015,16,17351,3231,20582
1,28,10,1,2015,17,16640,3186,19826
1,28,10,1,2015,18,15612,3130,18742
1,28,10,1,2015,19,16198,3229,19427
1,28,10,1,2015,20,16252,3098,19350
1,28,10,1,2015,21,15951,3112,19063
1,28,10,1,2015,22,14959,2854,17813
1,28,10,1,2015,23,14885,2790,17675
1,28,10,1,2015,24,15358,2717,18075
1,29,10,1,2015,1,15407,2544,17951
1,29,10,1,2015,2,15192,2326,17518
1,29,10,1,2015,3,15045,2178,17223
1,29,10,1,2015,4,15128,2064,17192
1,29,10,1,2015,5,15133,2029,17162
1,29,10,1,2015,6,15843,2064,17907
1,29,10,1,2015,7,16359,2119,18478
1,29,10,1,2015,8,16737,2224,18961
1,29,10,1,2015,9,16772,2495,19267
1,29,10,1,2015,10,17277,2824,20101
1,29,10,1,2015,11,17246,3069,20315
1,29,10,1,2015,12,17318,3150,20468
1,29,10,1,2015,13,17438,3147,20585
1,29,10,1,2015,14,17283,3084,20367
1,29,10,1,2015,15,17264,3126,20390
1,29,10,1,2015,16,17338,3127,20465
1,29,10,1,2015,17,16517,3100,19617
1,29,10,1,2015,18,15621,3047,18668
1,29,10,1,2015,19,15820,3046,18866
1,29,10,1,2015,20,15338,2978,18316
1,29,10,1,2015,21,15358,2749,18107
1,29,10,1,2015,22,14716,2663,17379
1,29,10,1,2015,23,14755,2472,17227
1,29,10,1,2015,24,14495,2461,16956
1,30,10,1,2015,1,14999,2370,17369
1,30,10,1,2015,2,14863,2194,17057
1,30,10,1,2015,3,15201,2012,17213
1,30,10,1,2015,4,14803,1972,16775
1,30,10,1,2015,5,14813,1942,16755
1,30,10,1,2015,6,15568,1957,17525
1,30,10,1,2015,7,16203,2037,18240
1,30,10,1,2015,8,16428,2135,18563
1,30,10,1,2015,9,16224,2403,18627
1,30,10,1,2015,10,16672,2718,19390
1,30,10,1,2015,11,16666,3011,19677
1,30,10,1,2015,12,17025,3076,20101
1,30,10,1,2015,13,16355,3077,19432
1,30,10,1,2015,14,16371,2987,19358
1,30,10,1,2015,15,16572,3041,19613
1,30,10,1,2015,16,16231,3075,19306
1,30,10,1,2015,17,16090,3078,19168
1,30,10,1,2015,18,14856,3060,17916
1,30,10,1,2015,19,14827,3064,17891
1,30,10,1,2015,20,15719,3038,18757
1,30,10,1,2015,21,14897,2805,17702
1,30,10,1,2015,22,14047,2655,16702
1,30,10,1,2015,23,13954,2565,16519
1,30,10,1,2015,24,14279,2478,16757
2,31,10,1,2015,1,14666,2333,16999
2,31,10,1,2015,2,14504,2124,16628
2,31,10,1,2015,3,14519,1994,16513
2,31,10,1,2015,4,14435,1884,16319
2,31,10,1,2015,5,15001,1856,16857
2,31,10,1,2015,6,14879,1920,16799
2,31,10,1,2015,7,16103,1972,18075
2,31,10,1,2015,8,16302,2047,18349
2,31,10,1,2015,9,16609,2267,18876
2,31,10,1,2015,10,16624,2561,19185
2,31,10,1,2015,11,17143,2885,20028
2,31,10,1,2015,12,17314,2933,20247
2,31,10,1,2015,13,17083,2930,20013
2,31,10,1,2015,14,17171,2855,20026
2,31,10,1,2015,15,16749,2887,19636
2,31,10,1,2015,16,17038,2909,19947
2,31,10,1,2015,17,16708,2906,19614
2,31,10,1,2015,18,15504,2848,18352
2,31,10,1,2015,19,15797,2915,18712
2,31,10,1,2015,20,15514,2901,18415
2,31,10,1,2015,21,14961,2794,17755
2,31,10,1,2015,22,14678,2651,17329
2,31,10,1,2015,23,14598,2537,17135
2,31,10,1,2015,24,14901,2484,17385
2,1,11,1,2015,1,15119,2294,17413
2,1,11,1,2015,2,14940,2112,17052
2,1,11,1,2015,3,14856,1976,16832
2,1,11,1,2015,4,14517,1881,16398
2,1,11,1,2015,5,14654,1839,16493
2,1,11,1,2015,6,15326,1869,17195
2,1,11,1,2015,7,15846,1856,17702
2,1,11,1,2015,8,16217,1870,18087
2,1,11,1,2015,9,16394,1973,18367
2,1,11,1,2015,10,16210,2107,18317
2,1,11,1,2015,11,16793,2227,19020
2,1,11,1,2015,12,17018,2324,19342
2,1,11,1,2015,13,17003,2349,19352
2,1,11,1,2015,14,16889,2329,19218
2,1,11,1,2015,15,16918,2335,19253
2,1,11,1,2015,16,16916,2343,19259
2,1,11,1,2015,17,16325,2314,18639
2,1,11,1,2015,18,14496,2294,16790
2,1,11,1,2015,19,15004,2368,17372
2,1,11,1,2015,20,14944,2456,17400
2,1,11,1,2015,21,14478,2489,16967
2,1,11,1,2015,22,14033,2458,16491
2,1,11,1,2015,23,13942,2426,16368
2,1,11,1,2015,24,14395,2409,16804
1,2,11,1,2015,1,14418,2370,16788
1,2,11,1,2015,2,14247,2160,16407
1,2,11,1,2015,3,14236,1997,16233
1,2,11,1,2015,4,14107,1910,16017
1,2,11,1,2015,5,14380,1851,16231
1,2,11,1,2015,6,15006,1909,16915
1,2,11,1,2015,7,15617,2018,17635
1,2,11,1,2015,8,16083,2135,18218
1,2,11,1,2015,9,16378,2458,18836
1,2,11,1,2015,10,16834,2826,19660
1,2,11,1,2015,11,17104,3105,20209
1,2,11,1,2015,12,17342,3125,20467
1,2,11,1,2015,13,17078,3118,20196
1,2,11,1,2015,14,16970,3056,20026
1,2,11,1,2015,15,17048,3095,20143
1,2,11,1,2015,16,17056,3114,20170
1,2,11,1,2015,17,16559,3122,19681
1,2,11,1,2015,18,14969,3087,18056
1,2,11,1,2015,19,15526,3124,18650
1,2,11,1,2015,20,15316,3046,18362
1,2,11,1,2015,21,14883,2848,17731
1,2,11,1,2015,22,14410,2748,17158
1,2,11,1,2015,23,14183,2665,16848
1,2,11,1,2015,24,14444,2603,17047
1,3,11,1,2015,1,14792,2421,17213
1,3,11,1,2015,2,14795,2191,16986
1,3,11,1,2015,3,14635,2054,16689
1,3,11,1,2015,4,14543,1961,16504
1,3,11,1,2015,5,15072,1922,16994
1,3,11,1,2015,6,15767,1985,17752
1,3,11,1,2015,7,16174,2076,18250
1,3,11,1,2015,8,16297,2184,18481
1,3,11,1,2015,9,16840,2461,19301
1,3,11,1,2015,10,16719,2839,19558
1,3,11,1,2015,11,17252,3082,20334
1,3,11,1,2015,12,17172,3153,20325
1,3,11,1,2015,13,17285,3149,20434
1,3,11,1,2015,14,16524,3094,19618
1,3,11,1,2015,15,16950,3121,20071
1,3,11,1,2015,16,17038,3149,20187
1,3,11,1,2015,17,16286,3144,19430
1,3,11,1,2015,18,15114,3105,18219
1,3,11,1,2015,19,15755,3112,18867
1,3,11,1,2015,20,15371,3009,18380
1,3,11,1,2015,21,14972,2819,17791
1,3,11,1,2015,22,14633,2676,17309
1,3,11,1,2015,23,14770,2595,17365
1,3,11,1,2015,24,14800,2504,17304
1,4,11,1,2015,1,14874,2357,17231
1,4,11,1,2015,2,14694,2157,16851
1,4,11,1,2015,3,14820,2022,16842
1,4,11,1,2015,4,14803,1940,16743
1,4,11,1,2015,5,14846,1914,16760
1,4,11,1,2015,6,15414,1969,17383
1,4,11,1,2015,7,16215,2050,18265
1,4,11,1,2015,8,16913,2172,19085
1,4,11,1,2015,9,16464,2463,18927
1,4,11,1,2015,10,16784,2784,19568
1,4,11,1,2015,11,17255,3094,20349
1,4,11,1,2015,12,17262,3207,20469
1,4,11,1,2015,13,17030,3174,20204
1,4,11,1,2015,14,16888,3110,19998
1,4,11,1,2015,15,16893,3163,20056
1,4,11,1,2015,16,17018,3196,20214
1,4,11,1,2015,17,16318,3167,19485
1,4,11,1,2015,18,15418,3009,18427
1,4,11,1,2015,19,15918,3190,19108
1,4,11,1,2015,20,15457,3057,18514
1,4,11,1,2015,21,14813,2830,17643
1,4,11,1,2015,22,14587,2745,17332
1,4,11,1,2015,23,14124,2640,16764
1,4,11,1,2015,24,14353,2580,16933
1,5,11,1,2015,1,14848,2440,17288
1,5,11,1,2015,2,14919,2232,17151
1,5,11,1,2015,3,14910,2101,17011
1,5,11,1,2015,4,14732,2016,16748
1,5,11,1,2015,5,15013,1977,16990
1,5,11,1,2015,6,15646,2032,17678
1,5,11,1,2015,7,16035,2113,18148
1,5,11,1,2015,8,16513,2226,18739
1,5,11,1,2015,9,16559,2480,19039
1,5,11,1,2015,10,16781,2910,19691
1,5,11,1,2015,11,17063,3180,20243
1,5,11,1,2015,12,16783,3220,20003
1,5,11,1,2015,13,16638,3208,19846
1,5,11,1,2015,14,16525,3152,19677
1,5,11,1,2015,15,16566,3208,19774
1,5,11,1,2015,16,16410,3217,19627
1,5,11,1,2015,17,16098,3206,19304
1,5,11,1,2015,18,14971,3132,18103
1,5,11,1,2015,19,15768,3126,18894
1,5,11,1,2015,20,15658,3040,18698
1,5,11,1,2015,21,14969,2888,17857
1,5,11,1,2015,22,14854,2779,17633
1,5,11,1,2015,23,14835,2656,17491
1,5,11,1,2015,24,14923,2594,17517
1,6,11,1,2015,1,15248,2454,17702
1,6,11,1,2015,2,14799,2240,17039
1,6,11,1,2015,3,15060,2097,17157
1,6,11,1,2015,4,14805,1999,16804
1,6,11,1,2015,5,14924,1963,16887
1,6,11,1,2015,6,15585,2007,17592
1,6,11,1,2015,7,16126,2079,18205
1,6,11,1,2015,8,16481,2186,18667
1,6,11,1,2015,9,16521,2489,19010
1,6,11,1,2015,10,16623,2847,19470
1,6,11,1,2015,11,16832,3143,19975
1,6,11,1,2015,12,16717,3208,19925
1,6,11,1,2015,13,16406,3203,19609
1,6,11,1,2015,14,16282,3095,19377
1,6,11,1,2015,15,16300,3151,19451
1,6,11,1,2015,16,16283,3201,19484
1,6,11,1,2015,17,15675,3183,18858
1,6,11,1,2015,18,14902,3116,18018
1,6,11,1,2015,19,15544,3117,18661
1,6,11,1,2015,20,15257,3079,18336
1,6,11,1,2015,21,14768,2865,17633
1,6,11,1,2015,22,14367,2720,17087
1,6,11,1,2015,23,14365,2631,16996
1,6,11,1,2015,24,14974,2587,17561
2,7,11,1,2015,1,14960,2448,17408
2,7,11,1,2015,2,14968,2227,17195
2,7,11,1,2015,3,14977,2083,17060
2,7,11,1,2015,4,14816,1979,16795
2,7,11,1,2015,5,14979,1937,16916
2,7,11,1,2015,6,15468,1966,17434
2,7,11,1,2015,7,15924,1989,17913
2,7,11,1,2015,8,16371,2048,18419
2,7,11,1,2015,9,16507,2281,18788
2,7,11,1,2015,10,16904,2606,19510
2,7,11,1,2015,11,16727,2890,19617
2,7,11,1,2015,12,16846,2928,19774
2,7,11,1,2015,13,16722,2919,19641
2,7,11,1,2015,14,16947,2820,19767
2,7,11,1,2015,15,16569,2850,19419
2,7,11,1,2015,16,16955,2891,19846
2,7,11,1,2015,17,16153,2884,19037
2,7,11,1,2015,18,14800,2831,17631
2,7,11,1,2015,19,15433,2901,18334
2,7,11,1,2015,20,15251,2863,18114
2,7,11,1,2015,21,15106,2776,17882
2,7,11,1,2015,22,14640,2653,17293
2,7,11,1,2015,23,14715,2549,17264
2,7,11,1,2015,24,14616,2506,17122
2,8,11,1,2015,1,14998,2375,17373
2,8,11,1,2015,2,14729,2186,16915
2,8,11,1,2015,3,14666,2045,16711
2,8,11,1,2015,4,14581,1953,16534
2,8,11,1,2015,5,14727,1897,16624
2,8,11,1,2015,6,15528,1919,17447
2,8,11,1,2015,7,15510,1890,17400
2,8,11,1,2015,8,16326,1877,18203
2,8,11,1,2015,9,16682,2019,18701
2,8,11,1,2015,10,16805,2120,18925
2,8,11,1,2015,11,17255,2241,19496
2,8,11,1,2015,12,17161,2308,19469
2,8,11,1,2015,13,17435,2325,19760
2,8,11,1,2015,14,16470,2287,18757
2,8,11,1,2015,15,16882,2304,19186
2,8,11,1,2015,16,16799,2291,19090
2,8,11,1,2015,17,15802,2251,18053
2,8,11,1,2015,18,14675,2216,16891
2,8,11,1,2015,19,15624,2343,17967
2,8,11,1,2015,20,15241,2398,17639
2,8,11,1,2015,21,14853,2404,17257
2,8,11,1,2015,22,14566,2384,16950
2,8,11,1,2015,23,14193,2340,16533
2,8,11,1,2015,24,14511,2327,16838
1,9,11,1,2015,1,14662,2235,16897
1,9,11,1,2015,2,14376,2063,16439
1,9,11,1,2015,3,13895,1942,15837
1,9,11,1,2015,4,14183,1852,16035
1,9,11,1,2015,5,14643,1822,16465
1,9,11,1,2015,6,15301,1878,17179
1,9,11,1,2015,7,16070,1936,18006
1,9,11,1,2015,8,16725,2069,18794
1,9,11,1,2015,9,16735,2373,19108
1,9,11,1,2015,10,16800,2745,19545
1,9,11,1,2015,11,16985,3024,20009
1,9,11,1,2015,12,17699,3061,20760
1,9,11,1,2015,13,17356,3059,20415
1,9,11,1,2015,14,16953,2982,19935
1,9,11,1,2015,15,16573,3004,19577
1,9,11,1,2015,16,16775,3001,19776
1,9,11,1,2015,17,15967,2968,18935
1,9,11,1,2015,18,14718,2911,17629
1,9,11,1,2015,19,15564,2969,18533
1,9,11,1,2015,20,15460,2945,18405
1,9,11,1,2015,21,15030,2778,17808
1,9,11,1,2015,22,14753,2639,17392
1,9,11,1,2015,23,14067,2535,16602
1,9,11,1,2015,24,14185,2448,16633
1,10,11,1,2015,1,14068,2300,16368
1,10,11,1,2015,2,13959,2112,16071
1,10,11,1,2015,3,13812,1992,15804
1,10,11,1,2015,4,13994,1903,15897
1,10,11,1,2015,5,14164,1867,16031
1,10,11,1,2015,6,15273,1949,17222
1,10,11,1,2015,7,16237,2030,18267
1,10,11,1,2015,8,16396,2126,18522
1,10,11,1,2015,9,16113,2340,18453
1,10,11,1,2015,10,16186,2591,18777
1,10,11,1,2015,11,16374,2860,19234
1,10,11,1,2015,12,16561,2893,19454
1,10,11,1,2015,13,16181,2890,19071
1,10,11,1,2015,14,16037,2831,18868
1,10,11,1,2015,15,15678,2836,18514
1,10,11,1,2015,16,15694,2822,18516
1,10,11,1,2015,17,14836,2775,17611
1,10,11,1,2015,18,13866,2704,16570
1,10,11,1,2015,19,14723,2815,17538
1,10,11,1,2015,20,14642,2750,17392
1,10,11,1,2015,21,14054,2623,16677
1,10,11,1,2015,22,13311,2528,15839
1,10,11,1,2015,23,13082,2437,15519
1,10,11,1,2015,24,13059,2349,15408
3,11,11,1,2015,1,12807,2162,14969
3,11,11,1,2015,2,12820,2029,14849
3,11,11,1,2015,3,12576,1908,14484
3,11,11,1,2015,4,12755,1815,14570
3,11,11,1,2015,5,13033,1782,14815
3,11,11,1,2015,6,13661,1818,15479
3,11,11,1,2015,7,14481,1837,16318
3,11,11,1,2015,8,14685,1850,16535
3,11,11,1,2015,9,14139,1920,16059
3,11,11,1,2015,10,14116,2040,16156
3,11,11,1,2015,11,14282,2138,16420
3,11,11,1,2015,12,14013,2158,16171
3,11,11,1,2015,13,13660,2190,15850
3,11,11,1,2015,14,13495,2138,15633
3,11,11,1,2015,15,13121,2099,15220
3,11,11,1,2015,16,13242,2092,15334
3,11,11,1,2015,17,12499,2102,14601
3,11,11,1,2015,18,11842,2159,14001
3,11,11,1,2015,19,12596,2449,15045
3,11,11,1,2015,20,12404,2462,14866
3,11,11,1,2015,21,12419,2430,14849
3,11,11,1,2015,22,11676,2366,14042
3,11,11,1,2015,23,11560,2314,13874
3,11,11,1,2015,24,11680,2292,13972
1,13,11,1,2015,1,12089,2224,14313
1,13,11,1,2015,2,12092,2042,14134
1,13,11,1,2015,3,11855,1920,13775
1,13,11,1,2015,4,11816,1829,13645
1,13,11,1,2015,5,12459,1802,14261
1,13,11,1,2015,6,12816,1834,14650
1,13,11,1,2015,7,13427,1847,15274
1,13,11,1,2015,8,14216,1873,16089
1,13,11,1,2015,9,14426,2048,16474
1,13,11,1,2015,10,14113,2237,16350
1,13,11,1,2015,11,14633,2358,16991
1,13,11,1,2015,12,14388,2415,16803
1,13,11,1,2015,13,14208,2446,16654
1,13,11,1,2015,14,14064,2377,16441
1,13,11,1,2015,15,13738,2365,16103
1,13,11,1,2015,16,13643,2395,16038
1,13,11,1,2015,17,13193,2363,15556
1,13,11,1,2015,18,12179,2336,14515
1,13,11,1,2015,19,13019,2484,15503
1,13,11,1,2015,20,13378,2490,15868
1,13,11,1,2015,21,12579,2447,15026
1,13,11,1,2015,22,12302,2381,14683
1,13,11,1,2015,23,12001,2301,14302
1,13,11,1,2015,24,12355,2253,14608
2,14,11,1,2015,1,12466,2169,14635
2,14,11,1,2015,2,12296,2013,14309
2,14,11,1,2015,3,12072,1902,13974
2,14,11,1,2015,4,12019,1818,13837
2,14,11,1,2015,5,12218,1792,14010
2,14,11,1,2015,6,12782,1822,14604
2,14,11,1,2015,7,13280,1830,15110
2,14,11,1,2015,8,14139,1851,15990
2,14,11,1,2015,9,14381,1995,16376
2,14,11,1,2015,10,14509,2175,16684
2,14,11,1,2015,11,15201,2331,17532
2,14,11,1,2015,12,14766,2444,17210
2,14,11,1,2015,13,14787,2459,17246
2,14,11,1,2015,14,14608,2379,16987
2,14,11,1,2015,15,14409,2390,16799
2,14,11,1,2015,16,14449,2396,16845
2,14,11,1,2015,17,14243,2383,16626
2,14,11,1,2015,18,12812,2372,15184
2,14,11,1,2015,19,13620,2523,16143
2,14,11,1,2015,20,13775,2528,16303
2,14,11,1,2015,21,13062,2483,15545
2,14,11,1,2015,22,12543,2436,14979
2,14,11,1,2015,23,12193,2346,14539
2,14,11,1,2015,24,12039,2245,14284
2,15,11,1,2015,1,12712,2144,14856
2,15,11,1,2015,2,12546,1986,14532
2,15,11,1,2015,3,12372,1884,14256
2,15,11,1,2015,4,12440,1811,14251
2,15,11,1,2015,5,12762,1775,14537
2,15,11,1,2015,6,13590,1800,15390
2,15,11,1,2015,7,14078,1802,15880
2,15,11,1,2015,8,14614,1801,16415
2,15,11,1,2015,9,15059,1874,16933
2,15,11,1,2015,10,15112,1975,17087
2,15,11,1,2015,11,15503,2069,17572
2,15,11,1,2015,12,15555,2117,17672
2,15,11,1,2015,13,15015,2132,17147
2,15,11,1,2015,14,14725,2099,16824
2,15,11,1,2015,15,14855,2093,16948
2,15,11,1,2015,16,14524,2101,16625
2,15,11,1,2015,17,14145,2087,16232
2,15,11,1,2015,18,13160,2096,15256
2,15,11,1,2015,19,13570,2289,15859
2,15,11,1,2015,20,13670,2309,15979
2,15,11,1,2015,21,13225,2310,15535
2,15,11,1,2015,22,12567,2303,14870
2,15,11,1,2015,23,12275,2264,14539
2,15,11,1,2015,24,12009,2236,14245
1,16,11,1,2015,1,12857,2137,14994
1,16,11,1,2015,2,12874,1988,14862
1,16,11,1,2015,3,12680,1876,14556
1,16,11,1,2015,4,12604,1808,14412
1,16,11,1,2015,5,13383,1777,15160
1,16,11,1,2015,6,13386,1832,15218
1,16,11,1,2015,7,14035,1900,15935
1,16,11,1,2015,8,15106,2026,17132
1,16,11,1,2015,9,15400,2335,17735
1,16,11,1,2015,10,15516,2690,18206
1,16,11,1,2015,11,16121,2928,19049
1,16,11,1,2015,12,15824,2966,18790
1,16,11,1,2015,13,15554,2997,18551
1,16,11,1,2015,14,15167,2914,18081
1,16,11,1,2015,15,15394,2931,18325
1,16,11,1,2015,16,15593,2949,18542
1,16,11,1,2015,17,14926,2925,17851
1,16,11,1,2015,18,14091,2871,16962
1,16,11,1,2015,19,14538,2905,17443
1,16,11,1,2015,20,14552,2830,17382
1,16,11,1,2015,21,13814,2679,16493
1,16,11,1,2015,22,13472,2544,16016
1,16,11,1,2015,23,13375,2403,15778
1,16,11,1,2015,24,13208,2316,15524
1,17,11,1,2015,1,13468,2207,15675
1,17,11,1,2015,2,13512,2021,15533
1,17,11,1,2015,3,13124,1915,15039
1,17,11,1,2015,4,13412,1847,15259
1,17,11,1,2015,5,13515,1812,15327
1,17,11,1,2015,6,13817,1866,15683
1,17,11,1,2015,7,14413,1916,16329
1,17,11,1,2015,8,15562,2054,17616
1,17,11,1,2015,9,16028,2298,18326
1,17,11,1,2015,10,15863,2718,18581
1,17,11,1,2015,11,16460,2951,19411
1,17,11,1,2015,12,16544,3007,19551
1,17,11,1,2015,13,15742,3005,18747
1,17,11,1,2015,14,15450,2900,18350
1,17,11,1,2015,15,15653,2929,18582
1,17,11,1,2015,16,15678,2947,18625
1,17,11,1,2015,17,15110,2912,18022
1,17,11,1,2015,18,14260,2872,17132
1,17,11,1,2015,19,14602,2891,17493
1,17,11,1,2015,20,14577,2820,17397
1,17,11,1,2015,21,13916,2649,16565
1,17,11,1,2015,22,13200,2477,15677
1,17,11,1,2015,23,12601,2370,14971
1,17,11,1,2015,24,13005,2291,15296
1,18,11,1,2015,1,13170,2147,15317
1,18,11,1,2015,2,12767,1972,14739
1,18,11,1,2015,3,12883,1865,14748
1,18,11,1,2015,4,12877,1796,14673
1,18,11,1,2015,5,13415,1770,15185
1,18,11,1,2015,6,13574,1832,15406
1,18,11,1,2015,7,14464,1901,16365
1,18,11,1,2015,8,15484,2036,17520
1,18,11,1,2015,9,15713,2324,18037
1,18,11,1,2015,10,16277,2700,18977
1,18,11,1,2015,11,16100,2910,19010
1,18,11,1,2015,12,15459,2962,18421
1,18,11,1,2015,13,15001,2959,17960
1,18,11,1,2015,14,14894,2831,17725
1,18,11,1,2015,15,14683,2859,17542
1,18,11,1,2015,16,15240,2888,18128
1,18,11,1,2015,17,14829,2884,17713
1,18,11,1,2015,18,13533,2818,16351
1,18,11,1,2015,19,14630,2930,17560
1,18,11,1,2015,20,14365,2866,17231
1,18,11,1,2015,21,13699,2699,16398
1,18,11,1,2015,22,12908,2490,15398
1,18,11,1,2015,23,12663,2400,15063
1,18,11,1,2015,24,12604,2299,14903
1,19,11,1,2015,1,12748,2127,14875
1,19,11,1,2015,2,12488,1960,14448
1,19,11,1,2015,3,12424,1846,14270
1,19,11,1,2015,4,12610,1761,14371
1,19,11,1,2015,5,12616,1736,14352
1,19,11,1,2015,6,13231,1798,15029
1,19,11,1,2015,7,14190,1875,16065
1,19,11,1,2015,8,14814,2002,16816
1,19,11,1,2015,9,15411,2279,17690
1,19,11,1,2015,10,15793,2609,18402
1,19,11,1,2015,11,15431,2864,18295
1,19,11,1,2015,12,15431,2897,18328
1,19,11,1,2015,13,14825,2880,17705
1,19,11,1,2015,14,15132,2764,17896
1,19,11,1,2015,15,15078,2789,17867
1,19,11,1,2015,16,14931,2805,17736
1,19,11,1,2015,17,14852,2810,17662
1,19,11,1,2015,18,13691,2790,16481
1,19,11,1,2015,19,14531,2836,17367
1,19,11,1,2015,20,14259,2757,17016
1,19,11,1,2015,21,13519,2613,16132
1,19,11,1,2015,22,12667,2386,15053
1,19,11,1,2015,23,12247,2303,14550
1,19,11,1,2015,24,12484,2172,14656
1,20,11,1,2015,1,12683,2000,14683
1,20,11,1,2015,2,12645,1875,14520
1,20,11,1,2015,3,12490,1801,14291
1,20,11,1,2015,4,12528,1751,14279
1,20,11,1,2015,5,12876,1725,14601
1,20,11,1,2015,6,13220,1785,15005
1,20,11,1,2015,7,13969,1832,15801
1,20,11,1,2015,8,15115,1947,17062
1,20,11,1,2015,9,15652,2191,17843
1,20,11,1,2015,10,15483,2431,17914
1,20,11,1,2015,11,15560,2798,18358
1,20,11,1,2015,12,14831,2948,17779
1,20,11,1,2015,13,15134,2983,18116
1,20,11,1,2015,14,14868,2871,17739
1,20,11,1,2015,15,14945,2923,17868
1,20,11,1,2015,16,14743,2961,17704
1,20,11,1,2015,17,14508,2909,17417
1,20,11,1,2015,18,13302,2860,16162
1,20,11,1,2015,19,14327,2887,17214
1,20,11,1,2015,20,14192,2799,16991
1,20,11,1,2015,21,13645,2581,16226
1,20,11,1,2015,22,12845,2541,15386
1,20,11,1,2015,23,12738,2375,15113
1,20,11,1,2015,24,13020,2314,15334
2,21,11,1,2015,1,12961,2198,15159
2,21,11,1,2015,2,12956,2023,14979
2,21,11,1,2015,3,12693,1909,14602
2,21,11,1,2015,4,12691,1831,14522
2,21,11,1,2015,5,13134,1797,14931
2,21,11,1,2015,6,13586,1854,15440
2,21,11,1,2015,7,14218,1902,16120
2,21,11,1,2015,8,15507,2004,17511
2,21,11,1,2015,9,15900,2235,18135
2,21,11,1,2015,10,16187,2516,18703
2,21,11,1,2015,11,15856,2794,18650
2,21,11,1,2015,12,16348,2885,19233
2,21,11,1,2015,13,16094,2887,18981
2,21,11,1,2015,14,15634,2761,18395
2,21,11,1,2015,15,15530,2763,18293
2,21,11,1,2015,16,15807,2753,18560
2,21,11,1,2015,17,14783,2703,17486
2,21,11,1,2015,18,14246,2725,16971
2,21,11,1,2015,19,14507,2804,17311
2,21,11,1,2015,20,14610,2727,17337
2,21,11,1,2015,21,14081,2592,16673
2,21,11,1,2015,22,13338,2461,15799
2,21,11,1,2015,23,13199,2360,15559
2,21,11,1,2015,24,13144,2272,15416
2,22,11,1,2015,1,13367,2181,15548
2,22,11,1,2015,2,12828,2018,14846
2,22,11,1,2015,3,12828,1907,14735
2,22,11,1,2015,4,12666,1833,14499
2,22,11,1,2015,5,12745,1812,14557
2,22,11,1,2015,6,13306,1847,15153
2,22,11,1,2015,7,14033,1848,15881
2,22,11,1,2015,8,14466,1851,16317
2,22,11,1,2015,9,15037,1940,16977
2,22,11,1,2015,10,15154,2073,17227
2,22,11,1,2015,11,15464,2206,17670
2,22,11,1,2015,12,15728,2231,17959
2,22,11,1,2015,13,15265,2228,17493
2,22,11,1,2015,14,15421,2196,17617
2,22,11,1,2015,15,15391,2175,17566
2,22,11,1,2015,16,14917,2141,17058
2,22,11,1,2015,17,14136,2122,16258
2,22,11,1,2015,18,13519,2149,15668
2,22,11,1,2015,19,14079,2376,16455
2,22,11,1,2015,20,13544,2383,15927
2,22,11,1,2015,21,13155,2328,15483
2,22,11,1,2015,22,12346,2250,14596
2,22,11,1,2015,23,12432,2193,14625
2,22,11,1,2015,24,12287,2140,14427
1,23,11,1,2015,1,12448,2035,14483
1,23,11,1,2015,2,12525,1882,14407
1,23,11,1,2015,3,11874,1788,13662
1,23,11,1,2015,4,11954,1732,13686
1,23,11,1,2015,5,12110,1713,13823
1,23,11,1,2015,6,12624,1805,14429
1,23,11,1,2015,7,13223,1898,15121
1,23,11,1,2015,8,13972,2053,16025
1,23,11,1,2015,9,14552,2352,16904
1,23,11,1,2015,10,14596,2736,17332
1,23,11,1,2015,11,15113,2988,18101
1,23,11,1,2015,12,15046,3051,18097
1,23,11,1,2015,13,14966,3044,18010
1,23,11,1,2015,14,14899,2959,17858
1,23,11,1,2015,15,14706,2985,17691
1,23,11,1,2015,16,14865,3011,17876
1,23,11,1,2015,17,14119,2978,17097
1,23,11,1,2015,18,14013,2940,16953
1,23,11,1,2015,19,14456,2974,17430
1,23,11,1,2015,20,13953,2915,16868
1,23,11,1,2015,21,13352,2704,16056
1,23,11,1,2015,22,13175,2587,15762
1,23,11,1,2015,23,12831,2471,15302
1,23,11,1,2015,24,12800,2373,15173
3,25,11,1,2015,1,13309,2253,15562
3,25,11,1,2015,2,13112,2048,15160
3,25,11,1,2015,3,13014,1925,14939
3,25,11,1,2015,4,13011,1851,14862
3,25,11,1,2015,5,13232,1824,15056
3,25,11,1,2015,6,13369,1879,15248
3,25,11,1,2015,7,13969,1941,15910
3,25,11,1,2015,8,15081,2065,17146
3,25,11,1,2015,9,15373,2318,17691
3,25,11,1,2015,10,15375,2675,18050
3,25,11,1,2015,11,15794,2912,18706
3,25,11,1,2015,12,15703,2969,18672
3,25,11,1,2015,13,15280,2961,18241
3,25,11,1,2015,14,14945,2859,17804
3,25,11,1,2015,15,15148,2889,18037
3,25,11,1,2015,16,15226,2880,18106
3,25,11,1,2015,17,14826,2883,17709
3,25,11,1,2015,18,14195,2891,17086
3,25,11,1,2015,19,14809,2958,17767
3,25,11,1,2015,20,14673,2920,17593
3,25,11,1,2015,21,14261,2761,17022
3,25,11,1,2015,22,13709,2630,16339
3,25,11,1,2015,23,13597,2537,16134
3,25,11,1,2015,24,13302,2468,15770
1,26,11,1,2015,1,13272,2293,15565
1,26,11,1,2015,2,13052,2104,15156
1,26,11,1,2015,3,12958,1978,14936
1,26,11,1,2015,4,12814,1895,14709
1,26,11,1,2015,5,12848,1879,14727
1,26,11,1,2015,6,13760,1932,15692
1,26,11,1,2015,7,14571,2043,16614
1,26,11,1,2015,8,15024,2181,17205
1,26,11,1,2015,9,15282,2515,17797
1,26,11,1,2015,10,15685,2813,18498
1,26,11,1,2015,11,15686,3123,18809
1,26,11,1,2015,12,15632,3130,18762
1,26,11,1,2015,13,15198,3127,18325
1,26,11,1,2015,14,14745,3027,17772
1,26,11,1,2015,15,15076,3070,18146
1,26,11,1,2015,16,15156,3079,18235
1,26,11,1,2015,17,14445,3053,17498
1,26,11,1,2015,18,14167,3007,17174
1,26,11,1,2015,19,14660,3037,17697
1,26,11,1,2015,20,14336,2952,17288
1,26,11,1,2015,21,13750,2796,16546
1,26,11,1,2015,22,13365,2640,16005
1,26,11,1,2015,23,13127,2550,15677
1,26,11,1,2015,24,13211,2468,15679
1,27,11,1,2015,1,13344,2331,15675
1,27,11,1,2015,2,13134,2126,15260
1,27,11,1,2015,3,13110,2008,15118
1,27,11,1,2015,4,13200,1930,15130
1,27,11,1,2015,5,13241,1898,15139
1,27,11,1,2015,6,13871,1963,15834
1,27,11,1,2015,7,14596,2065,16661
1,27,11,1,2015,8,15083,2170,17253
1,27,11,1,2015,9,15203,2461,17664
1,27,11,1,2015,10,15050,2751,17801
1,27,11,1,2015,11,15172,2999,18171
1,27,11,1,2015,12,15212,3015,18227
1,27,11,1,2015,13,14728,3013,17741
1,27,11,1,2015,14,14586,2892,17478
1,27,11,1,2015,15,14633,2927,17560
1,27,11,1,2015,16,14476,2941,17417
1,27,11,1,2015,17,13811,2919,16730
1,27,11,1,2015,18,13314,2843,16157
1,27,11,1,2015,19,14066,2880,16946
1,27,11,1,2015,20,14030,2804,16834
1,27,11,1,2015,21,13416,2548,15964
1,27,11,1,2015,22,12964,2434,15398
1,27,11,1,2015,23,12927,2300,15227
1,27,11,1,2015,24,12939,2228,15167
2,28,11,1,2015,1,12920,2079,14999
2,28,11,1,2015,2,12734,1914,14648
2,28,11,1,2015,3,12620,1810,14430
2,28,11,1,2015,4,12578,1737,14315
2,28,11,1,2015,5,12879,1717,14596
2,28,11,1,2015,6,13413,1788,15201
2,28,11,1,2015,7,14091,1847,15938
2,28,11,1,2015,8,15021,1920,16941
2,28,11,1,2015,9,15541,2106,17647
2,28,11,1,2015,10,15149,2373,17522
2,28,11,1,2015,11,15582,2625,18207
2,28,11,1,2015,12,15729,2638,18367
2,28,11,1,2015,13,15484,2633,18117
2,28,11,1,2015,14,14742,2525,17267
2,28,11,1,2015,15,15201,2507,17708
2,28,11,1,2015,16,15221,2493,17714
2,28,11,1,2015,17,14680,2460,17140
2,28,11,1,2015,18,14101,2449,16550
2,28,11,1,2015,19,14636,2550,17186
2,28,11,1,2015,20,14318,2511,16829
2,28,11,1,2015,21,13738,2397,16135
2,28,11,1,2015,22,12935,2317,15252
2,28,11,1,2015,23,12908,2174,15082
2,28,11,1,2015,24,12883,2076,14959
2,29,11,1,2015,1,13099,1884,14983
2,29,11,1,2015,2,12877,1754,14631
2,29,11,1,2015,3,12730,1667,14397
2,29,11,1,2015,4,12602,1615,14217
2,29,11,1,2015,5,13074,1608,14682
2,29,11,1,2015,6,13490,1669,15159
2,29,11,1,2015,7,13759,1684,15443
2,29,11,1,2015,8,14675,1724,16399
2,29,11,1,2015,9,14898,1793,16691
2,29,11,1,2015,10,15317,1909,17226
2,29,11,1,2015,11,15509,2062,17571
2,29,11,1,2015,12,15460,2087,17547
2,29,11,1,2015,13,15415,2106,17521
2,29,11,1,2015,14,14902,2065,16967
2,29,11,1,2015,15,14974,2044,17018
2,29,11,1,2015,16,14933,2029,16962
2,29,11,1,2015,17,14264,2010,16274
2,29,11,1,2015,18,13493,2033,15526
2,29,11,1,2015,19,13873,2230,16103
2,29,11,1,2015,20,13962,2265,16227
2,29,11,1,2015,21,13067,2248,15315
2,29,11,1,2015,22,12893,2188,15081
2,29,11,1,2015,23,12542,2160,14702
2,29,11,1,2015,24,12554,2101,14655
1,30,11,1,2015,1,12977,1985,14962
1,30,11,1,2015,2,12681,1812,14493
1,30,11,1,2015,3,12470,1724,14194
1,30,11,1,2015,4,12570,1658,14228
1,30,11,1,2015,5,12610,1651,14260
1,30,11,1,2015,6,13164,1734,14898
1,30,11,1,2015,7,14328,1880,16208
1,30,11,1,2015,8,15310,2021,17331
1,30,11,1,2015,9,15497,2262,17759
1,30,11,1,2015,10,15537,2653,18190
1,30,11,1,2015,11,16092,2899,18991
1,30,11,1,2015,12,16167,2956,19123
1,30,11,1,2015,13,15741,2944,18685
1,30,11,1,2015,14,15505,2863,18368
1,30,11,1,2015,15,15419,2897,18316
1,30,11,1,2015,16,15662,2898,18560
1,30,11,1,2015,17,14796,2880,17676
1,30,11,1,2015,18,14350,2839,17189
1,30,11,1,2015,19,14572,2890,17462
1,30,11,1,2015,20,14193,2855,17048
1,30,11,1,2015,21,14165,2665,16830
1,30,11,1,2015,22,13718,2521,16239
1,30,11,1,2015,23,13177,2405,15582
1,30,11,1,2015,24,13633,2276,15909
1,1,12,1,2015,1,13777,2081,15858
1,1,12,1,2015,2,13734,1911,15645
1,1,12,1,2015,3,13588,1808,15396
1,1,12,1,2015,4,13388,1735,15123
1,1,12,1,2015,5,13560,1723,15283
1,1,12,1,2015,6,13967,1821,15788
1,1,12,1,2015,7,15016,1954,16970
1,1,12,1,2015,8,15746,2074,17820
1,1,12,1,2015,9,16069,2396,18465
1,1,12,1,2015,10,15998,2695,18693
1,1,12,1,2015,11,16289,2957,19246
1,1,12,1,2015,12,16506,3020,19526
1,1,12,1,2015,13,15783,3010,18793
1,1,12,1,2015,14,15670,2955,18625
1,1,12,1,2015,15,15870,2987,18857
1,1,12,1,2015,16,15599,2996,18595
1,1,12,1,2015,17,15238,2961,18199
1,1,12,1,2015,18,13949,2913,16862
1,1,12,1,2015,19,14469,2964,17433
1,1,12,1,2015,20,14652,2869,17521
1,1,12,1,2015,21,14055,2747,16802
1,1,12,1,2015,22,13498,2556,16054
1,1,12,1,2015,23,13323,2434,15757
1,1,12,1,2015,24,14047,2337,16384
1,2,12,1,2015,1,13858,2125,15983
1,2,12,1,2015,2,13464,1983,15447
1,2,12,1,2015,3,13585,1866,15451
1,2,12,1,2015,4,13503,1788,15291
1,2,12,1,2015,5,13804,1772,15576
1,2,12,1,2015,6,14315,1859,16174
1,2,12,1,2015,7,15133,2010,17143
1,2,12,1,2015,8,16118,2130,18248
1,2,12,1,2015,9,16274,2457,18731
1,2,12,1,2015,10,16435,2678,19113
1,2,12,1,2015,11,16375,2945,19320
1,2,12,1,2015,12,16522,3032,19554
1,2,12,1,2015,13,16089,3027,19116
1,2,12,1,2015,14,15633,2950,18583
1,2,12,1,2015,15,14966,2990,17956
1,2,12,1,2015,16,15606,3001,18607
1,2,12,1,2015,17,14933,2989,17922
1,2,12,1,2015,18,14045,2922,16967
1,2,12,1,2015,19,14984,2963,17947
1,2,12,1,2015,20,14407,2891,17298
1,2,12,1,2015,21,13836,2715,16551
1,2,12,1,2015,22,13224,2567,15791
1,2,12,1,2015,23,13026,2442,15468
1,2,12,1,2015,24,13117,2301,15418
1,3,12,1,2015,1,13215,2131,15346
1,3,12,1,2015,2,13166,1949,15115
1,3,12,1,2015,3,13206,1842,15048
1,3,12,1,2015,4,13199,1769,14968
1,3,12,1,2015,5,13167,1743,14910
1,3,12,1,2015,6,14284,1829,16113
1,3,12,1,2015,7,14795,1968,16763
1,3,12,1,2015,8,15636,2057,17693
1,3,12,1,2015,9,15452,2353,17805
1,3,12,1,2015,10,15772,2693,18465
1,3,12,1,2015,11,15936,2902,18838
1,3,12,1,2015,12,15766,2972,18738
1,3,12,1,2015,13,15492,2971,18463
1,3,12,1,2015,14,15187,2887,18074
1,3,12,1,2015,15,15532,2921,18453
1,3,12,1,2015,16,15718,2929,18647
1,3,12,1,2015,17,14932,2899,17831
1,3,12,1,2015,18,13988,2848,16836
1,3,12,1,2015,19,14839,2868,17707
1,3,12,1,2015,20,14458,2809,17267
1,3,12,1,2015,21,13937,2646,16583
1,3,12,1,2015,22,13368,2471,15839
1,3,12,1,2015,23,13406,2322,15728
1,3,12,1,2015,24,13325,2214,15539
1,4,12,1,2015,1,13253,2061,15314
1,4,12,1,2015,2,13285,1876,15161
1,4,12,1,2015,3,13090,1785,14875
1,4,12,1,2015,4,13263,1711,14974
1,4,12,1,2015,5,13253,1709,14962
1,4,12,1,2015,6,13960,1790,15750
1,4,12,1,2015,7,14904,1938,16842
1,4,12,1,2015,8,15693,2057,17750
1,4,12,1,2015,9,15691,2284,17975
1,4,12,1,2015,10,15650,2698,18348
1,4,12,1,2015,11,15677,2865,18542
1,4,12,1,2015,12,15297,2948,18245
1,4,12,1,2015,13,15187,2944,18131
1,4,12,1,2015,14,14777,2853,17630
1,4,12,1,2015,15,14815,2882,17697
1,4,12,1,2015,16,15072,2921,17993
1,4,12,1,2015,17,14228,2904,17132
1,4,12,1,2015,18,13407,2856,16263
1,4,12,1,2015,19,14321,2898,17219
1,4,12,1,2015,20,14004,2784,16788
1,4,12,1,2015,21,13215,2607,15822
1,4,12,1,2015,22,12718,2434,15152
1,4,12,1,2015,23,12533,2288,14821
1,4,12,1,2015,24,12671,2186,14857
2,5,12,1,2015,1,12890,2032,14922
2,5,12,1,2015,2,12676,1866,14542
2,5,12,1,2015,3,12569,1767,14336
2,5,12,1,2015,4,12379,1694,14073
2,5,12,1,2015,5,12818,1675,14493
2,5,12,1,2015,6,13329,1751,15080
2,5,12,1,2015,7,14428,1837,16265
2,5,12,1,2015,8,15216,1916,17132
2,5,12,1,2015,9,15331,2184,17515
2,5,12,1,2015,10,15738,2437,18175
2,5,12,1,2015,11,15778,2713,18491
2,5,12,1,2015,12,15709,2758,18467
2,5,12,1,2015,13,15478,2756,18234
2,5,12,1,2015,14,15205,2633,17838
2,5,12,1,2015,15,15324,2647,17971
2,5,12,1,2015,16,15262,2651,17913
2,5,12,1,2015,17,14810,2646,17456
2,5,12,1,2015,18,13872,2614,16486
2,5,12,1,2015,19,14491,2695,17186
2,5,12,1,2015,20,14199,2650,16849
2,5,12,1,2015,21,13369,2511,15880
2,5,12,1,2015,22,12752,2386,15138
2,5,12,1,2015,23,12640,2214,14854
2,5,12,1,2015,24,12832,2172,15004
2,6,12,1,2015,1,12891,2008,14899
2,6,12,1,2015,2,12833,1853,14686
2,6,12,1,2015,3,12540,1750,14290
2,6,12,1,2015,4,12448,1687,14135
2,6,12,1,2015,5,13053,1660,14713
2,6,12,1,2015,6,13441,1709,15150
2,6,12,1,2015,7,14140,1735,15875
2,6,12,1,2015,8,14838,1742,16580
2,6,12,1,2015,9,15402,1817,17219
2,6,12,1,2015,10,15533,1943,17476
2,6,12,1,2015,11,15465,2047,17512
2,6,12,1,2015,12,15279,2084,17363
2,6,12,1,2015,13,15230,2134,17364
2,6,12,1,2015,14,14532,2082,16614
2,6,12,1,2015,15,14762,2050,16812
2,6,12,1,2015,16,14734,2034,16768
2,6,12,1,2015,17,14088,2008,16096
2,6,12,1,2015,18,12983,2046,15029
2,6,12,1,2015,19,13729,2227,15956
2,6,12,1,2015,20,13635,2234,15869
2,6,12,1,2015,21,13055,2227,15282
2,6,12,1,2015,22,12441,2223,14664
2,6,12,1,2015,23,12011,2187,14198
2,6,12,1,2015,24,12110,2144,14254
1,7,12,1,2015,1,12207,1972,14179
1,7,12,1,2015,2,12103,1807,13910
1,7,12,1,2015,3,11965,1707,13672
1,7,12,1,2015,4,11920,1643,13563
1,7,12,1,2015,5,12182,1639,13821
1,7,12,1,2015,6,12920,1735,14655
1,7,12,1,2015,7,14185,1883,16068
1,7,12,1,2015,8,15170,2003,17173
1,7,12,1,2015,9,15349,2260,17609
1,7,12,1,2015,10,15918,2622,18540
1,7,12,1,2015,11,16286,2795,19081
1,7,12,1,2015,12,15379,2878,18257
1,7,12,1,2015,13,15408,2869,18277
1,7,12,1,2015,14,15381,2810,18191
1,7,12,1,2015,15,15508,2827,18335
1,7,12,1,2015,16,15609,2821,18430
1,7,12,1,2015,17,15130,2842,17972
1,7,12,1,2015,18,13602,2803,16405
1,7,12,1,2015,19,14324,2824,17148
1,7,12,1,2015,20,14076,2731,16807
1,7,12,1,2015,21,13546,2599,16145
1,7,12,1,2015,22,12976,2419,15395
1,7,12,1,2015,23,12362,2272,14634
1,7,12,1,2015,24,12484,2172,14656
1,8,12,1,2015,1,12454,1992,14446
1,8,12,1,2015,2,12407,1838,14245
1,8,12,1,2015,3,12469,1741,14210
1,8,12,1,2015,4,12440,1684,14124
1,8,12,1,2015,5,12528,1674,14202
1,8,12,1,2015,6,13387,1766,15153
1,8,12,1,2015,7,14305,1900,16205
1,8,12,1,2015,8,15598,2002,17600
1,8,12,1,2015,9,15714,2312,18026
1,8,12,1,2015,10,15914,2597,18511
1,8,12,1,2015,11,15880,2807,18687
1,8,12,1,2015,12,15939,2883,18822
1,8,12,1,2015,13,15691,2877,18568
1,8,12,1,2015,14,15271,2763,18034
1,8,12,1,2015,15,15329,2799,18128
1,8,12,1,2015,16,15463,2815,18278
1,8,12,1,2015,17,15140,2798,17938
1,8,12,1,2015,18,13846,2771,16617
1,8,12,1,2015,19,14701,2830,17531
1,8,12,1,2015,20,14278,2755,17033
1,8,12,1,2015,21,13485,2562,16047
1,8,12,1,2015,22,12383,2414,14797
1,8,12,1,2015,23,12460,2279,14739
1,8,12,1,2015,24,12297,2145,14442
1,9,12,1,2015,1,12492,1969,14461
1,9,12,1,2015,2,12366,1795,14161
1,9,12,1,2015,3,12093,1702,13795
1,9,12,1,2015,4,12207,1646,13853
1,9,12,1,2015,5,12467,1625,14092
1,9,12,1,2015,6,13136,1733,14869
1,9,12,1,2015,7,14286,1884,16170
1,9,12,1,2015,8,15207,1990,17197
1,9,12,1,2015,9,15421,2223,17644
1,9,12,1,2015,10,15783,2566,18349
1,9,12,1,2015,11,15997,2817,18814
1,9,12,1,2015,12,16282,2845,19127
1,9,12,1,2015,13,15484,2816,18300
1,9,12,1,2015,14,15022,2721,17743
1,9,12,1,2015,15,15505,2758,18263
1,9,12,1,2015,16,15863,2758,18621
1,9,12,1,2015,17,14568,2756,17324
1,9,12,1,2015,18,13727,2735,16462
1,9,12,1,2015,19,14703,2802,17505
1,9,12,1,2015,20,14234,2752,16986
1,9,12,1,2015,21,13478,2608,16086
1,9,12,1,2015,22,12603,2467,15070
1,9,12,1,2015,23,12383,2312,14695
1,9,12,1,2015,24,12166,2203,14369
1,10,12,1,2015,1,12572,1978,14550
1,10,12,1,2015,2,12496,1805,14301
1,10,12,1,2015,3,12653,1692,14345
1,10,12,1,2015,4,12422,1629,14051
1,10,12,1,2015,5,12834,1623,14457
1,10,12,1,2015,6,13636,1721,15357
1,10,12,1,2015,7,14507,1862,16369
1,10,12,1,2015,8,15633,1991,17624
1,10,12,1,2015,9,15662,2285,17947
1,10,12,1,2015,10,16195,2571,18766
1,10,12,1,2015,11,16123,2836,18959
1,10,12,1,2015,12,16123,2860,18983
1,10,12,1,2015,13,15608,2855,18463
1,10,12,1,2015,14,15626,2758,18384
1,10,12,1,2015,15,15562,2783,18345
1,10,12,1,2015,16,14955,2804,17759
1,10,12,1,2015,17,15476,2790,18266
1,10,12,1,2015,18,13968,2749,16717
1,10,12,1,2015,19,15136,2797,17933
1,10,12,1,2015,20,14317,2738,17055
1,10,12,1,2015,21,13209,2594,15803
1,10,12,1,2015,22,12903,2413,15316
1,10,12,1,2015,23,12652,2263,14915
1,10,12,1,2015,24,12623,2120,14743
1,11,12,1,2015,1,12861,1934,14795
1,11,12,1,2015,2,12862,1771,14633
1,11,12,1,2015,3,12785,1681,14466
1,11,12,1,2015,4,12630,1630,14260
1,11,12,1,2015,5,13153,1636,14789
1,11,12,1,2015,6,13613,1734,15347
1,11,12,1,2015,7,14900,1896,16796
1,11,12,1,2015,8,15785,2030,17815
1,11,12,1,2015,9,15872,2344,18216
1,11,12,1,2015,10,15965,2616,18581
1,11,12,1,2015,11,16047,2878,18925
1,11,12,1,2015,12,15946,2911,18857
1,11,12,1,2015,13,15250,2905,18155
1,11,12,1,2015,14,15200,2748,17948
1,11,12,1,2015,15,15084,2770,17854
1,11,12,1,2015,16,14924,2731,17655
1,11,12,1,2015,17,14407,2686,17093
1,11,12,1,2015,18,13441,2677,16118
1,11,12,1,2015,19,14294,2720,17014
1,11,12,1,2015,20,13965,2647,16612
1,11,12,1,2015,21,13515,2461,15976
1,11,12,1,2015,22,12921,2314,15235
1,11,12,1,2015,23,12551,2135,14686
1,11,12,1,2015,24,12617,1999,14616
2,12,12,1,2015,1,12854,1846,14700
2,12,12,1,2015,2,12800,1700,14500
2,12,12,1,2015,3,12770,1621,14391
2,12,12,1,2015,4,12773,1565,14338
2,12,12,1,2015,5,13156,1563,14719
2,12,12,1,2015,6,14023,1648,15671
2,12,12,1,2015,7,14683,1728,16411
2,12,12,1,2015,8,15756,1827,17583
2,12,12,1,2015,9,15952,1941,17893
2,12,12,1,2015,10,15900,2249,18149
2,12,12,1,2015,11,16323,2443,18766
2,12,12,1,2015,12,16005,2465,18470
2,12,12,1,2015,13,15826,2463,18289
2,12,12,1,2015,14,15565,2351,17916
2,12,12,1,2015,15,15488,2346,17834
2,12,12,1,2015,16,15477,2328,17805
2,12,12,1,2015,17,14796,2320,17116
2,12,12,1,2015,18,13949,2310,16259
2,12,12,1,2015,19,14683,2464,17147
2,12,12,1,2015,20,14291,2438,16729
2,12,12,1,2015,21,13818,2288,16106
2,12,12,1,2015,22,12781,2208,14989
2,12,12,1,2015,23,12732,1922,14654
2,12,12,1,2015,24,12689,1889,14578
2,13,12,1,2015,1,12971,1741,14712
2,13,12,1,2015,2,13114,1609,14723
2,13,12,1,2015,3,13186,1543,14729
2,13,12,1,2015,4,12931,1502,14433
2,13,12,1,2015,5,13395,1505,14900
2,13,12,1,2015,6,13989,1565,15554
2,13,12,1,2015,7,14601,1603,16204
2,13,12,1,2015,8,15438,1643,17081
2,13,12,1,2015,9,15854,1740,17594
2,13,12,1,2015,10,15896,1865,17761
2,13,12,1,2015,11,16156,1976,18132
2,13,12,1,2015,12,16149,2008,18157
2,13,12,1,2015,13,15810,1973,17783
2,13,12,1,2015,14,14883,1906,16789
2,13,12,1,2015,15,15329,1841,17170
2,13,12,1,2015,16,15194,1800,16994
2,13,12,1,2015,17,14544,1793,16337
2,13,12,1,2015,18,13483,1836,15319
2,13,12,1,2015,19,13998,2020,16018
2,13,12,1,2015,20,14008,2041,16049
2,13,12,1,2015,21,13450,2035,15485
2,13,12,1,2015,22,12802,1965,14767
2,13,12,1,2015,23,12562,1875,14437
2,13,12,1,2015,24,12827,1763,14590
1,14,12,1,2015,1,12850,1674,14524
1,14,12,1,2015,2,13052,1547,14599
1,14,12,1,2015,3,12512,1482,13994
1,14,12,1,2015,4,12716,1442,14158
1,14,12,1,2015,5,13006,1465,14471
1,14,12,1,2015,6,13651,1580,15231
1,14,12,1,2015,7,14836,1759,16595
1,14,12,1,2015,8,15794,1925,17719
1,14,12,1,2015,9,15758,2140,17898
1,14,12,1,2015,10,16167,2489,18656
1,14,12,1,2015,11,16268,2714,18982
1,14,12,1,2015,12,16432,2728,19160
1,14,12,1,2015,13,16111,2715,18826
1,14,12,1,2015,14,15469,2618,18087
1,14,12,1,2015,15,15950,2621,18571
1,14,12,1,2015,16,15904,2627,18531
1,14,12,1,2015,17,15369,2617,17986
1,14,12,1,2015,18,14287,2592,16879
1,14,12,1,2015,19,15000,2652,17652
1,14,12,1,2015,20,14759,2609,17368
1,14,12,1,2015,21,14322,2463,16785
1,14,12,1,2015,22,13487,2295,15782
1,14,12,1,2015,23,13105,2106,15211
1,14,12,1,2015,24,12808,1969,14777
1,15,12,1,2015,1,13378,1769,15147
1,15,12,1,2015,2,13333,1637,14970
1,15,12,1,2015,3,13347,1558,14905
1,15,12,1,2015,4,13101,1512,14613
1,15,12,1,2015,5,13368,1518,14886
1,15,12,1,2015,6,14664,1624,16288
1,15,12,1,2015,7,14976,1795,16771
1,15,12,1,2015,8,15924,1918,17842
1,15,12,1,2015,9,16087,2205,18292
1,15,12,1,2015,10,16241,2531,18772
1,15,12,1,2015,11,16687,2722,19409
1,15,12,1,2015,12,16577,2776,19353
1,15,12,1,2015,13,16166,2773,18939
1,15,12,1,2015,14,15475,2677,18152
1,15,12,1,2015,15,15927,2715,18642
1,15,12,1,2015,16,15691,2713,18404
1,15,12,1,2015,17,15445,2716,18161
1,15,12,1,2015,18,14361,2697,17058
1,15,12,1,2015,19,14936,2762,17698
1,15,12,1,2015,20,14702,2660,17362
1,15,12,1,2015,21,14359,2499,16858
1,15,12,1,2015,22,13547,2353,15900
1,15,12,1,2015,23,12906,2188,15094
1,15,12,1,2015,24,13086,2036,15122
1,16,12,1,2015,1,13448,1803,15251
1,16,12,1,2015,2,13498,1643,15141
1,16,12,1,2015,3,13255,1564,14819
1,16,12,1,2015,4,13139,1514,14653
1,16,12,1,2015,5,13789,1518,15307
1,16,12,1,2015,6,14371,1633,16004
1,16,12,1,2015,7,15430,1827,17257
1,16,12,1,2015,8,16106,1984,18090
1,16,12,1,2015,9,16474,2198,18672
1,16,12,1,2015,10,16383,2550,18933
1,16,12,1,2015,11,16725,2792,19517
1,16,12,1,2015,12,16428,2809,19237
1,16,12,1,2015,13,16064,2797,18861
1,16,12,1,2015,14,15744,2665,18409
1,16,12,1,2015,15,15996,2687,18683
1,16,12,1,2015,16,16101,2680,18781
1,16,12,1,2015,17,15330,2664,17994
1,16,12,1,2015,18,14587,2643,17230
1,16,12,1,2015,19,14801,2684,17485
1,16,12,1,2015,20,14679,2594,17273
1,16,12,1,2015,21,14096,2417,16513
1,16,12,1,2015,22,13331,2282,15613
1,16,12,1,2015,23,13015,2073,15088
1,16,12,1,2015,24,13346,1874,15220
1,17,12,1,2015,1,13227,1710,14937
1,17,12,1,2015,2,13036,1590,14626
1,17,12,1,2015,3,13051,1515,14566
1,17,12,1,2015,4,13312,1481,14793
1,17,12,1,2015,5,13453,1461,14914
1,17,12,1,2015,6,13796,1580,15376
1,17,12,1,2015,7,15168,1748,16916
1,17,12,1,2015,8,16050,1917,17967
1,17,12,1,2015,9,16101,2106,18207
1,17,12,1,2015,10,16259,2444,18703
1,17,12,1,2015,11,16476,2626,19102
1,17,12,1,2015,12,15646,2633,18279
1,17,12,1,2015,13,15932,2607,18539
1,17,12,1,2015,14,15413,2454,17867
1,17,12,1,2015,15,15217,2473,17690
1,17,12,1,2015,16,15508,2507,18015
1,17,12,1,2015,17,14983,2516,17499
1,17,12,1,2015,18,13900,2507,16407
1,17,12,1,2015,19,14536,2568,17104
1,17,12,1,2015,20,14267,2488,16755
1,17,12,1,2015,21,13744,2393,16137
1,17,12,1,2015,22,12977,2179,15156
1,17,12,1,2015,23,12747,2020,14767
1,17,12,1,2015,24,13077,1810,14887
1,18,12,1,2015,1,13101,1625,14726
1,18,12,1,2015,2,12961,1495,14456
1,18,12,1,2015,3,12928,1427,14355
1,18,12,1,2015,4,12768,1383,14151
1,18,12,1,2015,5,13132,1396,14528
1,18,12,1,2015,6,14130,1494,15624
1,18,12,1,2015,7,14854,1682,16536
1,18,12,1,2015,8,15650,1842,17492
1,18,12,1,2015,9,15956,2052,18008
1,18,12,1,2015,10,15548,2352,17900
1,18,12,1,2015,11,15805,2554,18359
1,18,12,1,2015,12,15765,2583,18348
1,18,12,1,2015,13,15339,2599,17938
1,18,12,1,2015,14,15069,2456,17525
1,18,12,1,2015,15,14986,2491,17477
1,18,12,1,2015,16,14611,2513,17124
1,18,12,1,2015,17,14488,2524,17012
1,18,12,1,2015,18,13318,2556,15874
1,18,12,1,2015,19,14057,2611,16668
1,18,12,1,2015,20,13799,2554,16353
1,18,12,1,2015,21,13526,2417,15943
1,18,12,1,2015,22,12394,2227,14621
1,18,12,1,2015,23,12303,2034,14337
1,18,12,1,2015,24,12466,1893,14359
2,19,12,1,2015,1,12526,1691,14217
2,19,12,1,2015,2,12611,1547,14158
2,19,12,1,2015,3,12434,1468,13902
2,19,12,1,2015,4,12555,1429,13984
2,19,12,1,2015,5,12681,1441,14122
2,19,12,1,2015,6,13688,1538,15226
2,19,12,1,2015,7,14712,1656,16368
2,19,12,1,2015,8,15218,1757,16975
2,19,12,1,2015,9,15538,1991,17529
2,19,12,1,2015,10,15851,2287,18138
2,19,12,1,2015,11,15622,2505,18127
2,19,12,1,2015,12,15654,2563,18217
2,19,12,1,2015,13,15345,2559,17904
2,19,12,1,2015,14,14879,2413,17292
2,19,12,1,2015,15,14786,2410,17196
2,19,12,1,2015,16,15048,2418,17466
2,19,12,1,2015,17,14801,2405,17206
2,19,12,1,2015,18,13497,2433,15930
2,19,12,1,2015,19,14560,2539,17099
2,19,12,1,2015,20,13911,2547,16458
2,19,12,1,2015,21,13570,2421,15991
2,19,12,1,2015,22,12727,2286,15013
2,19,12,1,2015,23,12341,2092,14433
2,19,12,1,2015,24,12588,1957,14545
2,20,12,1,2015,1,12854,1768,14622
2,20,12,1,2015,2,12784,1637,14421
2,20,12,1,2015,3,12811,1557,14368
2,20,12,1,2015,4,12884,1500,14384
2,20,12,1,2015,5,13082,1505,14587
2,20,12,1,2015,6,13844,1562,15406
2,20,12,1,2015,7,14477,1625,16102
2,20,12,1,2015,8,15492,1661,17153
2,20,12,1,2015,9,15714,1775,17489
2,20,12,1,2015,10,15667,1939,17606
2,20,12,1,2015,11,15801,2047,17848
2,20,12,1,2015,12,15704,2067,17771
2,20,12,1,2015,13,15224,2063,17287
2,20,12,1,2015,14,14935,2004,16939
2,20,12,1,2015,15,14650,1909,16559
2,20,12,1,2015,16,14767,1874,16641
2,20,12,1,2015,17,13902,1852,15754
2,20,12,1,2015,18,13173,1903,15076
2,20,12,1,2015,19,13761,2097,15858
2,20,12,1,2015,20,13724,2106,15830
2,20,12,1,2015,21,13306,2103,15409
2,20,12,1,2015,22,12591,2083,14674
2,20,12,1,2015,23,12304,1947,14251
2,20,12,1,2015,24,12282,1876,14158
1,21,12,1,2015,1,12565,1673,14238
1,21,12,1,2015,2,12456,1576,14032
1,21,12,1,2015,3,12329,1501,13830
1,21,12,1,2015,4,12519,1458,13977
1,21,12,1,2015,5,12647,1464,14111
1,21,12,1,2015,6,13347,1555,14902
1,21,12,1,2015,7,14484,1714,16198
1,21,12,1,2015,8,15564,1848,17412
1,21,12,1,2015,9,15961,2131,18092
1,21,12,1,2015,10,16057,2452,18509
1,21,12,1,2015,11,16239,2618,18857
1,21,12,1,2015,12,16350,2683,19033
1,21,12,1,2015,13,15697,2644,18341
1,21,12,1,2015,14,15498,2522,18020
1,21,12,1,2015,15,15220,2512,17732
1,21,12,1,2015,16,15387,2512,17899
1,21,12,1,2015,17,14809,2517,17326
1,21,12,1,2015,18,13923,2481,16404
1,21,12,1,2015,19,14239,2542,16781
1,21,12,1,2015,20,14223,2470,16693
1,21,12,1,2015,21,13821,2275,16096
1,21,12,1,2015,22,13029,2146,15175
1,21,12,1,2015,23,12461,1993,14454
1,21,12,1,2015,24,12678,1846,14524
1,22,12,1,2015,1,12689,1615,14304
1,22,12,1,2015,2,12484,1503,13987
1,22,12,1,2015,3,12302,1445,13747
1,22,12,1,2015,4,12222,1420,13642
1,22,12,1,2015,5,12549,1423,13972
1,22,12,1,2015,6,13270,1522,14792
1,22,12,1,2015,7,14542,1680,16222
1,22,12,1,2015,8,15569,1822,17391
1,22,12,1,2015,9,15934,2073,18007
1,22,12,1,2015,10,15910,2365,18275
1,22,12,1,2015,11,16141,2520,18661
1,22,12,1,2015,12,15803,2577,18380
1,22,12,1,2015,13,15350,2540,17890
1,22,12,1,2015,14,15227,2363,17590
1,22,12,1,2015,15,14823,2361,17184
1,22,12,1,2015,16,15155,2352,17507
1,22,12,1,2015,17,14651,2357,17008
1,22,12,1,2015,18,13627,2359,15986
1,22,12,1,2015,19,14226,2441,16667
1,22,12,1,2015,20,14292,2413,16705
1,22,12,1,2015,21,13549,2247,15796
1,22,12,1,2015,22,12801,2105,14906
1,22,12,1,2015,23,12051,1889,13940
1,22,12,1,2015,24,12289,1729,14018
1,23,12,1,2015,1,12427,1513,13940
1,23,12,1,2015,2,12336,1397,13733
1,23,12,1,2015,3,12210,1336,13546
1,23,12,1,2015,4,12122,1296,13418
1,23,12,1,2015,5,12473,1311,13784
1,23,12,1,2015,6,13168,1418,14586
1,23,12,1,2015,7,14198,1586,15784
1,23,12,1,2015,8,15469,1732,17201
1,23,12,1,2015,9,15854,2012,17866
1,23,12,1,2015,10,15930,2301,18231
1,23,12,1,2015,11,15896,2446,18342
1,23,12,1,2015,12,15731,2467,18198
1,23,12,1,2015,13,15103,2434,17537
1,23,12,1,2015,14,14816,2331,17147
1,23,12,1,2015,15,15040,2326,17366
1,23,12,1,2015,16,15000,2325,17325
1,23,12,1,2015,17,14562,2340,16902
1,23,12,1,2015,18,13470,2355,15825
1,23,12,1,2015,19,14304,2432,16736
1,23,12,1,2015,20,14234,2409,16643
1,23,12,1,2015,21,13319,2285,15604
1,23,12,1,2015,22,12746,2076,14822
1,23,12,1,2015,23,12380,1895,14275
1,23,12,1,2015,24,12360,1713,14073
3,24,12,1,2015,1,12489,1530,14019
3,24,12,1,2015,2,12337,1376,13713
3,24,12,1,2015,3,12156,1309,13465
3,24,12,1,2015,4,12113,1272,13385
3,24,12,1,2015,5,12393,1287,13680
3,24,12,1,2015,6,12839,1388,14227
3,24,12,1,2015,7,13868,1507,15375
3,24,12,1,2015,8,14890,1643,16533
3,24,12,1,2015,9,15460,1872,17332
3,24,12,1,2015,10,15635,2167,17802
3,24,12,1,2015,11,15895,2297,18192
3,24,12,1,2015,12,15392,2299,17691
3,24,12,1,2015,13,15055,2281,17336
3,24,12,1,2015,14,14677,2156,16833
3,24,12,1,2015,15,14594,2152,16746
3,24,12,1,2015,16,14656,2158,16814
3,24,12,1,2015,17,14144,2166,16310
3,24,12,1,2015,18,13128,2194,15322
3,24,12,1,2015,19,13617,2306,15923
3,24,12,1,2015,20,13437,2301,15738
3,24,12,1,2015,21,13124,1967,15091
3,24,12,1,2015,22,12345,1887,14232
3,24,12,1,2015,23,11597,1734,13331
3,24,12,1,2015,24,11434,1620,13054
3,25,12,1,2015,1,11414,1536,12950
3,25,12,1,2015,2,11390,1414,12804
3,25,12,1,2015,3,11228,1344,12572
3,25,12,1,2015,4,11174,1258,12432
3,25,12,1,2015,5,11444,1264,12708
3,25,12,1,2015,6,11888,1346,13234
3,25,12,1,2015,7,12701,1420,14121
3,25,12,1,2015,8,13497,1496,14993
3,25,12,1,2015,9,14382,1682,16064
3,25,12,1,2015,10,14492,1904,16396
3,25,12,1,2015,11,14365,2000,16365
3,25,12,1,2015,12,14328,2046,16374
3,25,12,1,2015,13,14118,2055,16173
3,25,12,1,2015,14,13831,1933,15764
3,25,12,1,2015,15,13406,1928,15334
3,25,12,1,2015,16,13608,1928,15536
3,25,12,1,2015,17,13200,1928,15128
3,25,12,1,2015,18,12224,1971,14195
3,25,12,1,2015,19,13087,2107,15194
3,25,12,1,2015,20,13005,2108,15113
3,25,12,1,2015,21,12115,2101,14216
3,25,12,1,2015,22,11219,1974,13193
3,25,12,1,2015,23,10954,1796,12750
3,25,12,1,2015,24,10602,1637,12239
2,26,12,1,2015,1,10891,1445,12336
2,26,12,1,2015,2,10641,1315,11956
2,26,12,1,2015,3,10640,1254,11894
2,26,12,1,2015,4,10679,1214,11893
2,26,12,1,2015,5,10542,1222,11764
2,26,12,1,2015,6,11464,1313,12777
2,26,12,1,2015,7,12347,1415,13762
2,26,12,1,2015,8,13580,1533,15113
2,26,12,1,2015,9,14609,1747,16356
2,26,12,1,2015,10,14994,1926,16920
2,26,12,1,2015,11,15054,2126,17180
2,26,12,1,2015,12,15172,2149,17321
2,26,12,1,2015,13,14548,2141,16689
2,26,12,1,2015,14,14530,2006,16536
2,26,12,1,2015,15,14153,1989,16142
2,26,12,1,2015,16,14441,1990,16431
2,26,12,1,2015,17,14004,1985,15989
2,26,12,1,2015,18,12987,2054,15041
2,26,12,1,2015,19,13903,2201,16104
2,26,12,1,2015,20,13452,2191,15643
2,26,12,1,2015,21,12740,2089,14829
2,26,12,1,2015,22,11517,1993,13510
2,26,12,1,2015,23,11108,1793,12901
2,26,12,1,2015,24,11007,1617,12624
2,27,12,1,2015,1,11005,1464,12469
2,27,12,1,2015,2,10821,1335,12156
2,27,12,1,2015,3,10745,1268,12013
2,27,12,1,2015,4,10945,1236,12181
2,27,12,1,2015,5,11123,1236,12359
2,27,12,1,2015,6,11693,1316,13009
2,27,12,1,2015,7,12399,1380,13779
2,27,12,1,2015,8,13826,1443,15269
2,27,12,1,2015,9,14497,1564,16061
2,27,12,1,2015,10,15107,1722,16829
2,27,12,1,2015,11,15164,1807,16971
2,27,12,1,2015,12,15176,1827,17003
2,27,12,1,2015,13,14452,1805,16257
2,27,12,1,2015,14,14193,1724,15917
2,27,12,1,2015,15,14151,1671,15822
2,27,12,1,2015,16,14073,1635,15708
2,27,12,1,2015,17,13448,1627,15075
2,27,12,1,2015,18,12414,1664,14078
2,27,12,1,2015,19,13182,1883,15065
2,27,12,1,2015,20,12984,1928,14912
2,27,12,1,2015,21,12337,1924,14261
2,27,12,1,2015,22,11028,1872,12900
2,27,12,1,2015,23,10500,1737,12237
2,27,12,1,2015,24,10556,1597,12153
1,28,12,1,2015,1,10987,1438,12425
1,28,12,1,2015,2,10722,1312,12034
1,28,12,1,2015,3,10659,1251,11910
1,28,12,1,2015,4,10739,1222,11961
1,28,12,1,2015,5,11077,1238,12315
1,28,12,1,2015,6,12336,1347,13683
1,28,12,1,2015,7,12994,1492,14486
1,28,12,1,2015,8,14572,1660,16232
1,28,12,1,2015,9,15107,2008,17115
1,28,12,1,2015,10,15994,2261,18255
1,28,12,1,2015,11,15650,2438,18088
1,28,12,1,2015,12,15151,2456,17607
1,28,12,1,2015,13,14808,2444,17252
1,28,12,1,2015,14,14302,2326,16628
1,28,12,1,2015,15,14211,2312,16523
1,28,12,1,2015,16,14255,2304,16559
1,28,12,1,2015,17,13750,2309,16059
1,28,12,1,2015,18,12869,2329,15198
1,28,12,1,2015,19,13548,2384,15932
1,28,12,1,2015,20,13438,2353,15791
1,28,12,1,2015,21,12911,2225,15136
1,28,12,1,2015,22,11609,2089,13698
1,28,12,1,2015,23,11276,1892,13168
1,28,12,1,2015,24,10897,1705,12602
1,29,12,1,2015,1,11106,1529,12635
1,29,12,1,2015,2,11227,1401,12628
1,29,12,1,2015,3,11369,1331,12700
1,29,12,1,2015,4,11148,1294,12442
1,29,12,1,2015,5,11464,1284,12748
1,29,12,1,2015,6,12294,1397,13691
1,29,12,1,2015,7,13235,1525,14760
1,29,12,1,2015,8,15058,1724,16782
1,29,12,1,2015,9,15266,1994,17260
1,29,12,1,2015,10,15601,2334,17935
1,29,12,1,2015,11,15881,2529,18410
1,29,12,1,2015,12,15442,2558,18000
1,29,12,1,2015,13,15303,2553,17856
1,29,12,1,2015,14,14353,2404,16757
1,29,12,1,2015,15,14043,2434,16477
1,29,12,1,2015,16,14413,2444,16857
1,29,12,1,2015,17,14125,2447,16572
1,29,12,1,2015,18,13213,2446,15659
1,29,12,1,2015,19,13704,2519,16223
1,29,12,1,2015,20,13460,2494,15954
1,29,12,1,2015,21,13021,2274,15295
1,29,12,1,2015,22,11923,2149,14072
1,29,12,1,2015,23,11490,1948,13438
1,29,12,1,2015,24,11481,1803,13284
1,30,12,1,2015,1,11567,1594,13161
1,30,12,1,2015,2,11280,1483,12763
1,30,12,1,2015,3,11331,1412,12743
1,30,12,1,2015,4,11628,1376,13004
1,30,12,1,2015,5,11827,1380,13207
1,30,12,1,2015,6,12519,1467,13986
1,30,12,1,2015,7,13336,1588,14924
1,30,12,1,2015,8,15076,1779,16855
1,30,12,1,2015,9,15912,2063,17975
1,30,12,1,2015,10,16017,2395,18412
1,30,12,1,2015,11,15965,2579,18544
1,30,12,1,2015,12,15764,2602,18366
1,30,12,1,2015,13,15109,2589,17698
1,30,12,1,2015,14,14462,2485,16947
1,30,12,1,2015,15,14396,2500,16896
1,30,12,1,2015,16,14382,2491,16873
1,30,12,1,2015,17,14000,2498,16498
1,30,12,1,2015,18,12965,2490,15455
1,30,12,1,2015,19,13683,2585,16268
1,30,12,1,2015,20,13755,2512,16267
1,30,12,1,2015,21,12937,2339,15276
1,30,12,1,2015,22,12065,2156,14221
1,30,12,1,2015,23,11479,1957,13436
1,30,12,1,2015,24,11464,1807,13271
1,31,12,1,2015,1,11691,1601,13292
1,31,12,1,2015,2,11648,1463,13111
1,31,12,1,2015,3,11688,1454,13142
1,31,12,1,2015,4,11573,1424,12997
1,31,12,1,2015,5,11913,1418,13331
1,31,12,1,2015,6,12260,1455,13715
1,31,12,1,2015,7,13629,1592,15221
1,31,12,1,2015,8,15059,1774,16833
1,31,12,1,2015,9,15317,2058,17375
1,31,12,1,2015,10,15524,2415,17939
1,31,12,1,2015,11,15835,2583,18418
1,31,12,1,2015,12,15506,2612,18118
1,31,12,1,2015,13,15105,2609,17714
1,31,12,1,2015,14,14220,2489,16709
1,31,12,1,2015,15,14069,2507,16576
1,31,12,1,2015,16,14397,2524,16921
1,31,12,1,2015,17,13467,2511,15978
1,31,12,1,2015,18,12692,2494,15186
1,31,12,1,2015,19,13247,2512,15759
1,31,12,1,2015,20,13411,2506,15917
1,31,12,1,2015,21,12641,2330,14971
1,31,12,1,2015,22,11886,2154,14040
1,31,12,1,2015,23,11331,1972,13303
1,31,12,1,2015,24,11398,1840,13238
1,1,1,1,2016,1,11403,1708,13111
1,1,1,1,2016,2,11364,1585,12949
1,1,1,1,2016,3,11246,1517,12763
1,1,1,1,2016,4,11152,1464,12616
1,1,1,1,2016,5,11450,1449,12899
1,1,1,1,2016,6,12015,1527,13542
1,1,1,1,2016,7,12946,1602,14548
1,1,1,1,2016,8,14185,1695,15880
1,1,1,1,2016,9,14817,1893,16710
1,1,1,1,2016,10,14784,2151,16935
1,1,1,1,2016,11,14708,2306,17014
1,1,1,1,2016,12,14466,2371,16837
1,1,1,1,2016,13,13983,2369,16352
1,1,1,1,2016,14,13377,2273,15650
1,1,1,1,2016,15,13378,2272,15650
1,1,1,1,2016,16,13383,2269,15652
1,1,1,1,2016,17,12837,2250,15087
1,1,1,1,2016,18,11893,2238,14131
1,1,1,1,2016,19,12877,2313,15190
1,1,1,1,2016,20,12781,2331,15112
1,1,1,1,2016,21,12211,2181,14392
1,1,1,1,2016,22,11404,2069,13473
1,1,1,1,2016,23,11235,1957,13192
1,1,1,1,2016,24,11266,1847,13113
2,2,1,1,2016,1,17,11228,1689
2,2,1,1,2016,2,10,11117,1554
2,2,1,1,2016,3,10,10992,1485
2,2,1,1,2016,4,10,11374,1447
2,2,1,1,2016,5,10,11639,1446
2,2,1,1,2016,6,13,12259,1528
2,2,1,1,2016,7,13,13259,1628
2,2,1,1,2016,8,13,14463,1720
2,2,1,1,2016,9,13,15352,1944
2,2,1,1,2016,10,13,15309,2254
2,2,1,1,2016,11,13,15448,2433
2,2,1,1,2016,12,13,15696,2473
2,2,1,1,2016,13,13,15022,2471
2,2,1,1,2016,14,14,14538,2356
2,2,1,1,2016,15,11,14168,2349
2,2,1,1,2016,16,11,14545,2332
2,2,1,1,2016,17,11,14104,2314
2,2,1,1,2016,18,11,13002,2305
2,2,1,1,2016,19,11,14199,2376
2,2,1,1,2016,20,11,13444,2440
2,2,1,1,2016,21,11,13038,2267
2,2,1,1,2016,22,11,12223,2135
2,2,1,1,2016,23,11,11705,1967
2,2,1,1,2016,24,11,11482,1818
2,3,1,1,2016,1,11784,1645,13429
2,3,1,1,2016,2,11754,1535,13289
2,3,1,1,2016,3,11739,1461,13200
2,3,1,1,2016,4,11612,1424,13036
2,3,1,1,2016,5,11921,1416,13337
2,3,1,1,2016,6,12385,1491,13876
2,3,1,1,2016,7,13489,1556,15045
2,3,1,1,2016,8,14811,1592,16403
2,3,1,1,2016,9,15188,1685,16873
2,3,1,1,2016,10,15819,1816,17635
2,3,1,1,2016,11,15391,1900,17291
2,3,1,1,2016,12,15543,1907,17450
2,3,1,1,2016,13,15025,1942,16967
2,3,1,1,2016,14,14297,1862,16159
2,3,1,1,2016,15,14203,1782,15985
2,3,1,1,2016,16,14123,1755,15878
2,3,1,1,2016,17,13743,1752,15495
2,3,1,1,2016,18,12529,1785,14314
2,3,1,1,2016,19,13402,1936,15338
2,3,1,1,2016,20,13214,2000,15214
2,3,1,1,2016,21,12549,2002,14551
2,3,1,1,2016,22,11819,1970,13789
2,3,1,1,2016,23,11357,1870,13227
2,3,1,1,2016,24,11615,1748,13363
1,4,1,1,2016,1,11920,1528,13448
1,4,1,1,2016,2,11514,1406,12920
1,4,1,1,2016,3,11476,1368,12844
1,4,1,1,2016,4,11375,1342,12717
1,4,1,1,2016,5,11671,1350,13021
1,4,1,1,2016,6,12408,1464,13872
1,4,1,1,2016,7,13674,1631,15305
1,4,1,1,2016,8,14842,1827,16669
1,4,1,1,2016,9,15382,2071,17453
1,4,1,1,2016,10,15807,2382,18189
1,4,1,1,2016,11,15572,2543,18115
1,4,1,1,2016,12,15517,2613,18130
1,4,1,1,2016,13,15108,2578,17686
1,4,1,1,2016,14,14658,2485,17143
1,4,1,1,2016,15,14481,2526,17007
1,4,1,1,2016,16,14897,2518,17415
1,4,1,1,2016,17,14343,2510,16853
1,4,1,1,2016,18,13195,2483,15678
1,4,1,1,2016,19,13814,2513,16327
1,4,1,1,2016,20,13986,2472,16458
1,4,1,1,2016,21,13257,2315,15572
1,4,1,1,2016,22,12596,2171,14767
1,4,1,1,2016,23,11865,1996,13861
1,4,1,1,2016,24,11754,1823,13577
1,5,1,1,2016,1,11797,1659,13456
1,5,1,1,2016,2,11888,1538,13426
1,5,1,1,2016,3,11732,1471,13203
1,5,1,1,2016,4,11917,1434,13351
1,5,1,1,2016,5,11890,1444,13334
1,5,1,1,2016,6,12644,1553,14197
1,5,1,1,2016,7,13745,1723,15468
1,5,1,1,2016,8,15219,1891,17110
1,5,1,1,2016,9,15439,2082,17521
1,5,1,1,2016,10,15810,2398,18208
1,5,1,1,2016,11,15758,2591,18349
1,5,1,1,2016,12,15625,2621,18246
1,5,1,1,2016,13,15098,2619,17717
1,5,1,1,2016,14,14680,2525,17205
1,5,1,1,2016,15,15086,2530,17616
1,5,1,1,2016,16,14903,2548,17451
1,5,1,1,2016,17,14624,2561,17185
1,5,1,1,2016,18,13467,2541,16008
1,5,1,1,2016,19,14164,2576,16740
1,5,1,1,2016,20,13866,2491,16357
1,5,1,1,2016,21,13456,2379,15835
1,5,1,1,2016,22,12491,2192,14683
1,5,1,1,2016,23,12130,2047,14177
1,5,1,1,2016,24,12038,1833,13871
1,6,1,1,2016,1,12233,1696,13929
1,6,1,1,2016,2,12002,1573,13575
1,6,1,1,2016,3,12095,1504,13599
1,6,1,1,2016,4,11961,1465,13426
1,6,1,1,2016,5,12133,1471,13604
1,6,1,1,2016,6,13001,1571,14572
1,6,1,1,2016,7,14143,1739,15882
1,6,1,1,2016,8,15085,1924,17009
1,6,1,1,2016,9,15545,2163,17708
1,6,1,1,2016,10,15975,2442,18417
1,6,1,1,2016,11,15463,2666,18129
1,6,1,1,2016,12,15795,2688,18483
1,6,1,1,2016,13,15251,2669,17920
1,6,1,1,2016,14,14929,2560,17489
1,6,1,1,2016,15,14859,2584,17443
1,6,1,1,2016,16,15053,2586,17639
1,6,1,1,2016,17,14545,2571,17116
1,6,1,1,2016,18,13559,2565,16124
1,6,1,1,2016,19,14106,2611,16717
1,6,1,1,2016,20,14215,2551,16766
1,6,1,1,2016,21,13284,2452,15736
1,6,1,1,2016,22,12731,2240,14971
1,6,1,1,2016,23,12195,2039,14234
1,6,1,1,2016,24,12308,1891,14199
1,7,1,1,2016,1,12097,1742,13839
1,7,1,1,2016,2,11968,1582,13550
1,7,1,1,2016,3,11787,1523,13310
1,7,1,1,2016,4,11576,1479,13055
1,7,1,1,2016,5,12167,1484,13651
1,7,1,1,2016,6,12709,1598,14307
1,7,1,1,2016,7,14105,1755,15860
1,7,1,1,2016,8,15295,1951,17246
1,7,1,1,2016,9,15599,2179,17778
1,7,1,1,2016,10,15380,2496,17876
1,7,1,1,2016,11,15633,2651,18284
1,7,1,1,2016,12,15362,2680,18042
1,7,1,1,2016,13,14584,2670,17254
1,7,1,1,2016,14,14406,2560,16966
1,7,1,1,2016,15,14266,2582,16848
1,7,1,1,2016,16,14423,2599,17022
1,7,1,1,2016,17,14061,2578,16639
1,7,1,1,2016,18,13093,2560,15653
1,7,1,1,2016,19,13581,2596,16177
1,7,1,1,2016,20,13710,2546,16256
1,7,1,1,2016,21,12992,2432,15424
1,7,1,1,2016,22,12277,2211,14488
1,7,1,1,2016,23,11686,2063,13749
1,7,1,1,2016,24,11608,1900,13508
1,8,1,1,2016,1,11716,1731,13447
1,8,1,1,2016,2,11738,1584,13322
1,8,1,1,2016,3,11687,1518,13205
1,8,1,1,2016,4,11699,1482,13181
1,8,1,1,2016,5,11966,1483,13449
1,8,1,1,2016,6,12729,1587,14316
1,8,1,1,2016,7,13925,1753,15678
1,8,1,1,2016,8,15097,1906,17003
1,8,1,1,2016,9,15627,2163,17790
1,8,1,1,2016,10,15697,2463,18160
1,8,1,1,2016,11,15506,2647,18153
1,8,1,1,2016,12,15182,2688,17870
1,8,1,1,2016,13,14602,2649,17251
1,8,1,1,2016,14,14442,2518,16960
1,8,1,1,2016,15,14037,2567,16604
1,8,1,1,2016,16,14192,2571,16763
1,8,1,1,2016,17,13626,2575,16201
1,8,1,1,2016,18,12823,2559,15382
1,8,1,1,2016,19,13505,2577,16082
1,8,1,1,2016,20,13597,2541,16138
1,8,1,1,2016,21,12982,2347,15329
1,8,1,1,2016,22,12220,2220,14440
1,8,1,1,2016,23,11548,2091,13639
1,8,1,1,2016,24,11755,1928,13683
2,9,1,1,2016,1,12061,1688,13749
2,9,1,1,2016,2,11722,1564,13286
2,9,1,1,2016,3,11662,1501,13163
2,9,1,1,2016,4,11702,1465,13167
2,9,1,1,2016,5,11908,1473,13381
2,9,1,1,2016,6,12750,1555,14305
2,9,1,1,2016,7,13581,1697,15278
2,9,1,1,2016,8,15128,1778,16906
2,9,1,1,2016,9,15467,1984,17451
2,9,1,1,2016,10,15589,2124,17713
2,9,1,1,2016,11,15645,2367,18012
2,9,1,1,2016,12,15551,2397,17948
2,9,1,1,2016,13,15172,2303,17475
2,9,1,1,2016,14,14771,2181,16952
2,9,1,1,2016,15,14731,2170,16901
2,9,1,1,2016,16,14714,2161,16875
2,9,1,1,2016,17,14492,2195,16687
2,9,1,1,2016,18,13274,2185,15459
2,9,1,1,2016,19,13876,2259,16135
2,9,1,1,2016,20,13948,2274,16222
2,9,1,1,2016,21,13134,2163,15297
2,9,1,1,2016,22,12275,2070,14345
2,9,1,1,2016,23,11708,1926,13634
2,9,1,1,2016,24,11582,1815,13397
2,10,1,1,2016,1,11871,1637,13508
2,10,1,1,2016,2,11803,1512,13315
2,10,1,1,2016,3,11715,1448,13163
2,10,1,1,2016,4,11754,1401,13155
2,10,1,1,2016,5,12005,1402,13407
2,10,1,1,2016,6,12682,1461,14143
2,10,1,1,2016,7,13599,1513,15112
2,10,1,1,2016,8,14767,1558,16325
2,10,1,1,2016,9,15269,1667,16936
2,10,1,1,2016,10,15552,1794,17346
2,10,1,1,2016,11,15569,1911,17480
2,10,1,1,2016,12,15542,1918,17460
2,10,1,1,2016,13,14976,1930,16906
2,10,1,1,2016,14,14535,1860,16395
2,10,1,1,2016,15,14330,1817,16147
2,10,1,1,2016,16,14391,1781,16172
2,10,1,1,2016,17,13800,1761,15561
2,10,1,1,2016,18,12930,1780,14710
2,10,1,1,2016,19,13123,1950,15073
2,10,1,1,2016,20,13359,1996,15355
2,10,1,1,2016,21,12739,1997,14736
2,10,1,1,2016,22,12011,1974,13985
2,10,1,1,2016,23,11484,1877,13361
2,10,1,1,2016,24,11621,1748,13369
1,11,1,1,2016,1,11627,1542,13169
1,11,1,1,2016,2,11735,1422,13157
1,11,1,1,2016,3,11641,1367,13008
1,11,1,1,2016,4,11467,1350,12817
1,11,1,1,2016,5,11612,1364,12976
1,11,1,1,2016,6,12529,1462,13991
1,11,1,1,2016,7,13800,1655,15455
1,11,1,1,2016,8,15044,1817,16861
1,11,1,1,2016,9,15598,2154,17752
1,11,1,1,2016,10,15703,2336,18039
1,11,1,1,2016,11,15775,2543,18318
1,11,1,1,2016,12,15339,2622,17961
1,11,1,1,2016,13,15065,2580,17645
1,11,1,1,2016,14,14764,2462,17226
1,11,1,1,2016,15,14654,2501,17155
1,11,1,1,2016,16,14502,2509,17011
1,11,1,1,2016,17,14359,2506,16865
1,11,1,1,2016,18,13434,2493,15927
1,11,1,1,2016,19,13691,2525,16216
1,11,1,1,2016,20,14172,2483,16655
1,11,1,1,2016,21,13242,2390,15632
1,11,1,1,2016,22,12530,2170,14700
1,11,1,1,2016,23,11802,1987,13789
1,11,1,1,2016,24,12027,1806,13833
1,12,1,1,2016,1,11897,1656,13553
1,12,1,1,2016,2,12108,1532,13640
1,12,1,1,2016,3,11828,1465,13293
1,12,1,1,2016,4,11887,1429,13316
1,12,1,1,2016,5,12050,1435,13486
1,12,1,1,2016,6,12699,1549,14248
1,12,1,1,2016,7,14049,1734,15783
1,12,1,1,2016,8,15480,1887,17367
1,12,1,1,2016,9,16080,2147,18227
1,12,1,1,2016,10,15974,2428,18402
1,12,1,1,2016,11,15702,2647,18349
1,12,1,1,2016,12,15345,2660,18005
1,12,1,1,2016,13,15138,2636,17774
1,12,1,1,2016,14,14689,2496,17185
1,12,1,1,2016,15,14567,2510,17077
1,12,1,1,2016,16,14765,2515,17280
1,12,1,1,2016,17,14355,2509,16864
1,12,1,1,2016,18,13529,2498,16027
1,12,1,1,2016,19,14054,2527,16581
1,12,1,1,2016,20,14222,2507,16729
1,12,1,1,2016,21,13167,2392,15559
1,12,1,1,2016,22,13062,2153,15215
1,12,1,1,2016,23,12143,1976,14119
1,12,1,1,2016,24,11595,1813,13408
1,13,1,1,2016,1,11741,1616,13357
1,13,1,1,2016,2,11826,1467,13293
1,13,1,1,2016,3,11922,1410,13332
1,13,1,1,2016,4,12072,1374,13446
1,13,1,1,2016,5,12284,1381,13665
1,13,1,1,2016,6,13127,1499,14626
1,13,1,1,2016,7,14143,1682,15825
1,13,1,1,2016,8,15243,1813,17056
1,13,1,1,2016,9,16254,2131,18385
1,13,1,1,2016,10,16135,2395,18530
1,13,1,1,2016,11,16006,2540,18546
1,13,1,1,2016,12,15759,2599,18358
1,13,1,1,2016,13,15362,2541,17903
1,13,1,1,2016,14,14985,2436,17421
1,13,1,1,2016,15,14832,2414,17246
1,13,1,1,2016,16,14596,2423,17019
1,13,1,1,2016,17,14618,2429,17047
1,13,1,1,2016,18,13502,2404,15906
1,13,1,1,2016,19,14444,2471,16915
1,13,1,1,2016,20,14159,2451,16610
1,13,1,1,2016,21,13553,2346,15899
1,13,1,1,2016,22,12615,2224,14839
1,13,1,1,2016,23,11899,2060,13959
1,13,1,1,2016,24,11870,1778,13648
1,14,1,1,2016,1,12080,1572,13652
1,14,1,1,2016,2,12065,1448,13513
1,14,1,1,2016,3,11954,1386,13340
1,14,1,1,2016,4,12185,1357,13542
1,14,1,1,2016,5,12499,1360,13859
1,14,1,1,2016,6,13358,1477,14835
1,14,1,1,2016,7,14701,1662,16363
1,14,1,1,2016,8,15977,1804,17781
1,14,1,1,2016,9,16088,2067,18155
1,14,1,1,2016,10,16241,2356,18597
1,14,1,1,2016,11,16144,2503,18647
1,14,1,1,2016,12,15345,2538,17883
1,14,1,1,2016,13,14774,2489,17263
1,14,1,1,2016,14,14649,2374,17023
1,14,1,1,2016,15,14393,2387,16780
1,14,1,1,2016,16,14788,2402,17190
1,14,1,1,2016,17,13988,2384,16372
1,14,1,1,2016,18,13277,2365,15642
1,14,1,1,2016,19,13796,2425,16221
1,14,1,1,2016,20,14383,2391,16774
1,14,1,1,2016,21,13571,2273,15844
1,14,1,1,2016,22,12817,2102,14919
1,14,1,1,2016,23,12107,1929,14036
1,14,1,1,2016,24,12203,1758,13961
1,15,1,1,2016,1,12107,1537,13644
1,15,1,1,2016,2,12131,1413,13544
1,15,1,1,2016,3,12134,1352,13486
1,15,1,1,2016,4,11927,1317,13244
1,15,1,1,2016,5,12358,1333,13691
1,15,1,1,2016,6,13141,1456,14597
1,15,1,1,2016,7,14277,1630,15907
1,15,1,1,2016,8,15698,1742,17440
1,15,1,1,2016,9,16165,2079,18244
1,15,1,1,2016,10,16162,2345,18507
1,15,1,1,2016,11,15586,2496,18082
1,15,1,1,2016,12,15234,2563,17797
1,15,1,1,2016,13,14765,2497,17262
1,15,1,1,2016,14,14240,2349,16589
1,15,1,1,2016,15,14186,2316,16502
1,15,1,1,2016,16,14241,2325,16566
1,15,1,1,2016,17,13831,2314,16145
1,15,1,1,2016,18,13142,2264,15406
1,15,1,1,2016,19,13403,2301,15704
1,15,1,1,2016,20,13799,2314,16113
1,15,1,1,2016,21,13357,2194,15551
1,15,1,1,2016,22,12650,2061,14711
1,15,1,1,2016,23,12504,1916,14420
1,15,1,1,2016,24,11869,1790,13659
2,16,1,1,2016,1,12000,1507,13507
2,16,1,1,2016,2,11815,1384,13199
2,16,1,1,2016,3,11862,1315,13177
2,16,1,1,2016,4,11896,1283,13179
2,16,1,1,2016,5,12045,1292,13337
2,16,1,1,2016,6,12843,1402,14245
2,16,1,1,2016,7,14044,1557,15601
2,16,1,1,2016,8,15461,1652,17113
2,16,1,1,2016,9,15891,1887,17778
2,16,1,1,2016,10,16103,2168,18271
2,16,1,1,2016,11,16038,2321,18359
2,16,1,1,2016,12,15570,2358,17928
2,16,1,1,2016,13,15383,2293,17676
2,16,1,1,2016,14,14955,2177,17132
2,16,1,1,2016,15,14569,2163,16732
2,16,1,1,2016,16,14599,2173,16772
2,16,1,1,2016,17,14231,2165,16396
2,16,1,1,2016,18,13379,2158,15537
2,16,1,1,2016,19,13598,2220,15818
2,16,1,1,2016,20,14140,2289,16429
2,16,1,1,2016,21,13339,2188,15527
2,16,1,1,2016,22,12527,2059,14586
2,16,1,1,2016,23,12178,1897,14075
2,16,1,1,2016,24,12103,1762,13865
2,17,1,1,2016,1,12174,1522,13696
2,17,1,1,2016,2,12043,1389,13432
2,17,1,1,2016,3,12024,1324,13348
2,17,1,1,2016,4,12244,1281,13525
2,17,1,1,2016,5,12174,1290,13464
2,17,1,1,2016,6,12726,1362,14088
2,17,1,1,2016,7,13778,1420,15198
2,17,1,1,2016,8,15129,1480,16609
2,17,1,1,2016,9,15517,1597,17114
2,17,1,1,2016,10,15938,1745,17683
2,17,1,1,2016,11,15970,1837,17807
2,17,1,1,2016,12,15617,1868,17485
2,17,1,1,2016,13,14778,1827,16605
2,17,1,1,2016,14,14606,1736,16342
2,17,1,1,2016,15,14148,1696,15844
2,17,1,1,2016,16,14046,1642,15688
2,17,1,1,2016,17,13577,1600,15177
2,17,1,1,2016,18,12488,1648,14136
2,17,1,1,2016,19,12939,1800,14739
2,17,1,1,2016,20,13564,1931,15495
2,17,1,1,2016,21,12737,1901,14638
2,17,1,1,2016,22,11947,1861,13808
2,17,1,1,2016,23,11727,1734,13461
2,17,1,1,2016,24,11850,1585,13435
1,18,1,1,2016,1,12056,1434,13490
1,18,1,1,2016,2,11800,1317,13117
1,18,1,1,2016,3,11640,1259,12899
1,18,1,1,2016,4,11408,1241,12649
1,18,1,1,2016,5,11929,1257,13186
1,18,1,1,2016,6,12583,1385,13968
1,18,1,1,2016,7,13792,1579,15371
1,18,1,1,2016,8,15528,1735,17263
1,18,1,1,2016,9,15685,1979,17664
1,18,1,1,2016,10,15970,2254,18224
1,18,1,1,2016,11,16075,2418,18493
1,18,1,1,2016,12,15572,2452,18024
1,18,1,1,2016,13,15046,2408,17454
1,18,1,1,2016,14,14539,2293,16832
1,18,1,1,2016,15,14674,2303,16977
1,18,1,1,2016,16,14464,2303,16767
1,18,1,1,2016,17,14187,2289,16476
1,18,1,1,2016,18,12966,2262,15228
1,18,1,1,2016,19,13652,2295,15947
1,18,1,1,2016,20,13937,2294,16231
1,18,1,1,2016,21,13271,2198,15469
1,18,1,1,2016,22,12566,2033,14599
1,18,1,1,2016,23,11886,1838,13724
1,18,1,1,2016,24,11837,1653,13490
1,19,1,1,2016,1,12308,1440,13748
1,19,1,1,2016,2,12108,1321,13429
1,19,1,1,2016,3,12005,1274,13279
1,19,1,1,2016,4,11912,1250,13162
1,19,1,1,2016,5,12170,1260,13430
1,19,1,1,2016,6,12619,1400,14019
1,19,1,1,2016,7,14004,1593,15597
1,19,1,1,2016,8,15721,1743,17464
1,19,1,1,2016,9,16045,1974,18019
1,19,1,1,2016,10,15984,2265,18249
1,19,1,1,2016,11,15951,2402,18353
1,19,1,1,2016,12,15535,2449,17984
1,19,1,1,2016,13,14928,2390,17318
1,19,1,1,2016,14,14655,2257,16912
1,19,1,1,2016,15,14418,2268,16686
1,19,1,1,2016,16,14371,2259,16630
1,19,1,1,2016,17,13940,2268,16208
1,19,1,1,2016,18,13095,2267,15362
1,19,1,1,2016,19,13800,2293,16093
1,19,1,1,2016,20,14034,2306,16340
1,19,1,1,2016,21,13431,2170,15601
1,19,1,1,2016,22,12582,2031,14613
1,19,1,1,2016,23,11813,1806,13619
1,19,1,1,2016,24,11760,1691,13451
1,20,1,1,2016,1,11847,1416,13263
1,20,1,1,2016,2,11865,1299,13164
1,20,1,1,2016,3,11916,1244,13160
1,20,1,1,2016,4,11832,1208,13040
1,20,1,1,2016,5,11661,1228,12889
1,20,1,1,2016,6,13268,1351,14619
1,20,1,1,2016,7,13837,1555,15392
1,20,1,1,2016,8,15508,1717,17225
1,20,1,1,2016,9,15805,1943,17748
1,20,1,1,2016,10,15834,2248,18082
1,20,1,1,2016,11,15716,2340,18056
1,20,1,1,2016,12,15260,2379,17639
1,20,1,1,2016,13,14846,2340,17186
1,20,1,1,2016,14,14479,2196,16675
1,20,1,1,2016,15,14498,2230,16728
1,20,1,1,2016,16,14588,2234,16822
1,20,1,1,2016,17,14136,2227,16363
1,20,1,1,2016,18,13080,2223,15303
1,20,1,1,2016,19,13865,2258,16123
1,20,1,1,2016,20,14128,2309,16437
1,20,1,1,2016,21,13472,2155,15627
1,20,1,1,2016,22,12290,2083,14373
1,20,1,1,2016,23,11743,1835,13578
1,20,1,1,2016,24,11333,1691,13024
1,21,1,1,2016,1,11500,1419,12919
1,21,1,1,2016,2,11508,1291,12799
1,21,1,1,2016,3,11582,1233,12815
1,21,1,1,2016,4,11420,1201,12621
1,21,1,1,2016,5,11695,1217,12912
1,21,1,1,2016,6,12374,1348,13722
1,21,1,1,2016,7,13746,1542,15288
1,21,1,1,2016,8,14772,1743,16515
1,21,1,1,2016,9,15448,1949,17397
1,21,1,1,2016,10,15533,2210,17743
1,21,1,1,2016,11,15083,2355,17438
1,21,1,1,2016,12,14716,2383,17099
1,21,1,1,2016,13,14177,2336,16513
1,21,1,1,2016,14,13844,2206,16050
1,21,1,1,2016,15,13884,2237,16121
1,21,1,1,2016,16,14080,2250,16330
1,21,1,1,2016,17,13512,2255,15767
1,21,1,1,2016,18,12776,2259,15035
1,21,1,1,2016,19,13143,2315,15458
1,21,1,1,2016,20,13937,2333,16270
1,21,1,1,2016,21,12856,2236,15092
1,21,1,1,2016,22,12163,2028,14191
1,21,1,1,2016,23,11478,1855,13333
1,21,1,1,2016,24,11069,1621,12690
1,22,1,1,2016,1,11384,1449,12833
1,22,1,1,2016,2,11094,1324,12418
1,22,1,1,2016,3,11164,1263,12427
1,22,1,1,2016,4,11170,1223,12393
1,22,1,1,2016,5,11302,1241,12543
1,22,1,1,2016,6,12204,1384,13588
1,22,1,1,2016,7,13460,1597,15057
1,22,1,1,2016,8,14875,1768,16643
1,22,1,1,2016,9,15146,2019,17165
1,22,1,1,2016,10,15050,2278,17328
1,22,1,1,2016,11,15369,2422,17791
1,22,1,1,2016,12,14798,2428,17226
1,22,1,1,2016,13,14264,2412,16676
1,22,1,1,2016,14,14295,2279,16574
1,22,1,1,2016,15,13919,2301,16220
1,22,1,1,2016,16,13786,2308,16094
1,22,1,1,2016,17,13341,2318,15659
1,22,1,1,2016,18,12539,2328,14867
1,22,1,1,2016,19,13249,2364,15613
1,22,1,1,2016,20,13670,2359,16029
1,22,1,1,2016,21,13055,2182,15237
1,22,1,1,2016,22,11984,2033,14017
1,22,1,1,2016,23,11485,1843,13328
1,22,1,1,2016,24,11542,1701,13243
2,23,1,1,2016,1,11342,1472,12814
2,23,1,1,2016,2,11013,1336,12349
2,23,1,1,2016,3,11126,1275,12401
2,23,1,1,2016,4,11017,1241,12258
2,23,1,1,2016,5,11150,1252,12402
2,23,1,1,2016,6,11700,1368,13068
2,23,1,1,2016,7,12771,1511,14282
2,23,1,1,2016,8,14795,1625,16420
2,23,1,1,2016,9,15335,1880,17215
2,23,1,1,2016,10,15147,2115,17262
2,23,1,1,2016,11,15794,2269,18063
2,23,1,1,2016,12,15354,2270,17624
2,23,1,1,2016,13,14781,2247,17028
2,23,1,1,2016,14,14016,2163,16179
2,23,1,1,2016,15,14230,2142,16372
2,23,1,1,2016,16,14367,2130,16497
2,23,1,1,2016,17,13987,2144,16131
2,23,1,1,2016,18,12917,2142,15059
2,23,1,1,2016,19,13480,2205,15685
2,23,1,1,2016,20,13766,2301,16067
2,23,1,1,2016,21,13000,2183,15183
2,23,1,1,2016,22,12235,2003,14238
2,23,1,1,2016,23,11479,1886,13365
2,23,1,1,2016,24,11194,1731,12925
2,24,1,1,2016,1,11205,1524,12729
2,24,1,1,2016,2,10976,1393,12369
2,24,1,1,2016,3,11104,1326,12430
2,24,1,1,2016,4,11246,1299,12545
2,24,1,1,2016,5,11475,1293,12768
2,24,1,1,2016,6,12230,1380,13610
2,24,1,1,2016,7,13157,1449,14606
2,24,1,1,2016,8,14438,1533,15971
2,24,1,1,2016,9,15270,1650,16920
2,24,1,1,2016,10,15937,1798,17735
2,24,1,1,2016,11,15881,1923,17804
2,24,1,1,2016,12,15657,1924,17581
2,24,1,1,2016,13,15020,1899,16919
2,24,1,1,2016,14,14316,1825,16141
2,24,1,1,2016,15,14491,1765,16256
2,24,1,1,2016,16,14288,1736,16024
2,24,1,1,2016,17,13489,1712,15201
2,24,1,1,2016,18,12545,1729,14274
2,24,1,1,2016,19,12806,1863,14669
2,24,1,1,2016,20,13240,1981,15221
2,24,1,1,2016,21,12391,1972,14363
2,24,1,1,2016,22,11923,1920,13843
2,24,1,1,2016,23,11535,1812,13347
2,24,1,1,2016,24,11376,1658,13034
1,25,1,1,2016,1,11553,1501,13054
1,25,1,1,2016,2,11546,1369,12915
1,25,1,1,2016,3,11468,1306,12774
1,25,1,1,2016,4,11346,1271,12617
1,25,1,1,2016,5,11695,1295,12990
1,25,1,1,2016,6,12406,1414,13820
1,25,1,1,2016,7,13271,1634,14905
1,25,1,1,2016,8,14907,1826,16733
1,25,1,1,2016,9,15560,2034,17594
1,25,1,1,2016,10,15680,2310,17990
1,25,1,1,2016,11,15446,2507,17953
1,25,1,1,2016,12,15358,2513,17871
1,25,1,1,2016,13,14702,2477,17179
1,25,1,1,2016,14,14529,2363,16892
1,25,1,1,2016,15,14251,2361,16612
1,25,1,1,2016,16,14206,2360,16566
1,25,1,1,2016,17,14125,2347,16472
1,25,1,1,2016,18,12913,2315,15228
1,25,1,1,2016,19,13297,2271,15568
1,25,1,1,2016,20,13733,2284,16017
1,25,1,1,2016,21,13319,2157,15476
1,25,1,1,2016,22,12213,2070,14283
1,25,1,1,2016,23,11575,1913,13488
1,25,1,1,2016,24,11367,1802,13169
3,26,1,1,2016,1,11568,1513,13081
3,26,1,1,2016,2,11500,1404,12904
3,26,1,1,2016,3,11314,1301,12615
3,26,1,1,2016,4,11189,1316,12505
3,26,1,1,2016,5,11676,1299,12975
3,26,1,1,2016,6,12721,1351,14072
3,26,1,1,2016,7,14386,1541,15927
3,26,1,1,2016,8,14674,1550,16224
3,26,1,1,2016,9,14185,1687,15872
3,26,1,1,2016,10,13651,1750,15401
3,26,1,1,2016,11,13364,1810,15174
3,26,1,1,2016,12,13147,1838,14985
3,26,1,1,2016,13,12930,1786,14716
3,26,1,1,2016,14,12600,1740,14340
3,26,1,1,2016,15,12394,1646,14040
3,26,1,1,2016,16,12396,1669,14065
3,26,1,1,2016,17,11943,1646,13589
3,26,1,1,2016,18,10888,1751,12639
3,26,1,1,2016,19,11882,1852,13734
3,26,1,1,2016,20,12236,1905,14141
3,26,1,1,2016,21,11570,1954,13524
3,26,1,1,2016,22,10802,1859,12661
3,26,1,1,2016,23,10622,1756,12378
3,26,1,1,2016,24,10761,1643,12404
1,27,1,1,2016,1,10618,1453,12071
1,27,1,1,2016,2,10749,1321,12070
1,27,1,1,2016,3,10691,1264,11955
1,27,1,1,2016,4,10626,1234,11860
1,27,1,1,2016,5,10822,1264,12086
1,27,1,1,2016,6,12220,1398,13618
1,27,1,1,2016,7,13090,1619,14709
1,27,1,1,2016,8,14744,1805,16549
1,27,1,1,2016,9,14833,2044,16877
1,27,1,1,2016,10,15881,2360,18241
1,27,1,1,2016,11,15430,2515,17945
1,27,1,1,2016,12,15307,2517,17824
1,27,1,1,2016,13,14848,2477,17325
1,27,1,1,2016,14,14671,2342,17013
1,27,1,1,2016,15,14366,2337,16703
1,27,1,1,2016,16,14556,2342,16898
1,27,1,1,2016,17,14330,2339,16669
1,27,1,1,2016,18,13398,2338,15736
1,27,1,1,2016,19,13696,2371,16067
1,27,1,1,2016,20,14180,2394,16574
1,27,1,1,2016,21,13603,2156,15759
1,27,1,1,2016,22,12446,2147,14593
1,27,1,1,2016,23,12108,1875,13983
1,27,1,1,2016,24,12032,1691,13723
1,28,1,1,2016,1,11759,1488,13247
1,28,1,1,2016,2,11978,1354,13332
1,28,1,1,2016,3,11668,1294,12962
1,28,1,1,2016,4,11599,1263,12862
1,28,1,1,2016,5,11892,1272,13164
1,28,1,1,2016,6,12537,1406,13943
1,28,1,1,2016,7,14193,1609,15802
1,28,1,1,2016,8,15566,1845,17411
1,28,1,1,2016,9,16113,2056,18169
1,28,1,1,2016,10,16041,2288,18329
1,28,1,1,2016,11,15947,2504,18451
1,28,1,1,2016,12,15533,2513,18046
1,28,1,1,2016,13,14857,2485,17342
1,28,1,1,2016,14,14526,2370,16896
1,28,1,1,2016,15,14260,2390,16650
1,28,1,1,2016,16,14715,2418,17133
1,28,1,1,2016,17,14188,2430,16618
1,28,1,1,2016,18,13243,2422,15665
1,28,1,1,2016,19,13887,2427,16314
1,28,1,1,2016,20,13998,2439,16437
1,28,1,1,2016,21,13172,2295,15467
1,28,1,1,2016,22,12909,2141,15050
1,28,1,1,2016,23,12139,1940,14079
1,28,1,1,2016,24,12246,1720,13966
1,29,1,1,2016,1,12093,1563,13656
1,29,1,1,2016,2,11958,1428,13386
1,29,1,1,2016,3,12032,1363,13395
1,29,1,1,2016,4,12023,1328,13351
1,29,1,1,2016,5,12244,1342,13586
1,29,1,1,2016,6,13072,1479,14551
1,29,1,1,2016,7,13882,1669,15551
1,29,1,1,2016,8,15616,1864,17480
1,29,1,1,2016,9,15677,2173,17850
1,29,1,1,2016,10,15388,2418,17806
1,29,1,1,2016,11,15438,2599,18037
1,29,1,1,2016,12,15210,2631,17841
1,29,1,1,2016,13,14766,2613,17379
1,29,1,1,2016,14,14360,2480,16840
1,29,1,1,2016,15,14366,2491,16857
1,29,1,1,2016,16,14205,2502,16707
1,29,1,1,2016,17,13908,2498,16406
1,29,1,1,2016,18,13069,2465,15534
1,29,1,1,2016,19,13180,2480,15660
1,29,1,1,2016,20,13900,2502,16402
1,29,1,1,2016,21,13458,2317,15775
1,29,1,1,2016,22,12743,2144,14887
1,29,1,1,2016,23,12155,1979,14134
1,29,1,1,2016,24,11962,1838,13800
2,30,1,1,2016,1,12277,1605,13882
2,30,1,1,2016,2,11724,1483,13207
2,30,1,1,2016,3,11871,1413,13284
2,30,1,1,2016,4,11962,1380,13342
2,30,1,1,2016,5,12023,1388,13411
2,30,1,1,2016,6,12862,1491,14353
2,30,1,1,2016,7,14171,1610,15781
2,30,1,1,2016,8,15582,1762,17344
2,30,1,1,2016,9,16104,2023,18127
2,30,1,1,2016,10,16066,2281,18347
2,30,1,1,2016,11,15602,2478,18080
2,30,1,1,2016,12,15429,2503,17932
2,30,1,1,2016,13,15341,2501,17842
2,30,1,1,2016,14,14862,2357,17219
2,30,1,1,2016,15,14774,2370,17144
2,30,1,1,2016,16,14864,2379,17243
2,30,1,1,2016,17,14671,2361,17032
2,30,1,1,2016,18,13493,2310,15803
2,30,1,1,2016,19,13679,2380,16059
2,30,1,1,2016,20,14264,2394,16658
2,30,1,1,2016,21,13548,2273,15821
2,30,1,1,2016,22,12981,2118,15099
2,30,1,1,2016,23,12670,1990,14660
2,30,1,1,2016,24,12597,1822,14419
2,31,1,1,2016,1,12490,1617,14107
2,31,1,1,2016,2,12125,1484,13609
2,31,1,1,2016,3,12611,1416,14027
2,31,1,1,2016,4,12367,1387,13754
2,31,1,1,2016,5,12659,1380,14039
2,31,1,1,2016,6,13173,1451,14624
2,31,1,1,2016,7,13844,1513,15357
2,31,1,1,2016,8,15187,1623,16810
2,31,1,1,2016,9,15792,1703,17495
2,31,1,1,2016,10,16020,1856,17876
2,31,1,1,2016,11,16059,1965,18024
2,31,1,1,2016,12,16031,1984,18015
2,31,1,1,2016,13,15044,2012,17056
2,31,1,1,2016,14,14443,1939,16382
2,31,1,1,2016,15,14250,1878,16128
2,31,1,1,2016,16,14437,1826,16263
2,31,1,1,2016,17,14120,1820,15940
2,31,1,1,2016,18,13313,1809,15122
2,31,1,1,2016,19,13117,1953,15070
2,31,1,1,2016,20,13739,2054,15793
2,31,1,1,2016,21,13325,1864,15189
2,31,1,1,2016,22,12689,1874,14563
2,31,1,1,2016,23,12546,1863,14409
2,31,1,1,2016,24,12087,1756,13843
1,1,2,1,2016,1,12312,1612,13924
1,1,2,1,2016,2,12263,1484,13747
1,1,2,1,2016,3,12287,1425,13712
1,1,2,1,2016,4,12377,1395,13772
1,1,2,1,2016,5,12346,1414,13760
1,1,2,1,2016,6,12989,1522,14511
1,1,2,1,2016,7,14027,1693,15720
1,1,2,1,2016,8,15226,1885,17111
1,1,2,1,2016,9,15882,2186,18068
1,1,2,1,2016,10,16103,2409,18512
1,1,2,1,2016,11,15859,2588,18447
1,1,2,1,2016,12,15612,2591,18203
1,1,2,1,2016,13,15202,2588,17790
1,1,2,1,2016,14,15125,2538,17663
1,1,2,1,2016,15,14950,2575,17525
1,1,2,1,2016,16,14951,2552,17503
1,1,2,1,2016,17,14426,2582,17008
1,1,2,1,2016,18,13701,2438,16139
1,1,2,1,2016,19,13821,2536,16357
1,1,2,1,2016,20,14084,2435,16519
1,1,2,1,2016,21,14214,2332,16546
1,1,2,1,2016,22,13436,2176,15612
1,1,2,1,2016,23,12857,2000,14857
1,1,2,1,2016,24,13260,1774,15034
1,2,2,1,2016,1,12925,1623,14548
1,2,2,1,2016,2,12618,1464,14082
1,2,2,1,2016,3,12473,1417,13890
1,2,2,1,2016,4,12501,1386,13887
1,2,2,1,2016,5,12628,1398,14026
1,2,2,1,2016,6,13052,1521,14573
1,2,2,1,2016,7,14501,1714,16215
1,2,2,1,2016,8,15359,1863,17222
1,2,2,1,2016,9,15919,2133,18052
1,2,2,1,2016,10,15664,2444,18108
1,2,2,1,2016,11,16066,2619,18685
1,2,2,1,2016,12,15619,2622,18241
1,2,2,1,2016,13,15392,2616,18008
1,2,2,1,2016,14,15175,2517,17692
1,2,2,1,2016,15,15029,2541,17570
1,2,2,1,2016,16,15069,2552,17621
1,2,2,1,2016,17,14776,2541,17317
1,2,2,1,2016,18,13487,2508,15995
1,2,2,1,2016,19,13719,2509,16228
1,2,2,1,2016,20,14632,2496,17128
1,2,2,1,2016,21,14149,2337,16486
1,2,2,1,2016,22,12706,2187,14893
1,2,2,1,2016,23,12744,2003,14747
1,2,2,1,2016,24,12577,1832,14409
1,3,2,1,2016,1,12967,1617,14584
1,3,2,1,2016,2,12763,1495,14258
1,3,2,1,2016,3,12601,1432,14033
1,3,2,1,2016,4,12710,1379,14089
1,3,2,1,2016,5,12815,1399,14214
1,3,2,1,2016,6,13237,1510,14747
1,3,2,1,2016,7,14582,1752,16334
1,3,2,1,2016,8,16191,1886,18077
1,3,2,1,2016,9,16172,2092,18264
1,3,2,1,2016,10,16188,2387,18575
1,3,2,1,2016,11,15705,2599,18304
1,3,2,1,2016,12,15907,2608,18515
1,3,2,1,2016,13,15353,2599,17952
1,3,2,1,2016,14,15075,2500,17575
1,3,2,1,2016,15,15131,2509,17640
1,3,2,1,2016,16,15110,2501,17611
1,3,2,1,2016,17,14705,2503,17208
1,3,2,1,2016,18,13549,2448,15997
1,3,2,1,2016,19,13868,2452,16320
1,3,2,1,2016,20,14536,2454,16990
1,3,2,1,2016,21,13995,2199,16194
1,3,2,1,2016,22,13221,2138,15359
1,3,2,1,2016,23,12761,1978,14739
1,3,2,1,2016,24,12441,1779,14220
1,4,2,1,2016,1,12610,1585,14195
1,4,2,1,2016,2,12555,1460,14015
1,4,2,1,2016,3,12454,1391,13845
1,4,2,1,2016,4,12382,1362,13744
1,4,2,1,2016,5,12518,1363,13881
1,4,2,1,2016,6,13302,1495,14797
1,4,2,1,2016,7,14317,1649,15966
1,4,2,1,2016,8,15959,1866,17825
1,4,2,1,2016,9,15837,2147,17984
1,4,2,1,2016,10,16147,2390,18537
1,4,2,1,2016,11,15616,2528,18144
1,4,2,1,2016,12,15841,2559,18400
1,4,2,1,2016,13,15107,2556,17663
1,4,2,1,2016,14,14825,2414,17239
1,4,2,1,2016,15,14902,2440,17342
1,4,2,1,2016,16,14959,2445,17404
1,4,2,1,2016,17,14406,2457,16863
1,4,2,1,2016,18,13704,2438,16142
1,4,2,1,2016,19,13559,2441,16000
1,4,2,1,2016,20,14328,2420,16748
1,4,2,1,2016,21,13630,2326,15956
1,4,2,1,2016,22,12917,2155,15072
1,4,2,1,2016,23,12472,1935,14407
1,4,2,1,2016,24,12307,1779,14086
1,5,2,1,2016,1,12465,1564,14029
1,5,2,1,2016,2,12699,1452,14151
1,5,2,1,2016,3,12287,1386,13673
1,5,2,1,2016,4,12249,1341,13590
1,5,2,1,2016,5,12610,1355,13965
1,5,2,1,2016,6,13094,1482,14576
1,5,2,1,2016,7,14555,1700,16255
1,5,2,1,2016,8,15697,1844,17541
1,5,2,1,2016,9,15982,2137,18119
1,5,2,1,2016,10,15681,2419,18100
1,5,2,1,2016,11,15405,2587,17992
1,5,2,1,2016,12,15261,2612,17873
1,5,2,1,2016,13,14841,2609,17450
1,5,2,1,2016,14,14424,2456,16880
1,5,2,1,2016,15,14194,2463,16657
1,5,2,1,2016,16,14310,2468,16778
1,5,2,1,2016,17,13728,2487,16215
1,5,2,1,2016,18,12995,2458,15453
1,5,2,1,2016,19,13322,2444,15766
1,5,2,1,2016,20,14351,2471,16822
1,5,2,1,2016,21,13747,2288,16035
1,5,2,1,2016,22,13092,2145,15237
1,5,2,1,2016,23,12816,1943,14759
1,5,2,1,2016,24,12517,1765,14282
2,6,2,1,2016,1,12583,1660,14243
2,6,2,1,2016,2,12641,1472,14113
2,6,2,1,2016,3,12558,1403,13961
2,6,2,1,2016,4,12644,1366,14010
2,6,2,1,2016,5,12736,1369,14105
2,6,2,1,2016,6,13400,1470,14870
2,6,2,1,2016,7,14755,1576,16331
2,6,2,1,2016,8,15752,1759,17511
2,6,2,1,2016,9,15875,2026,17901
2,6,2,1,2016,10,16114,2258,18372
2,6,2,1,2016,11,16155,2428,18583
2,6,2,1,2016,12,15647,2445,18092
2,6,2,1,2016,13,15149,2423,17572
2,6,2,1,2016,14,14299,2258,16557
2,6,2,1,2016,15,14280,2244,16524
2,6,2,1,2016,16,14424,2214,16638
2,6,2,1,2016,17,14146,2200,16346
2,6,2,1,2016,18,13119,2184,15303
2,6,2,1,2016,19,13383,2257,15640
2,6,2,1,2016,20,14103,2293,16396
2,6,2,1,2016,21,13642,2203,15845
2,6,2,1,2016,22,13033,2072,15105
2,6,2,1,2016,23,12408,1848,14256
2,6,2,1,2016,24,12384,1719,14103
2,7,2,1,2016,1,12330,1533,13863
2,7,2,1,2016,2,12294,1425,13719
2,7,2,1,2016,3,12263,1355,13618
2,7,2,1,2016,4,12345,1319,13664
2,7,2,1,2016,5,12570,1335,13905
2,7,2,1,2016,6,13400,1400,14800
2,7,2,1,2016,7,13885,1482,15367
2,7,2,1,2016,8,15241,1542,16783
2,7,2,1,2016,9,15773,1695,17468
2,7,2,1,2016,10,16031,1769,17800
2,7,2,1,2016,11,15762,1930,17692
2,7,2,1,2016,12,15394,1930,17324
2,7,2,1,2016,13,15067,1892,16959
2,7,2,1,2016,14,14645,1827,16472
2,7,2,1,2016,15,14264,1733,15997
2,7,2,1,2016,16,14213,1672,15885
2,7,2,1,2016,17,13854,1665,15519
2,7,2,1,2016,18,12704,1698,14402
2,7,2,1,2016,19,13027,1751,14778
2,7,2,1,2016,20,13809,1957,15766
2,7,2,1,2016,21,13154,1947,15101
2,7,2,1,2016,22,12376,1892,14268
2,7,2,1,2016,23,12117,1784,13901
2,7,2,1,2016,24,12223,1640,13863
1,8,2,1,2016,1,12279,1464,13743
1,8,2,1,2016,2,12119,1348,13467
1,8,2,1,2016,3,12281,1285,13566
1,8,2,1,2016,4,12120,1252,13372
1,8,2,1,2016,5,12385,1270,13655
1,8,2,1,2016,6,13219,1411,14630
1,8,2,1,2016,7,14244,1645,15889
1,8,2,1,2016,8,15664,1781,17445
1,8,2,1,2016,9,16083,2044,18127
1,8,2,1,2016,10,15989,2315,18304
1,8,2,1,2016,11,15946,2498,18444
1,8,2,1,2016,12,15922,2499,18421
1,8,2,1,2016,13,14984,2469,17453
1,8,2,1,2016,14,14774,2420,17194
1,8,2,1,2016,15,14681,2386,17067
1,8,2,1,2016,16,15000,2379,17379
1,8,2,1,2016,17,14470,2378,16848
1,8,2,1,2016,18,13429,2364,15793
1,8,2,1,2016,19,13776,2340,16116
1,8,2,1,2016,20,14523,2395,16918
1,8,2,1,2016,21,13801,2263,16064
1,8,2,1,2016,22,13248,2084,15332
1,8,2,1,2016,23,12562,1944,14506
1,8,2,1,2016,24,12672,1743,14415
1,9,2,1,2016,1,12868,1535,14403
1,9,2,1,2016,2,12833,1419,14252
1,9,2,1,2016,3,12950,1354,14304
1,9,2,1,2016,4,12843,1335,14178
1,9,2,1,2016,5,13033,1346,14379
1,9,2,1,2016,6,13812,1494,15306
1,9,2,1,2016,7,14574,1687,16261
1,9,2,1,2016,8,16179,1877,18056
1,9,2,1,2016,9,17020,2179,19199
1,9,2,1,2016,10,17039,2419,19458
1,9,2,1,2016,11,16561,2592,19153
1,9,2,1,2016,12,16361,2621,18982
1,9,2,1,2016,13,15131,2614,17745
1,9,2,1,2016,14,14988,2460,17448
1,9,2,1,2016,15,15167,2481,17648
1,9,2,1,2016,16,15121,2479,17600
1,9,2,1,2016,17,14456,2484,16940
1,9,2,1,2016,18,13787,2446,16233
1,9,2,1,2016,19,14237,2448,16685
1,9,2,1,2016,20,14845,2466,17311
1,9,2,1,2016,21,13827,2318,16145
1,9,2,1,2016,22,13529,2104,15633
1,9,2,1,2016,23,12986,2031,15017
1,9,2,1,2016,24,13065,1799,14864
1,10,2,1,2016,1,13173,1572,14745
1,10,2,1,2016,2,12846,1467,14313
1,10,2,1,2016,3,12957,1401,14358
1,10,2,1,2016,4,12881,1359,14240
1,10,2,1,2016,5,12839,1382,14221
1,10,2,1,2016,6,13574,1515,15089
1,10,2,1,2016,7,14830,1697,16527
1,10,2,1,2016,8,16251,1912,18163
1,10,2,1,2016,9,16444,2237,18681
1,10,2,1,2016,10,16397,2489,18886
1,10,2,1,2016,11,16334,2627,18961
1,10,2,1,2016,12,16379,2629,19008
1,10,2,1,2016,13,15484,2590,18074
1,10,2,1,2016,14,15335,2462,17797
1,10,2,1,2016,15,15109,2462,17571
1,10,2,1,2016,16,14907,2452,17359
1,10,2,1,2016,17,14536,2449,16985
1,10,2,1,2016,18,13651,2416,16067
1,10,2,1,2016,19,14123,2430,16553
1,10,2,1,2016,20,14293,2510,16803
1,10,2,1,2016,21,14248,2362,16610
1,10,2,1,2016,22,13445,2175,15620
1,10,2,1,2016,23,12972,2024,14996
1,10,2,1,2016,24,12893,1843,14736
1,11,2,1,2016,1,13009,1682,14691
1,11,2,1,2016,2,12927,1524,14451
1,11,2,1,2016,3,12799,1454,14253
1,11,2,1,2016,4,12751,1414,14165
1,11,2,1,2016,5,12909,1428,14337
1,11,2,1,2016,6,13697,1505,15202
1,11,2,1,2016,7,14850,1763,16613
1,11,2,1,2016,8,15993,1944,17937
1,11,2,1,2016,9,16349,2177,18526
1,11,2,1,2016,10,16204,2492,18696
1,11,2,1,2016,11,16203,2649,18852
1,11,2,1,2016,12,15932,2649,18581
1,11,2,1,2016,13,15104,2608,17712
1,11,2,1,2016,14,14706,2443,17149
1,11,2,1,2016,15,14320,2449,16769
1,11,2,1,2016,16,14450,2441,16891
1,11,2,1,2016,17,14382,2379,16761
1,11,2,1,2016,18,13332,2327,15659
1,11,2,1,2016,19,13661,2377,16038
1,11,2,1,2016,20,14229,2473,16702
1,11,2,1,2016,21,13954,2329,16283
1,11,2,1,2016,22,13177,2124,15301
1,11,2,1,2016,23,12569,1970,14539
1,11,2,1,2016,24,12643,1801,14444
1,12,2,1,2016,1,12770,1613,14383
1,12,2,1,2016,2,12628,1485,14113
1,12,2,1,2016,3,12857,1410,14267
1,12,2,1,2016,4,12576,1374,13950
1,12,2,1,2016,5,12942,1393,14335
1,12,2,1,2016,6,13302,1516,14818
1,12,2,1,2016,7,14461,1696,16157
1,12,2,1,2016,8,15495,1914,17409
1,12,2,1,2016,9,15677,2177,17854
1,12,2,1,2016,10,15805,2424,18229
1,12,2,1,2016,11,15494,2587,18081
1,12,2,1,2016,12,15121,2590,17711
1,12,2,1,2016,13,14499,2522,17021
1,12,2,1,2016,14,14189,2384,16573
1,12,2,1,2016,15,13819,2392,16211
1,12,2,1,2016,16,13693,2398,16091
1,12,2,1,2016,17,13647,2388,16035
1,12,2,1,2016,18,12517,2349,14866
1,12,2,1,2016,19,13075,2316,15391
1,12,2,1,2016,20,13824,2378,16202
1,12,2,1,2016,21,13409,2275,15684
1,12,2,1,2016,22,13038,2098,15136
1,12,2,1,2016,23,12527,1933,14460
1,12,2,1,2016,24,12410,1807,14217
2,13,2,1,2016,1,12676,1572,14248
2,13,2,1,2016,2,12276,1436,13712
2,13,2,1,2016,3,12560,1355,13915
2,13,2,1,2016,4,12419,1323,13742
2,13,2,1,2016,5,12539,1336,13875
2,13,2,1,2016,6,13244,1440,14684
2,13,2,1,2016,7,14066,1580,15646
2,13,2,1,2016,8,15256,1678,16934
2,13,2,1,2016,9,15830,1907,17737
2,13,2,1,2016,10,15640,2173,17813
2,13,2,1,2016,11,15438,2322,17760
2,13,2,1,2016,12,14977,2328,17305
2,13,2,1,2016,13,14939,2313,17252
2,13,2,1,2016,14,14460,2168,16628
2,13,2,1,2016,15,14270,2157,16427
2,13,2,1,2016,16,14605,2139,16744
2,13,2,1,2016,17,14247,2122,16369
2,13,2,1,2016,18,13112,2124,15236
2,13,2,1,2016,19,13617,2157,15774
2,13,2,1,2016,20,14534,2268,16802
2,13,2,1,2016,21,13752,2149,15901
2,13,2,1,2016,22,12906,2024,14930
2,13,2,1,2016,23,12398,1859,14257
2,13,2,1,2016,24,12341,1710,14051
2,14,2,1,2016,1,12507,1578,14085
2,14,2,1,2016,2,12355,1445,13800
2,14,2,1,2016,3,12405,1358,13763
2,14,2,1,2016,4,12352,1311,13663
2,14,2,1,2016,5,12327,1322,13649
2,14,2,1,2016,6,13086,1398,14484
2,14,2,1,2016,7,13826,1464,15290
2,14,2,1,2016,8,15088,1525,16613
2,14,2,1,2016,9,15444,1657,17101
2,14,2,1,2016,10,15601,1811,17412
2,14,2,1,2016,11,15495,1907,17402
2,14,2,1,2016,12,15367,1921,17288
2,14,2,1,2016,13,14731,1888,16619
2,14,2,1,2016,14,14188,1816,16004
2,14,2,1,2016,15,14165,1725,15890
2,14,2,1,2016,16,14065,1693,15758
2,14,2,1,2016,17,13812,1661,15473
2,14,2,1,2016,18,12797,1688,14485
2,14,2,1,2016,19,12865,1808,14673
2,14,2,1,2016,20,13530,1935,15465
2,14,2,1,2016,21,13403,1934,15337
2,14,2,1,2016,22,12780,1878,14658
2,14,2,1,2016,23,12286,1771,14057
2,14,2,1,2016,24,12714,1612,14326
1,15,2,1,2016,1,12720,1472,14192
1,15,2,1,2016,2,12696,1349,14045
1,15,2,1,2016,3,12743,1289,14032
1,15,2,1,2016,4,12441,1264,13705
1,15,2,1,2016,5,12615,1283,13898
1,15,2,1,2016,6,13218,1414,14632
1,15,2,1,2016,7,14402,1620,16022
1,15,2,1,2016,8,15866,1834,17700
1,15,2,1,2016,9,15818,2111,17929
1,15,2,1,2016,10,16478,2286,18764
1,15,2,1,2016,11,15873,2485,18358
1,15,2,1,2016,12,15807,2510,18317
1,15,2,1,2016,13,15046,2468,17514
1,15,2,1,2016,14,15147,2342,17489
1,15,2,1,2016,15,14750,2345,17095
1,15,2,1,2016,16,15202,2344,17546
1,15,2,1,2016,17,14542,2340,16882
1,15,2,1,2016,18,14129,2333,16462
1,15,2,1,2016,19,13801,2341,16142
1,15,2,1,2016,20,14677,2355,17032
1,15,2,1,2016,21,14319,2272,16591
1,15,2,1,2016,22,13508,2089,15597
1,15,2,1,2016,23,13232,1901,15133
1,15,2,1,2016,24,12981,1716,14697
1,16,2,1,2016,1,13495,1542,15037
1,16,2,1,2016,2,13246,1426,14672
1,16,2,1,2016,3,13049,1364,14413
1,16,2,1,2016,4,13285,1332,14617
1,16,2,1,2016,5,13369,1357,14726
1,16,2,1,2016,6,13930,1455,15385
1,16,2,1,2016,7,15061,1710,16771
1,16,2,1,2016,8,16122,1882,18004
1,16,2,1,2016,9,16585,2122,18707
1,16,2,1,2016,10,15914,2361,18275
1,16,2,1,2016,11,15967,2571,18538
1,16,2,1,2016,12,15695,2602,18297
1,16,2,1,2016,13,15055,2567,17622
1,16,2,1,2016,14,14819,2429,17248
1,16,2,1,2016,15,14708,2464,17172
1,16,2,1,2016,16,15007,2477,17484
1,16,2,1,2016,17,14624,2482,17106
1,16,2,1,2016,18,13531,2462,15993
1,16,2,1,2016,19,14043,2479,16522
1,16,2,1,2016,20,14899,2520,17419
1,16,2,1,2016,21,14381,2376,16757
1,16,2,1,2016,22,13647,2127,15774
1,16,2,1,2016,23,13330,2015,15345
1,16,2,1,2016,24,13581,1813,15394
1,17,2,1,2016,1,13458,1654,15112
1,17,2,1,2016,2,13324,1532,14856
1,17,2,1,2016,3,13309,1464,14773
1,17,2,1,2016,4,13193,1428,14621
1,17,2,1,2016,5,13180,1434,14614
1,17,2,1,2016,6,13850,1548,15398
1,17,2,1,2016,7,15078,1776,16854
1,17,2,1,2016,8,15759,1881,17640
1,17,2,1,2016,9,16457,2195,18652
1,17,2,1,2016,10,16398,2544,18942
1,17,2,1,2016,11,15927,2711,18638
1,17,2,1,2016,12,15666,2721,18387
1,17,2,1,2016,13,15399,2681,18080
1,17,2,1,2016,14,15356,2509,17865
1,17,2,1,2016,15,14663,2535,17198
1,17,2,1,2016,16,15422,2542,17964
1,17,2,1,2016,17,15001,2531,17532
1,17,2,1,2016,18,13899,2514,16413
1,17,2,1,2016,19,14512,2520,17032
1,17,2,1,2016,20,14820,2570,17390
1,17,2,1,2016,21,14555,2395,16950
1,17,2,1,2016,22,13903,2193,16096
1,17,2,1,2016,23,13396,2031,15427
1,17,2,1,2016,24,13414,1888,15302
1,18,2,1,2016,1,13258,1706,14964
1,18,2,1,2016,2,13582,1583,15165
1,18,2,1,2016,3,13186,1512,14698
1,18,2,1,2016,4,13099,1482,14581
1,18,2,1,2016,5,13202,1472,14674
1,18,2,1,2016,6,13740,1562,15302
1,18,2,1,2016,7,14658,1724,16382
1,18,2,1,2016,8,15412,1932,17344
1,18,2,1,2016,9,15959,2140,18099
1,18,2,1,2016,10,16210,2495,18705
1,18,2,1,2016,11,16058,2674,18732
1,18,2,1,2016,12,15673,2696,18369
1,18,2,1,2016,13,15210,2668,17878
1,18,2,1,2016,14,14642,2574,17216
1,18,2,1,2016,15,14894,2586,17480
1,18,2,1,2016,16,15003,2536,17539
1,18,2,1,2016,17,14468,2581,17049
1,18,2,1,2016,18,13680,2516,16196
1,18,2,1,2016,19,13516,2506,16022
1,18,2,1,2016,20,14639,2533,17172
1,18,2,1,2016,21,14338,2374,16712
1,18,2,1,2016,22,13506,2231,15737
1,18,2,1,2016,23,13176,2074,15250
1,18,2,1,2016,24,13051,1905,14956
3,19,2,1,2016,1,13080,1680,14760
3,19,2,1,2016,2,13050,1559,14609
3,19,2,1,2016,3,12824,1488,14312
3,19,2,1,2016,4,13140,1458,14598
3,19,2,1,2016,5,13321,1456,14777
3,19,2,1,2016,6,13748,1555,15303
3,19,2,1,2016,7,14795,1713,16508
3,19,2,1,2016,8,15883,1859,17742
3,19,2,1,2016,9,16074,2204,18278
3,19,2,1,2016,10,16088,2492,18580
3,19,2,1,2016,11,16134,2674,18808
3,19,2,1,2016,12,15938,2727,18665
3,19,2,1,2016,13,15340,2720,18060
3,19,2,1,2016,14,14973,2525,17498
3,19,2,1,2016,15,14814,2543,17357
3,19,2,1,2016,16,15079,2534,17613
3,19,2,1,2016,17,14524,2522,17046
3,19,2,1,2016,18,13362,2491,15853
3,19,2,1,2016,19,13225,2474,15699
3,19,2,1,2016,20,14446,2518,16964
3,19,2,1,2016,21,13954,2423,16377
3,19,2,1,2016,22,13414,2232,15646
3,19,2,1,2016,23,13203,2058,15261
3,19,2,1,2016,24,12996,1918,14914
2,20,2,1,2016,1,13279,1749,15028
2,20,2,1,2016,2,13195,1606,14801
2,20,2,1,2016,3,13194,1530,14724
2,20,2,1,2016,4,13079,1485,14564
2,20,2,1,2016,5,13151,1477,14628
2,20,2,1,2016,6,14016,1572,15588
2,20,2,1,2016,7,15064,1713,16777
2,20,2,1,2016,8,16269,1888,18157
2,20,2,1,2016,9,16078,2038,18116
2,20,2,1,2016,10,15872,2361,18233
2,20,2,1,2016,11,16028,2604,18632
2,20,2,1,2016,12,16281,2627,18908
2,20,2,1,2016,13,15967,2611,18578
2,20,2,1,2016,14,15242,2455,17697
2,20,2,1,2016,15,15467,2444,17911
2,20,2,1,2016,16,15635,2424,18059
2,20,2,1,2016,17,15095,2394,17489
2,20,2,1,2016,18,13944,2342,16286
2,20,2,1,2016,19,14156,2380,16536
2,20,2,1,2016,20,14852,2435,17287
2,20,2,1,2016,21,14642,2317,16959
2,20,2,1,2016,22,13873,2207,16080
2,20,2,1,2016,23,13865,2039,15904
2,20,2,1,2016,24,13658,1957,15615
2,21,2,1,2016,1,13841,1778,15619
2,21,2,1,2016,2,13508,1647,15155
2,21,2,1,2016,3,13361,1566,14927
2,21,2,1,2016,4,13344,1519,14863
2,21,2,1,2016,5,13350,1517,14867
2,21,2,1,2016,6,14034,1554,15588
2,21,2,1,2016,7,14900,1589,16489
2,21,2,1,2016,8,15987,1613,17600
2,21,2,1,2016,9,15873,1765,17638
2,21,2,1,2016,10,16113,1941,18054
2,21,2,1,2016,11,16109,2041,18150
2,21,2,1,2016,12,15859,2053,17912
2,21,2,1,2016,13,15750,2037,17787
2,21,2,1,2016,14,15436,1966,17402
2,21,2,1,2016,15,14957,1910,16867
2,21,2,1,2016,16,14895,1859,16754
2,21,2,1,2016,17,14797,1833,16630
2,21,2,1,2016,18,13222,1818,15040
2,21,2,1,2016,19,13371,1930,15301
2,21,2,1,2016,20,14537,2047,16584
2,21,2,1,2016,21,14100,2050,16150
2,21,2,1,2016,22,13920,2017,15937
2,21,2,1,2016,23,13629,1945,15574
2,21,2,1,2016,24,13513,1801,15314
1,22,2,1,2016,1,13427,1689,15116
1,22,2,1,2016,2,13309,1548,14857
1,22,2,1,2016,3,13248,1470,14718
1,22,2,1,2016,4,12797,1437,14234
1,22,2,1,2016,5,13785,1452,15237
1,22,2,1,2016,6,14091,1567,15658
1,22,2,1,2016,7,15355,1764,17119
1,22,2,1,2016,8,15996,1938,17934
1,22,2,1,2016,9,16173,2168,18341
1,22,2,1,2016,10,16365,2427,18792
1,22,2,1,2016,11,16195,2645,18840
1,22,2,1,2016,12,15974,2693,18667
1,22,2,1,2016,13,15733,2688,18421
1,22,2,1,2016,14,15110,2499,17609
1,22,2,1,2016,15,15420,2501,17921
1,22,2,1,2016,16,15607,2500,18107
1,22,2,1,2016,17,14924,2518,17442
1,22,2,1,2016,18,13988,2466,16454
1,22,2,1,2016,19,13942,2437,16379
1,22,2,1,2016,20,15185,2463,17648
1,22,2,1,2016,21,14274,2364,16638
1,22,2,1,2016,22,13719,2163,15882
1,22,2,1,2016,23,13847,2026,15873
1,22,2,1,2016,24,13861,1817,15678
1,23,2,1,2016,1,13909,1649,15558
1,23,2,1,2016,2,13441,1548,14989
1,23,2,1,2016,3,13477,1460,14937
1,23,2,1,2016,4,13341,1418,14759
1,23,2,1,2016,5,13440,1426,14866
1,23,2,1,2016,6,14029,1551,15580
1,23,2,1,2016,7,15513,1753,17266
1,23,2,1,2016,8,16352,1858,18210
1,23,2,1,2016,9,16283,2197,18480
1,23,2,1,2016,10,16388,2435,18823
1,23,2,1,2016,11,16300,2642,18942
1,23,2,1,2016,12,16162,2705,18867
1,23,2,1,2016,13,15820,2633,18453
1,23,2,1,2016,14,15896,2490,18386
1,23,2,1,2016,15,15807,2536,18343
1,23,2,1,2016,16,15687,2588,18275
1,23,2,1,2016,17,15413,2582,17995
1,23,2,1,2016,18,14177,2556,16733
1,23,2,1,2016,19,14624,2511,17135
1,23,2,1,2016,20,15050,2546,17596
1,23,2,1,2016,21,14686,2444,17130
1,23,2,1,2016,22,14138,2269,16407
1,23,2,1,2016,23,13552,2042,15594
1,23,2,1,2016,24,13942,1931,15873
1,24,2,1,2016,1,14019,1732,15751
1,24,2,1,2016,2,13677,1608,15285
1,24,2,1,2016,3,13408,1540,14948
1,24,2,1,2016,4,13746,1496,15242
1,24,2,1,2016,5,13759,1488,15247
1,24,2,1,2016,6,14568,1604,16172
1,24,2,1,2016,7,15684,1820,17504
1,24,2,1,2016,8,16639,1947,18586
1,24,2,1,2016,9,16211,2257,18468
1,24,2,1,2016,10,16560,2538,19098
1,24,2,1,2016,11,16635,2705,19340
1,24,2,1,2016,12,16388,2774,19162
1,24,2,1,2016,13,15869,2761,18630
1,24,2,1,2016,14,15497,2610,18107
1,24,2,1,2016,15,15219,2658,17877
1,24,2,1,2016,16,15475,2668,18143
1,24,2,1,2016,17,14964,2664,17628
1,24,2,1,2016,18,13975,2613,16588
1,24,2,1,2016,19,13959,2581,16540
1,24,2,1,2016,20,15112,2614,17726
1,24,2,1,2016,21,14633,2395,17028
1,24,2,1,2016,22,14093,2309,16402
1,24,2,1,2016,23,13782,2091,15873
1,24,2,1,2016,24,13861,1944,15805
1,25,2,1,2016,1,13920,1730,15650
1,25,2,1,2016,2,13608,1619,15227
1,25,2,1,2016,3,13474,1547,15021
1,25,2,1,2016,4,13394,1495,14889
1,25,2,1,2016,5,13540,1504,15044
1,25,2,1,2016,6,14276,1623,15899
1,25,2,1,2016,7,15547,1799,17346
1,25,2,1,2016,8,15997,1950,17947
1,25,2,1,2016,9,16281,2234,18515
1,25,2,1,2016,10,16354,2552,18906
1,25,2,1,2016,11,16419,2745,19164
1,25,2,1,2016,12,16126,2755,18881
1,25,2,1,2016,13,15552,2719,18271
1,25,2,1,2016,14,15342,2578,17920
1,25,2,1,2016,15,15162,2564,17726
1,25,2,1,2016,16,15429,2580,18009
1,25,2,1,2016,17,15010,2560,17570
1,25,2,1,2016,18,13605,2515,16120
1,25,2,1,2016,19,13745,2515,16260
1,25,2,1,2016,20,14998,2538,17536
1,25,2,1,2016,21,14587,2408,16995
1,25,2,1,2016,22,14096,2272,16368
1,25,2,1,2016,23,13698,2041,15739
1,25,2,1,2016,24,13553,1951,15504
1,26,2,1,2016,1,14186,1706,15892
1,26,2,1,2016,2,13763,1582,15345
1,26,2,1,2016,3,13641,1505,15146
1,26,2,1,2016,4,13674,1460,15134
1,26,2,1,2016,5,13472,1469,14941
1,26,2,1,2016,6,14093,1586,15679
1,26,2,1,2016,7,15753,1757,17510
1,26,2,1,2016,8,16085,1933,18018
1,26,2,1,2016,9,16124,2252,18376
1,26,2,1,2016,10,16143,2514,18657
1,26,2,1,2016,11,15988,2704,18692
1,26,2,1,2016,12,15346,2767,18113
1,26,2,1,2016,13,15334,2728,18062
1,26,2,1,2016,14,14864,2543,17407
1,26,2,1,2016,15,14839,2568,17407
1,26,2,1,2016,16,14826,2586,17412
1,26,2,1,2016,17,14808,2589,17397
1,26,2,1,2016,18,13460,2566,16026
1,26,2,1,2016,19,13379,2525,15904
1,26,2,1,2016,20,14289,2590,16879
1,26,2,1,2016,21,14062,2517,16579
1,26,2,1,2016,22,13668,2296,15964
1,26,2,1,2016,23,13381,2115,15496
1,26,2,1,2016,24,13420,1936,15356
2,27,2,1,2016,1,13568,1791,15359
2,27,2,1,2016,2,13355,1624,14979
2,27,2,1,2016,3,13293,1546,14839
2,27,2,1,2016,4,13081,1496,14577
2,27,2,1,2016,5,13284,1504,14788
2,27,2,1,2016,6,14023,1599,15622
2,27,2,1,2016,7,15176,1711,16887
2,27,2,1,2016,8,15820,1840,17660
2,27,2,1,2016,9,16041,2063,18104
2,27,2,1,2016,10,15845,2286,18131
2,27,2,1,2016,11,15990,2542,18532
2,27,2,1,2016,12,15951,2603,18554
2,27,2,1,2016,13,15729,2595,18324
2,27,2,1,2016,14,15339,2474,17813
2,27,2,1,2016,15,15468,2471,17939
2,27,2,1,2016,16,15282,2482,17764
2,27,2,1,2016,17,15233,2450,17683
2,27,2,1,2016,18,13656,2420,16076
2,27,2,1,2016,19,13741,2416,16157
2,27,2,1,2016,20,14579,2519,17098
2,27,2,1,2016,21,14177,2377,16554
2,27,2,1,2016,22,13811,2235,16046
2,27,2,1,2016,23,13497,2106,15603
2,27,2,1,2016,24,13503,2000,15503
2,28,2,1,2016,1,13741,1816,15557
2,28,2,1,2016,2,13518,1684,15202
2,28,2,1,2016,3,13422,1593,15015
2,28,2,1,2016,4,13279,1543,14822
2,28,2,1,2016,5,13585,1535,15120
2,28,2,1,2016,6,14200,1621,15821
2,28,2,1,2016,7,14771,1664,16435
2,28,2,1,2016,8,15701,1720,17421
2,28,2,1,2016,9,15372,1847,17219
2,28,2,1,2016,10,15824,2017,17841
2,28,2,1,2016,11,15888,2107,17995
2,28,2,1,2016,12,15776,2168,17944
2,28,2,1,2016,13,15540,2166,17706
2,28,2,1,2016,14,14716,2096,16812
2,28,2,1,2016,15,15051,2031,17082
2,28,2,1,2016,16,15005,2000,17005
2,28,2,1,2016,17,14348,1985,16333
2,28,2,1,2016,18,13130,1946,15076
2,28,2,1,2016,19,13350,2047,15397
2,28,2,1,2016,20,14214,2180,16394
2,28,2,1,2016,21,13828,2187,16015
2,28,2,1,2016,22,13415,2155,15570
2,28,2,1,2016,23,13203,2079,15282
2,28,2,1,2016,24,13207,1948,15155
1,29,2,1,2016,1,13217,1806,15023
1,29,2,1,2016,2,12987,1655,14642
1,29,2,1,2016,3,12814,1582,14396
1,29,2,1,2016,4,12531,1547,14078
1,29,2,1,2016,5,12949,1548,14497
1,29,2,1,2016,6,13779,1649,15428
1,29,2,1,2016,7,14297,1852,16149
1,29,2,1,2016,8,14956,2013,16969
1,29,2,1,2016,9,15155,2274,17429
1,29,2,1,2016,10,15381,2623,18004
1,29,2,1,2016,11,15588,2870,18458
1,29,2,1,2016,12,15869,2938,18807
1,29,2,1,2016,13,15242,2928,18170
1,29,2,1,2016,14,15458,2796,18254
1,29,2,1,2016,15,15081,2814,17895
1,29,2,1,2016,16,15100,2827,17927
1,29,2,1,2016,17,14413,2821,17234
1,29,2,1,2016,18,13344,2769,16113
1,29,2,1,2016,19,13798,2682,16480
1,29,2,1,2016,20,13937,2704,16641
1,29,2,1,2016,21,13862,2575,16437
1,29,2,1,2016,22,13195,2376,15571
1,29,2,1,2016,23,13186,2257,15443
1,29,2,1,2016,24,13141,2094,15235
1,1,3,1,2016,1,12710,1924,14634
1,1,3,1,2016,2,12750,1720,14470
1,1,3,1,2016,3,12349,1637,13986
1,1,3,1,2016,4,12332,1591,13923
1,1,3,1,2016,5,12541,1599,14140
1,1,3,1,2016,6,13275,1705,14980
1,1,3,1,2016,7,14061,1856,15917
1,1,3,1,2016,8,14881,2008,16889
1,1,3,1,2016,9,14670,2325,16995
1,1,3,1,2016,10,14997,2666,17663
1,1,3,1,2016,11,14874,2900,17774
1,1,3,1,2016,12,15352,2966,18318
1,1,3,1,2016,13,15102,2939,18041
1,1,3,1,2016,14,14331,2827,17158
1,1,3,1,2016,15,14841,2830,17671
1,1,3,1,2016,16,15067,2847,17914
1,1,3,1,2016,17,14460,2857,17317
1,1,3,1,2016,18,13354,2789,16143
1,1,3,1,2016,19,13660,2729,16389
1,1,3,1,2016,20,14219,2751,16970
1,1,3,1,2016,21,13748,2643,16391
1,1,3,1,2016,22,13243,2500,15743
1,1,3,1,2016,23,14229,2330,16559
1,1,3,1,2016,24,12681,2172,14853
1,2,3,1,2016,1,12842,2012,14854
1,2,3,1,2016,2,12808,1847,14655
1,2,3,1,2016,3,12458,1751,14209
1,2,3,1,2016,4,12415,1703,14118
1,2,3,1,2016,5,12399,1712,14111
1,2,3,1,2016,6,13038,1771,14809
1,2,3,1,2016,7,13951,1961,15912
1,2,3,1,2016,8,14701,2128,16829
1,2,3,1,2016,9,14737,2368,17105
1,2,3,1,2016,10,15267,2721,17988
1,2,3,1,2016,11,15281,2954,18235
1,2,3,1,2016,12,15232,3037,18269
1,2,3,1,2016,13,14990,3030,18020
1,2,3,1,2016,14,15233,2921,18154
1,2,3,1,2016,15,15155,2884,18039
1,2,3,1,2016,16,15094,2959,18053
1,2,3,1,2016,17,14514,2946,17460
1,2,3,1,2016,18,13358,2874,16232
1,2,3,1,2016,19,13591,2787,16378
1,2,3,1,2016,20,14190,2824,17014
1,2,3,1,2016,21,13595,2638,16233
1,2,3,1,2016,22,13241,2495,15736
1,2,3,1,2016,23,13216,2374,15590
1,2,3,1,2016,24,12791,2292,15083
1,3,3,1,2016,1,12550,2085,14635
1,3,3,1,2016,2,12313,1924,14237
1,3,3,1,2016,3,12244,1813,14057
1,3,3,1,2016,4,12212,1741,13953
1,3,3,1,2016,5,12420,1740,14160
1,3,3,1,2016,6,13282,1831,15113
1,3,3,1,2016,7,14053,2010,16063
1,3,3,1,2016,8,14424,2114,16538
1,3,3,1,2016,9,15071,2389,17460
1,3,3,1,2016,10,14954,2753,17707
1,3,3,1,2016,11,15102,2986,18088
1,3,3,1,2016,12,15166,3013,18179
1,3,3,1,2016,13,14905,3004,17909
1,3,3,1,2016,14,14680,2878,17558
1,3,3,1,2016,15,14356,2910,17266
1,3,3,1,2016,16,14328,2971,17299
1,3,3,1,2016,17,14380,2967,17347
1,3,3,1,2016,18,13725,2907,16632
1,3,3,1,2016,19,13749,2841,16590
1,3,3,1,2016,20,14560,2820,17380
1,3,3,1,2016,21,14225,2557,16782
1,3,3,1,2016,22,13767,2434,16201
1,3,3,1,2016,23,13274,2427,15701
1,3,3,1,2016,24,13491,2303,15794
1,4,3,1,2016,1,13246,2131,15377
1,4,3,1,2016,2,13197,1956,15153
1,4,3,1,2016,3,12756,1838,14594
1,4,3,1,2016,4,12722,1776,14498
1,4,3,1,2016,5,12698,1769,14467
1,4,3,1,2016,6,13171,1846,15017
1,4,3,1,2016,7,13926,1975,15901
1,4,3,1,2016,8,14104,2110,16214
1,4,3,1,2016,9,13719,2410,16129
1,4,3,1,2016,10,13959,2678,16637
1,4,3,1,2016,11,13825,2806,16631
1,4,3,1,2016,12,13464,2822,16286
1,4,3,1,2016,13,13225,2822,16047
1,4,3,1,2016,14,12997,2727,15724
1,4,3,1,2016,15,13219,2774,15993
1,4,3,1,2016,16,13447,2780,16227
1,4,3,1,2016,17,13161,2797,15958
1,4,3,1,2016,18,12534,2717,15251
1,4,3,1,2016,19,12803,2675,15478
1,4,3,1,2016,20,13948,2725,16673
1,4,3,1,2016,21,13615,2621,16236
1,4,3,1,2016,22,13242,2459,15701
1,4,3,1,2016,23,12884,2339,15223
1,4,3,1,2016,24,12909,2228,15137
2,5,3,1,2016,1,13053,2065,15118
2,5,3,1,2016,2,12852,1896,14748
2,5,3,1,2016,3,12410,1780,14190
2,5,3,1,2016,4,12727,1711,14438
2,5,3,1,2016,5,12763,1690,14453
2,5,3,1,2016,6,13355,1792,15147
2,5,3,1,2016,7,14348,1865,16213
2,5,3,1,2016,8,14977,2006,16983
2,5,3,1,2016,9,15334,2143,17477
2,5,3,1,2016,10,15044,2460,17504
2,5,3,1,2016,11,15564,2732,18296
2,5,3,1,2016,12,15431,2764,18195
2,5,3,1,2016,13,15072,2761,17833
2,5,3,1,2016,14,14720,2653,17373
2,5,3,1,2016,15,14832,2691,17523
2,5,3,1,2016,16,15141,2687,17828
2,5,3,1,2016,17,14651,2659,17310
2,5,3,1,2016,18,13782,2558,16340
2,5,3,1,2016,19,13600,2507,16107
2,5,3,1,2016,20,14916,2608,17524
2,5,3,1,2016,21,14703,2564,17267
2,5,3,1,2016,22,13810,2426,16236
2,5,3,1,2016,23,13998,2238,16236
2,5,3,1,2016,24,13992,2112,16104
2,6,3,1,2016,1,13572,2048,15620
2,6,3,1,2016,2,13559,1887,15446
2,6,3,1,2016,3,13355,1783,15138
2,6,3,1,2016,4,13184,1718,14902
2,6,3,1,2016,5,13397,1685,15082
2,6,3,1,2016,6,13901,1727,15628
2,6,3,1,2016,7,14725,1752,16477
2,6,3,1,2016,8,15132,1801,16933
2,6,3,1,2016,9,15138,1878,17016
2,6,3,1,2016,10,15785,2004,17789
2,6,3,1,2016,11,15515,2113,17628
2,6,3,1,2016,12,15368,2116,17484
2,6,3,1,2016,13,14711,2121,16832
2,6,3,1,2016,14,14676,2070,16746
2,6,3,1,2016,15,14597,2019,16616
2,6,3,1,2016,16,14930,1987,16917
2,6,3,1,2016,17,14213,1955,16168
2,6,3,1,2016,18,12963,1938,14901
2,6,3,1,2016,19,13359,1963,15322
2,6,3,1,2016,20,14631,2173,16804
2,6,3,1,2016,21,14110,2190,16300
2,6,3,1,2016,22,13602,2164,15766
2,6,3,1,2016,23,13408,2117,15525
2,6,3,1,2016,24,13397,2064,15461
3,7,3,1,2016,1,13410,1913,15323
3,7,3,1,2016,2,13046,1762,14808
3,7,3,1,2016,3,12870,1660,14530
3,7,3,1,2016,4,12882,1606,14488
3,7,3,1,2016,5,13210,1605,14815
3,7,3,1,2016,6,13593,1695,15288
3,7,3,1,2016,7,14582,1768,16350
3,7,3,1,2016,8,15665,1921,17586
3,7,3,1,2016,9,15580,2226,17806
3,7,3,1,2016,10,16146,2478,18624
3,7,3,1,2016,11,16124,2666,18790
3,7,3,1,2016,12,15739,2675,18414
3,7,3,1,2016,13,15466,2673,18139
3,7,3,1,2016,14,15520,2576,18096
3,7,3,1,2016,15,15292,2591,17883
3,7,3,1,2016,16,15519,2595,18114
3,7,3,1,2016,17,15043,2570,17613
3,7,3,1,2016,18,13825,2509,16334
3,7,3,1,2016,19,13869,2451,16320
3,7,3,1,2016,20,14793,2529,17322
3,7,3,1,2016,21,14683,2439,17122
3,7,3,1,2016,22,14205,2337,16542
3,7,3,1,2016,23,13785,2235,16020
3,7,3,1,2016,24,13901,2120,16021
1,8,3,1,2016,1,13813,1993,15806
1,8,3,1,2016,2,13684,1810,15494
1,8,3,1,2016,3,13551,1735,15286
1,8,3,1,2016,4,13300,1666,14966
1,8,3,1,2016,5,13472,1669,15141
1,8,3,1,2016,6,14435,1776,16211
1,8,3,1,2016,7,15425,1941,17366
1,8,3,1,2016,8,16023,2031,18054
1,8,3,1,2016,9,16256,2269,18525
1,8,3,1,2016,10,16043,2601,18644
1,8,3,1,2016,11,16288,2855,19143
1,8,3,1,2016,12,16121,2897,19018
1,8,3,1,2016,13,15787,2890,18677
1,8,3,1,2016,14,15481,2786,18267
1,8,3,1,2016,15,15654,2813,18467
1,8,3,1,2016,16,15853,2821,18674
1,8,3,1,2016,17,15083,2786,17869
1,8,3,1,2016,18,14484,2763,17247
1,8,3,1,2016,19,14374,2678,17052
1,8,3,1,2016,20,15319,2701,18020
1,8,3,1,2016,21,15044,2568,17612
1,8,3,1,2016,22,14290,2402,16692
1,8,3,1,2016,23,14255,2267,16522
1,8,3,1,2016,24,14184,2155,16339
1,9,3,1,2016,1,14137,1991,16128
1,9,3,1,2016,2,13794,1842,15636
1,9,3,1,2016,3,13810,1751,15561
1,9,3,1,2016,4,13864,1687,15551
1,9,3,1,2016,5,13751,1683,15434
1,9,3,1,2016,6,14427,1776,16203
1,9,3,1,2016,7,15661,1927,17588
1,9,3,1,2016,8,15875,2058,17933
1,9,3,1,2016,9,16065,2298,18363
1,9,3,1,2016,10,16288,2628,18916
1,9,3,1,2016,11,16518,2891,19409
1,9,3,1,2016,12,16594,2931,19525
1,9,3,1,2016,13,15996,2929,18925
1,9,3,1,2016,14,15758,2816,18574
1,9,3,1,2016,15,15809,2866,18675
1,9,3,1,2016,16,15799,2874,18673
1,9,3,1,2016,17,15325,2861,18186
1,9,3,1,2016,18,14176,2826,17002
1,9,3,1,2016,19,14422,2689,17111
1,9,3,1,2016,20,15427,2725,18152
1,9,3,1,2016,21,15341,2556,17897
1,9,3,1,2016,22,14775,2458,17233
1,9,3,1,2016,23,14418,2298,16716
1,9,3,1,2016,24,14491,2180,16671
1,10,3,1,2016,1,14219,2038,16257
1,10,3,1,2016,2,14161,1854,16015
1,10,3,1,2016,3,13941,1763,15704
1,10,3,1,2016,4,13759,1696,15455
1,10,3,1,2016,5,13964,1678,15642
1,10,3,1,2016,6,14743,1775,16518
1,10,3,1,2016,7,15639,1929,17568
1,10,3,1,2016,8,16276,2037,18313
1,10,3,1,2016,9,15910,2273,18183
1,10,3,1,2016,10,16482,2647,19129
1,10,3,1,2016,11,16390,2891,19281
1,10,3,1,2016,12,16254,2923,19177
1,10,3,1,2016,13,15899,2920,18819
1,10,3,1,2016,14,15746,2841,18587
1,10,3,1,2016,15,15908,2899,18807
1,10,3,1,2016,16,16068,2902,18970
1,10,3,1,2016,17,15530,2912,18442
1,10,3,1,2016,18,14284,2853,17137
1,10,3,1,2016,19,14532,2720,17252
1,10,3,1,2016,20,15080,2729,17809
1,10,3,1,2016,21,15114,2650,17764
1,10,3,1,2016,22,14533,2503,17036
1,10,3,1,2016,23,14606,2374,16980
1,10,3,1,2016,24,14392,2284,16676
1,11,3,1,2016,1,14951,2050,17001
1,11,3,1,2016,2,14367,1900,16267
1,11,3,1,2016,3,13832,1769,15601
1,11,3,1,2016,4,13670,1714,15384
1,11,3,1,2016,5,13923,1716,15639
1,11,3,1,2016,6,14786,1835,16621
1,11,3,1,2016,7,15810,1960,17770
1,11,3,1,2016,8,16382,2106,18488
1,11,3,1,2016,9,16008,2443,18451
1,11,3,1,2016,10,16166,2732,18898
1,11,3,1,2016,11,16687,2963,19650
1,11,3,1,2016,12,16366,3046,19412
1,11,3,1,2016,13,15503,3041,18544
1,11,3,1,2016,14,15583,2934,18517
1,11,3,1,2016,15,15254,2999,18253
1,11,3,1,2016,16,15302,3009,18311
1,11,3,1,2016,17,14786,2990,17776
1,11,3,1,2016,18,13699,2902,16601
1,11,3,1,2016,19,14507,2808,17315
1,11,3,1,2016,20,15342,2811,18153
1,11,3,1,2016,21,15230,2716,17946
1,11,3,1,2016,22,14418,2568,16986
1,11,3,1,2016,23,14412,2457,16869
1,11,3,1,2016,24,14671,2368,17039
2,12,3,1,2016,1,14597,2157,16754
2,12,3,1,2016,2,14189,1989,16178
2,12,3,1,2016,3,14160,1899,16059
2,12,3,1,2016,4,13988,1784,15772
2,12,3,1,2016,5,14178,1773,15951
2,12,3,1,2016,6,14572,1860,16432
2,12,3,1,2016,7,15593,1938,17531
2,12,3,1,2016,8,16313,1976,18289
2,12,3,1,2016,9,16453,2139,18592
2,12,3,1,2016,10,16329,2446,18775
2,12,3,1,2016,11,16789,2725,19514
2,12,3,1,2016,12,16297,2764,19061
2,12,3,1,2016,13,16055,2743,18798
2,12,3,1,2016,14,15602,2592,18194
2,12,3,1,2016,15,15667,2608,18275
2,12,3,1,2016,16,15499,2602,18101
2,12,3,1,2016,17,15275,2566,17841
2,12,3,1,2016,18,14199,2493,16692
2,12,3,1,2016,19,13999,2468,16467
2,12,3,1,2016,20,15005,2500,17505
2,12,3,1,2016,21,14701,2533,17234
2,12,3,1,2016,22,14006,2396,16402
2,12,3,1,2016,23,14028,2298,16326
2,12,3,1,2016,24,14165,2193,16358
2,13,3,1,2016,1,14255,2046,16301
2,13,3,1,2016,2,14214,1919,16133
2,13,3,1,2016,3,14105,1811,15916
2,13,3,1,2016,4,13904,1744,15648
2,13,3,1,2016,5,14079,1715,15794
2,13,3,1,2016,6,14456,1842,16298
2,13,3,1,2016,7,15078,1873,16951
2,13,3,1,2016,8,15603,1801,17404
2,13,3,1,2016,9,15525,1924,17449
2,13,3,1,2016,10,15987,2054,18041
2,13,3,1,2016,11,16252,2121,18373
2,13,3,1,2016,12,16072,2135,18207
2,13,3,1,2016,13,15198,2028,17226
2,13,3,1,2016,14,14698,2062,16760
2,13,3,1,2016,15,14333,2055,16388
2,13,3,1,2016,16,14259,1968,16227
2,13,3,1,2016,17,14028,1944,15972
2,13,3,1,2016,18,13218,1935,15153
2,13,3,1,2016,19,13196,1951,15147
2,13,3,1,2016,20,13930,2133,16063
2,13,3,1,2016,21,13433,2176,15609
2,13,3,1,2016,22,13338,2171,15509
2,13,3,1,2016,23,13017,2090,15107
2,13,3,1,2016,24,13303,2053,15356
1,14,3,1,2016,1,13375,1949,15324
1,14,3,1,2016,2,13315,1780,15095
1,14,3,1,2016,3,13323,1688,15011
1,14,3,1,2016,4,12918,1632,14550
1,14,3,1,2016,5,13380,1622,15002
1,14,3,1,2016,6,13856,1732,15588
1,14,3,1,2016,7,14623,1861,16484
1,14,3,1,2016,8,15286,2060,17346
1,14,3,1,2016,9,15004,2313,17317
1,14,3,1,2016,10,15721,2602,18323
1,14,3,1,2016,11,15669,2849,18518
1,14,3,1,2016,12,15539,2915,18454
1,14,3,1,2016,13,15102,2903,18005
1,14,3,1,2016,14,16055,2795,18850
1,14,3,1,2016,15,16161,2782,18943
1,14,3,1,2016,16,15778,2800,18578
1,14,3,1,2016,17,14795,2771,17566
1,14,3,1,2016,18,14019,2695,16714
1,14,3,1,2016,19,13750,2620,16370
1,14,3,1,2016,20,15198,2662,17860
1,14,3,1,2016,21,15019,2523,17542
1,14,3,1,2016,22,14245,2341,16586
1,14,3,1,2016,23,14159,2232,16391
1,14,3,1,2016,24,14296,2122,16418
1,15,3,1,2016,1,14306,1949,16255
1,15,3,1,2016,2,14142,1799,15941
1,15,3,1,2016,3,14034,1706,15740
1,15,3,1,2016,4,13982,1649,15631
1,15,3,1,2016,5,14163,1653,15816
1,15,3,1,2016,6,14836,1750,16586
1,15,3,1,2016,7,14936,1896,16832
1,15,3,1,2016,8,16086,2045,18131
1,15,3,1,2016,9,16173,2336,18509
1,15,3,1,2016,10,16225,2683,18908
1,15,3,1,2016,11,16198,2893,19091
1,15,3,1,2016,12,16374,2934,19308
1,15,3,1,2016,13,16339,2918,19257
1,15,3,1,2016,14,15806,2772,18578
1,15,3,1,2016,15,15519,2798,18317
1,15,3,1,2016,16,15461,2798,18259
1,15,3,1,2016,17,15208,2795,18003
1,15,3,1,2016,18,14357,2718,17075
1,15,3,1,2016,19,14014,2664,16678
1,15,3,1,2016,20,15117,2681,17798
1,15,3,1,2016,21,14925,2580,17505
1,15,3,1,2016,22,14167,2434,16601
1,15,3,1,2016,23,14425,2264,16689
1,15,3,1,2016,24,14277,2139,16416
1,16,3,1,2016,1,14138,1964,16102
1,16,3,1,2016,2,13933,1810,15743
1,16,3,1,2016,3,13851,1730,15581
1,16,3,1,2016,4,13648,1675,15323
1,16,3,1,2016,5,13959,1678,15637
1,16,3,1,2016,6,14220,1766,15986
1,16,3,1,2016,7,15626,1920,17546
1,16,3,1,2016,8,15746,2047,17793
1,16,3,1,2016,9,16016,2313,18329
1,16,3,1,2016,10,16092,2690,18782
1,16,3,1,2016,11,16604,2910,19514
1,16,3,1,2016,12,16345,2953,19298
1,16,3,1,2016,13,15716,2934,18650
1,16,3,1,2016,14,15428,2779,18207
1,16,3,1,2016,15,15389,2828,18217
1,16,3,1,2016,16,15666,2835,18501
1,16,3,1,2016,17,15317,2827,18144
1,16,3,1,2016,18,14008,2777,16785
1,16,3,1,2016,19,14290,2712,17002
1,16,3,1,2016,20,15427,2758,18185
1,16,3,1,2016,21,15320,2620,17940
1,16,3,1,2016,22,14695,2409,17104
1,16,3,1,2016,23,14471,2392,16863
1,16,3,1,2016,24,14520,2249,16769
1,17,3,1,2016,1,14582,2067,16649
1,17,3,1,2016,2,14243,1890,16133
1,17,3,1,2016,3,14130,1802,15932
1,17,3,1,2016,4,13989,1722,15711
1,17,3,1,2016,5,14234,1718,15952
1,17,3,1,2016,6,14827,1814,16641
1,17,3,1,2016,7,15625,1962,17587
1,17,3,1,2016,8,16136,2073,18209
1,17,3,1,2016,9,16281,2356,18637
1,17,3,1,2016,10,16326,2744,19070
1,17,3,1,2016,11,16665,2957,19622
1,17,3,1,2016,12,16498,2958,19456
1,17,3,1,2016,13,16205,2928,19133
1,17,3,1,2016,14,15320,2802,18122
1,17,3,1,2016,15,15525,2821,18346
1,17,3,1,2016,16,15546,2860,18406
1,17,3,1,2016,17,15173,2837,18010
1,17,3,1,2016,18,13785,2750,16535
1,17,3,1,2016,19,14096,2665,16761
1,17,3,1,2016,20,15385,2687,18072
1,17,3,1,2016,21,15625,2622,18247
1,17,3,1,2016,22,14710,2474,17184
1,17,3,1,2016,23,14413,2370,16783
1,17,3,1,2016,24,14381,2263,16644
1,18,3,1,2016,1,14807,2046,16853
1,18,3,1,2016,2,14457,1882,16339
1,18,3,1,2016,3,14251,1785,16036
1,18,3,1,2016,4,14126,1730,15856
1,18,3,1,2016,5,14242,1714,15956
1,18,3,1,2016,6,14967,1796,16763
1,18,3,1,2016,7,16054,1962,18016
1,18,3,1,2016,8,16322,2087,18409
1,18,3,1,2016,9,15969,2331,18300
1,18,3,1,2016,10,16084,2699,18783
1,18,3,1,2016,11,16283,2983,19266
1,18,3,1,2016,12,16242,3033,19275
1,18,3,1,2016,13,15918,3012,18930
1,18,3,1,2016,14,15484,2902,18386
1,18,3,1,2016,15,15447,2962,18409
1,18,3,1,2016,16,15512,2994,18506
1,18,3,1,2016,17,15276,2980,18256
1,18,3,1,2016,18,14205,2899,17104
1,18,3,1,2016,19,13855,2755,16610
1,18,3,1,2016,20,15736,2767,18503
1,18,3,1,2016,21,15240,2657,17897
1,18,3,1,2016,22,14910,2514,17424
1,18,3,1,2016,23,14717,2417,17134
1,18,3,1,2016,24,14954,2313,17267
2,19,3,1,2016,1,14799,2154,16953
2,19,3,1,2016,2,14360,1954,16314
2,19,3,1,2016,3,14078,1831,15909
2,19,3,1,2016,4,14006,1749,15755
2,19,3,1,2016,5,14251,1746,15997
2,19,3,1,2016,6,14878,1813,16691
2,19,3,1,2016,7,15703,1902,17605
2,19,3,1,2016,8,16126,1975,18101
2,19,3,1,2016,9,16090,2220,18310
2,19,3,1,2016,10,16213,2605,18818
2,19,3,1,2016,11,16352,2820,19172
2,19,3,1,2016,12,16465,2898,19363
2,19,3,1,2016,13,16292,2897,19189
2,19,3,1,2016,14,15641,2754,18395
2,19,3,1,2016,15,15828,2772,18600
2,19,3,1,2016,16,16127,2776,18903
2,19,3,1,2016,17,15516,2748,18264
2,19,3,1,2016,18,14459,2644,17103
2,19,3,1,2016,19,14270,2576,16846
2,19,3,1,2016,20,15924,2645,18569
2,19,3,1,2016,21,15461,2560,18021
2,19,3,1,2016,22,15088,2451,17539
2,19,3,1,2016,23,14872,2390,17262
2,19,3,1,2016,24,15144,2312,17456
2,20,3,1,2016,1,14946,2234,17180
2,20,3,1,2016,2,14644,2071,16715
2,20,3,1,2016,3,14502,1925,16427
2,20,3,1,2016,4,14192,1834,16026
2,20,3,1,2016,5,14413,1800,16213
2,20,3,1,2016,6,14997,1840,16837
2,20,3,1,2016,7,15480,1847,17327
2,20,3,1,2016,8,15922,1863,17785
2,20,3,1,2016,9,15707,1970,17677
2,20,3,1,2016,10,16027,2064,18091
2,20,3,1,2016,11,16265,2211,18476
2,20,3,1,2016,12,15970,2233,18203
2,20,3,1,2016,13,15348,2263,17611
2,20,3,1,2016,14,15121,2198,17319
2,20,3,1,2016,15,14989,2187,17176
2,20,3,1,2016,16,15086,2173,17259
2,20,3,1,2016,17,14613,2152,16765
2,20,3,1,2016,18,13824,2090,15914
2,20,3,1,2016,19,13509,2107,15616
2,20,3,1,2016,20,15364,2349,17713
2,20,3,1,2016,21,14758,2355,17113
2,20,3,1,2016,22,14212,2357,16569
2,20,3,1,2016,23,14465,2325,16790
2,20,3,1,2016,24,14501,2365,16866
1,21,3,1,2016,1,14484,2216,16700
1,21,3,1,2016,2,14314,2033,16347
1,21,3,1,2016,3,14108,1911,16019
1,21,3,1,2016,4,14045,1829,15874
1,21,3,1,2016,5,14065,1810,15875
1,21,3,1,2016,6,14672,1878,16550
1,21,3,1,2016,7,15583,2003,17586
1,21,3,1,2016,8,15853,2150,18003
1,21,3,1,2016,9,16015,2469,18484
1,21,3,1,2016,10,16399,2771,19170
1,21,3,1,2016,11,16670,3008,19678
1,21,3,1,2016,12,16588,3088,19676
1,21,3,1,2016,13,15865,3094,18959
1,21,3,1,2016,14,15211,2999,18210
1,21,3,1,2016,15,15124,2997,18121
1,21,3,1,2016,16,15369,2998,18367
1,21,3,1,2016,17,15194,2971,18165
1,21,3,1,2016,18,14135,2884,17019
1,21,3,1,2016,19,13995,2711,16706
1,21,3,1,2016,20,16110,2734,18844
1,21,3,1,2016,21,15074,2630,17704
1,21,3,1,2016,22,15042,2495,17537
1,21,3,1,2016,23,14793,2410,17203
1,21,3,1,2016,24,14787,2351,17138
1,22,3,1,2016,1,15152,2268,17420
1,22,3,1,2016,2,14525,2032,16557
1,22,3,1,2016,3,14252,1907,16159
1,22,3,1,2016,4,14298,1835,16133
1,22,3,1,2016,5,14504,1795,16299
1,22,3,1,2016,6,14789,1856,16645
1,22,3,1,2016,7,15745,1946,17691
1,22,3,1,2016,8,16104,2082,18186
1,22,3,1,2016,9,16226,2420,18646
1,22,3,1,2016,10,16174,2693,18867
1,22,3,1,2016,11,16929,2937,19866
1,22,3,1,2016,12,16677,3025,19702
1,22,3,1,2016,13,16634,3015,19649
1,22,3,1,2016,14,16201,2913,19114
1,22,3,1,2016,15,16156,2962,19118
1,22,3,1,2016,16,16110,2998,19108
1,22,3,1,2016,17,16066,2951,19017
1,22,3,1,2016,18,14883,2877,17760
1,22,3,1,2016,19,14805,2770,17575
1,22,3,1,2016,20,15755,2798,18553
1,22,3,1,2016,21,15463,2689,18152
1,22,3,1,2016,22,14857,2523,17380
1,22,3,1,2016,23,15212,2418,17630
1,22,3,1,2016,24,15128,2377,17505
1,23,3,1,2016,1,15227,2206,17433
1,23,3,1,2016,2,15299,2034,17333
1,23,3,1,2016,3,15014,1925,16939
1,23,3,1,2016,4,14833,1860,16693
1,23,3,1,2016,5,14882,1823,16705
1,23,3,1,2016,6,15101,1886,16987
1,23,3,1,2016,7,15985,1972,17957
1,23,3,1,2016,8,15992,2067,18059
1,23,3,1,2016,9,16416,2365,18781
1,23,3,1,2016,10,16178,2753,18931
1,23,3,1,2016,11,16848,2979,19827
1,23,3,1,2016,12,16304,3003,19307
1,23,3,1,2016,13,16192,3019,19211
1,23,3,1,2016,14,16102,2953,19055
1,23,3,1,2016,15,16200,3018,19218
1,23,3,1,2016,16,16567,3029,19596
1,23,3,1,2016,17,16314,3002,19316
1,23,3,1,2016,18,14796,2894,17690
1,23,3,1,2016,19,14452,2709,17161
1,23,3,1,2016,20,15295,2734,18029
1,23,3,1,2016,21,15085,2604,17689
1,23,3,1,2016,22,14735,2504,17239
1,23,3,1,2016,23,14960,2451,17411
1,23,3,1,2016,24,15133,2434,17567
3,24,3,1,2016,1,15144,2356,17500
3,24,3,1,2016,2,14911,2134,17045
3,24,3,1,2016,3,14655,2000,16655
3,24,3,1,2016,4,14465,1885,16350
3,24,3,1,2016,5,14677,1832,16509
3,24,3,1,2016,6,14743,1862,16605
3,24,3,1,2016,7,14848,1840,16688
3,24,3,1,2016,8,14962,1792,16754
3,24,3,1,2016,9,14801,1814,16615
3,24,3,1,2016,10,14513,1868,16381
3,24,3,1,2016,11,14543,1933,16476
3,24,3,1,2016,12,14294,2010,16304
3,24,3,1,2016,13,14092,1988,16080
3,24,3,1,2016,14,14048,1994,16042
3,24,3,1,2016,15,13821,1998,15819
3,24,3,1,2016,16,13856,2015,15871
3,24,3,1,2016,17,13518,2012,15530
3,24,3,1,2016,18,12503,1986,14489
3,24,3,1,2016,19,12170,2048,14218
3,24,3,1,2016,20,13204,2243,15447
3,24,3,1,2016,21,13050,2255,15305
3,24,3,1,2016,22,12963,2271,15234
3,24,3,1,2016,23,12745,2295,15040
3,24,3,1,2016,24,13253,2307,15560
3,25,3,1,2016,1,13636,2194,15830
3,25,3,1,2016,2,13445,2036,15481
3,25,3,1,2016,3,13606,1919,15525
3,25,3,1,2016,4,13211,1842,15053
3,25,3,1,2016,5,13362,1817,15179
3,25,3,1,2016,6,13669,1852,15521
3,25,3,1,2016,7,14173,1881,16054
3,25,3,1,2016,8,14905,1938,16843
3,25,3,1,2016,9,15362,2139,17501
3,25,3,1,2016,10,15948,2402,18350
3,25,3,1,2016,11,15822,2646,18468
3,25,3,1,2016,12,15497,2753,18250
3,25,3,1,2016,13,15014,2765,17779
3,25,3,1,2016,14,15029,2636,17665
3,25,3,1,2016,15,15013,2671,17684
3,25,3,1,2016,16,15207,2694,17901
3,25,3,1,2016,17,14710,2676,17386
3,25,3,1,2016,18,14008,2628,16636
3,25,3,1,2016,19,13741,2577,16318
3,25,3,1,2016,20,14645,2641,17286
3,25,3,1,2016,21,14342,2592,16934
3,25,3,1,2016,22,14187,2499,16686
3,25,3,1,2016,23,14241,2442,16683
3,25,3,1,2016,24,14408,2426,16834
2,26,3,1,2016,1,14701,2267,16968
2,26,3,1,2016,2,14228,2079,16307
2,26,3,1,2016,3,13989,1943,15932
2,26,3,1,2016,4,13963,1854,15817
2,26,3,1,2016,5,14582,1827,16409
2,26,3,1,2016,6,14282,1891,16173
2,26,3,1,2016,7,15680,1913,17593
2,26,3,1,2016,8,16065,1969,18034
2,26,3,1,2016,9,16068,2174,18242
2,26,3,1,2016,10,16285,2473,18758
2,26,3,1,2016,11,16699,2666,19365
2,26,3,1,2016,12,16806,2785,19591
2,26,3,1,2016,13,15994,2796,18790
2,26,3,1,2016,14,16145,2665,18810
2,26,3,1,2016,15,16391,2696,19087
2,26,3,1,2016,16,16172,2709,18881
2,26,3,1,2016,17,16106,2683,18789
2,26,3,1,2016,18,14679,2615,17294
2,26,3,1,2016,19,14693,2561,17254
2,26,3,1,2016,20,15586,2647,18233
2,26,3,1,2016,21,15374,2607,17981
2,26,3,1,2016,22,14624,2484,17108
2,26,3,1,2016,23,15107,2430,17537
2,26,3,1,2016,24,15019,2406,17425
2,27,3,1,2016,1,15024,2266,17290
2,27,3,1,2016,2,14957,2096,17053
2,27,3,1,2016,3,14566,1956,16522
2,27,3,1,2016,4,14344,1862,16206
2,27,3,1,2016,5,14321,1810,16131
2,27,3,1,2016,6,14599,1850,16449
2,27,3,1,2016,7,15517,1854,17371
2,27,3,1,2016,8,16008,1849,17857
2,27,3,1,2016,9,16003,1959,17962
2,27,3,1,2016,10,16083,2067,18150
2,27,3,1,2016,11,16277,2195,18472
2,27,3,1,2016,12,16126,2266,18392
2,27,3,1,2016,13,15900,2276,18176
2,27,3,1,2016,14,15300,2258,17558
2,27,3,1,2016,15,15609,2275,17884
2,27,3,1,2016,16,15876,2284,18160
2,27,3,1,2016,17,15198,2248,17446
2,27,3,1,2016,18,13807,2169,15976
2,27,3,1,2016,19,13772,2175,15947
2,27,3,1,2016,20,14388,2351,16739
2,27,3,1,2016,21,13693,2401,16094
2,27,3,1,2016,22,13643,2399,16042
2,27,3,1,2016,23,13765,2392,16157
2,27,3,1,2016,24,14095,2409,16504
1,28,3,1,2016,1,14164,2323,16487
1,28,3,1,2016,2,13827,2088,15915
1,28,3,1,2016,3,13865,1977,15842
1,28,3,1,2016,4,13765,1865,15630
1,28,3,1,2016,5,13594,1815,15409
1,28,3,1,2016,6,14329,1875,16204
1,28,3,1,2016,7,14932,1961,16893
1,28,3,1,2016,8,15027,2086,17113
1,28,3,1,2016,9,14960,2405,17365
1,28,3,1,2016,10,15400,2735,18135
1,28,3,1,2016,11,15921,2959,18880
1,28,3,1,2016,12,15728,3052,18780
1,28,3,1,2016,13,15785,3056,18841
1,28,3,1,2016,14,15599,2943,18542
1,28,3,1,2016,15,15766,3010,18776
1,28,3,1,2016,16,15824,3053,18877
1,28,3,1,2016,17,15553,3047,18600
1,28,3,1,2016,18,14451,2952,17403
1,28,3,1,2016,19,14411,2817,17228
1,28,3,1,2016,20,15707,2860,18567
1,28,3,1,2016,21,15301,2800,18101
1,28,3,1,2016,22,14891,2667,17558
1,28,3,1,2016,23,14996,2623,17619
1,28,3,1,2016,24,15029,2609,17638
1,29,3,1,2016,1,15274,2411,17685
1,29,3,1,2016,2,14781,2171,16952
1,29,3,1,2016,3,14509,2026,16535
1,29,3,1,2016,4,14204,1935,16139
1,29,3,1,2016,5,14514,1895,16409
1,29,3,1,2016,6,15118,1959,17077
1,29,3,1,2016,7,15520,2033,17553
1,29,3,1,2016,8,15880,2166,18046
1,29,3,1,2016,9,16086,2495,18581
1,29,3,1,2016,10,16229,2830,19059
1,29,3,1,2016,11,16296,3037,19333
1,29,3,1,2016,12,16509,3126,19635
1,29,3,1,2016,13,16085,3115,19200
1,29,3,1,2016,14,15970,2992,18962
1,29,3,1,2016,15,16116,3053,19169
1,29,3,1,2016,16,16024,3094,19118
1,29,3,1,2016,17,16081,3077,19158
1,29,3,1,2016,18,14920,3014,17934
1,29,3,1,2016,19,15137,2893,18030
1,29,3,1,2016,20,16106,2921,19027
1,29,3,1,2016,21,15630,2827,18457
1,29,3,1,2016,22,15119,2682,17801
1,29,3,1,2016,23,15206,2582,17788
1,29,3,1,2016,24,15144,2544,17688
1,30,3,1,2016,1,15200,2350,17550
1,30,3,1,2016,2,14982,2123,17105
1,30,3,1,2016,3,14406,1979,16385
1,30,3,1,2016,4,14412,1884,16296
1,30,3,1,2016,5,14419,1842,16261
1,30,3,1,2016,6,14997,1922,16919
1,30,3,1,2016,7,15703,2008,17711
1,30,3,1,2016,8,15824,2120,17944
1,30,3,1,2016,9,15667,2482,18149
1,30,3,1,2016,10,16317,2788,19105
1,30,3,1,2016,11,16434,3000,19434
1,30,3,1,2016,12,16569,3068,19637
1,30,3,1,2016,13,16241,3063,19304
1,30,3,1,2016,14,15710,2934,18644
1,30,3,1,2016,15,15814,3001,18815
1,30,3,1,2016,16,16100,3032,19132
1,30,3,1,2016,17,15826,3020,18846
1,30,3,1,2016,18,14909,2950,17859
1,30,3,1,2016,19,14802,2853,17655
1,30,3,1,2016,20,16069,2876,18945
1,30,3,1,2016,21,15804,2729,18533
1,30,3,1,2016,22,15594,2603,18197
1,30,3,1,2016,23,15314,2538,17852
1,30,3,1,2016,24,15267,2487,17754
1,31,3,1,2016,1,15112,2347,17459
1,31,3,1,2016,2,14892,2119,17011
1,31,3,1,2016,3,14652,1984,16636
1,31,3,1,2016,4,14480,1896,16376
1,31,3,1,2016,5,14465,1851,16316
1,31,3,1,2016,6,15085,1919,17004
1,31,3,1,2016,7,15884,1989,17873
1,31,3,1,2016,8,15860,2096,17956
1,31,3,1,2016,9,15676,2441,18117
1,31,3,1,2016,10,15994,2803,18797
1,31,3,1,2016,11,16386,3025,19411
1,31,3,1,2016,12,16050,3051,19101
1,31,3,1,2016,13,15712,3045,18757
1,31,3,1,2016,14,15384,2966,18350
1,31,3,1,2016,15,15798,3024,18822
1,31,3,1,2016,16,15938,3019,18957
1,31,3,1,2016,17,15714,2964,18678
1,31,3,1,2016,18,14786,2870,17656
1,31,3,1,2016,19,14471,2775,17246
1,31,3,1,2016,20,15849,2809,18658
1,31,3,1,2016,21,15544,2746,18290
1,31,3,1,2016,22,14934,2513,17447
1,31,3,1,2016,23,15117,2460,17577
1,31,3,1,2016,24,14890,2436,17326
3,1,4,2,2016,1,14802,2326,17128
3,1,4,2,2016,2,14285,2090,16375
3,1,4,2,2016,3,14362,1947,16309
3,1,4,2,2016,4,14350,1863,16213
3,1,4,2,2016,5,14417,1840,16257
3,1,4,2,2016,6,14402,1911,16313
3,1,4,2,2016,7,15356,1997,17353
3,1,4,2,2016,8,15102,2085,17187
3,1,4,2,2016,9,15130,2323,17453
3,1,4,2,2016,10,15373,2699,18072
3,1,4,2,2016,11,15539,2989,18528
3,1,4,2,2016,12,15289,3046,18335
3,1,4,2,2016,13,15205,3039,18244
3,1,4,2,2016,14,15009,2893,17902
3,1,4,2,2016,15,15171,2973,18144
3,1,4,2,2016,16,15433,2982,18415
3,1,4,2,2016,17,15017,2969,17986
3,1,4,2,2016,18,13798,2890,16688
3,1,4,2,2016,19,13883,2733,16616
3,1,4,2,2016,20,15236,2769,18005
3,1,4,2,2016,21,14980,2649,17629
3,1,4,2,2016,22,14732,2521,17253
3,1,4,2,2016,23,14863,2445,17308
3,1,4,2,2016,24,14783,2412,17195
2,2,4,2,2016,1,14698,2285,16983
2,2,4,2,2016,2,14480,2087,16567
2,2,4,2,2016,3,14200,1956,16156
2,2,4,2,2016,4,14258,1871,16129
2,2,4,2,2016,5,14171,1828,15999
2,2,4,2,2016,6,14582,1868,16450
2,2,4,2,2016,7,15384,1937,17321
2,2,4,2,2016,8,15434,2032,17466
2,2,4,2,2016,9,15714,2234,17948
2,2,4,2,2016,10,16002,2523,18525
2,2,4,2,2016,11,16353,2807,19160
2,2,4,2,2016,12,16204,2890,19094
2,2,4,2,2016,13,16093,2873,18966
2,2,4,2,2016,14,15800,2758,18558
2,2,4,2,2016,15,15935,2779,18714
2,2,4,2,2016,16,16297,2794,19091
2,2,4,2,2016,17,15767,2779,18546
2,2,4,2,2016,18,14499,2710,17209
2,2,4,2,2016,19,13785,2627,16412
2,2,4,2,2016,20,15353,2708,18061
2,2,4,2,2016,21,14688,2637,17325
2,2,4,2,2016,22,15211,2532,17743
2,2,4,2,2016,23,14781,2454,17235
2,2,4,2,2016,24,15071,2364,17435
2,3,4,2,2016,1,15377,2270,17647
2,3,4,2,2016,2,14854,2111,16965
2,3,4,2,2016,3,14761,1983,16744
2,3,4,2,2016,4,14471,1882,16353
2,3,4,2,2016,5,14454,1830,16284
2,3,4,2,2016,6,15093,1862,16955
2,3,4,2,2016,7,15755,1865,17620
2,3,4,2,2016,8,15785,1856,17641
2,3,4,2,2016,9,15802,1936,17738
2,3,4,2,2016,10,16099,2086,18185
2,3,4,2,2016,11,16287,2226,18513
2,3,4,2,2016,12,16471,2262,18733
2,3,4,2,2016,13,15973,2294,18267
2,3,4,2,2016,14,15654,2253,17907
2,3,4,2,2016,15,15886,2248,18134
2,3,4,2,2016,16,16201,2223,18424
2,3,4,2,2016,17,15295,2163,17458
2,3,4,2,2016,18,14283,2123,16406
2,3,4,2,2016,19,14396,2110,16506
2,3,4,2,2016,20,15601,2384,17985
2,3,4,2,2016,21,15044,2393,17437
2,3,4,2,2016,22,14678,2376,17054
2,3,4,2,2016,23,15060,2367,17427
2,3,4,2,2016,24,15188,2401,17589
1,4,4,2,2016,1,15215,2270,17485
1,4,4,2,2016,2,14662,2062,16724
1,4,4,2,2016,3,14444,1914,16358
1,4,4,2,2016,4,14576,1824,16400
1,4,4,2,2016,5,14791,1794,16585
1,4,4,2,2016,6,15184,1893,17077
1,4,4,2,2016,7,15837,2026,17863
1,4,4,2,2016,8,15988,2193,18181
1,4,4,2,2016,9,16137,2426,18563
1,4,4,2,2016,10,16639,2731,19370
1,4,4,2,2016,11,16796,3015,19811
1,4,4,2,2016,12,16518,3127,19645
1,4,4,2,2016,13,16676,3121,19797
1,4,4,2,2016,14,16178,3032,19210
1,4,4,2,2016,15,16620,3039,19659
1,4,4,2,2016,16,16559,3085,19644
1,4,4,2,2016,17,15840,3076,18916
1,4,4,2,2016,18,15153,2964,18117
1,4,4,2,2016,19,14821,2838,17659
1,4,4,2,2016,20,15778,2829,18607
1,4,4,2,2016,21,15643,2728,18371
1,4,4,2,2016,22,15102,2595,17697
1,4,4,2,2016,23,15185,2541,17726
1,4,4,2,2016,24,15471,2491,17962
1,5,4,2,2016,1,15301,2289,17590
1,5,4,2,2016,2,15153,2090,17243
1,5,4,2,2016,3,14669,1942,16611
1,5,4,2,2016,4,14714,1861,16575
1,5,4,2,2016,5,14579,1837,16416
1,5,4,2,2016,6,15145,1895,17040
1,5,4,2,2016,7,15942,2011,17953
1,5,4,2,2016,8,15858,2109,17967
1,5,4,2,2016,9,15860,2440,18300
1,5,4,2,2016,10,16070,2852,18922
1,5,4,2,2016,11,16391,3069,19460
1,5,4,2,2016,12,16375,3111,19486
1,5,4,2,2016,13,16328,3111,19439
1,5,4,2,2016,14,15944,3031,18975
1,5,4,2,2016,15,16030,3085,19115
1,5,4,2,2016,16,16277,3095,19372
1,5,4,2,2016,17,15909,3055,18964
1,5,4,2,2016,18,14788,2960,17748
1,5,4,2,2016,19,14878,2840,17718
1,5,4,2,2016,20,15751,2844,18595
1,5,4,2,2016,21,15596,2736,18332
1,5,4,2,2016,22,15222,2585,17807
1,5,4,2,2016,23,15461,2506,17967
1,5,4,2,2016,24,15282,2451,17733
1,6,4,2,2016,1,15511,2254,17765
1,6,4,2,2016,2,15230,2050,17280
1,6,4,2,2016,3,15068,1929,16997
1,6,4,2,2016,4,15087,1838,16925
1,6,4,2,2016,5,15096,1805,16901
1,6,4,2,2016,6,15600,1873,17473
1,6,4,2,2016,7,16091,1993,18084
1,6,4,2,2016,8,16019,2108,18127
1,6,4,2,2016,9,16191,2373,18564
1,6,4,2,2016,10,16161,2693,18854
1,6,4,2,2016,11,16454,2982,19436
1,6,4,2,2016,12,16397,3083,19480
1,6,4,2,2016,13,16274,3081,19355
1,6,4,2,2016,14,15838,2986,18824
1,6,4,2,2016,15,16306,3018,19324
1,6,4,2,2016,16,16295,3054,19349
1,6,4,2,2016,17,15670,3063,18733
1,6,4,2,2016,18,14411,2947,17358
1,6,4,2,2016,19,13791,2775,16566
1,6,4,2,2016,20,14981,2795,17776
1,6,4,2,2016,21,14834,2716,17550
1,6,4,2,2016,22,14052,2589,16641
1,6,4,2,2016,23,14054,2477,16531
1,6,4,2,2016,24,14405,2516,16921
1,7,4,2,2016,1,14630,2285,16915
1,7,4,2,2016,2,14110,2078,16188
1,7,4,2,2016,3,14259,1935,16194
1,7,4,2,2016,4,13952,1838,15790
1,7,4,2,2016,5,14114,1820,15934
1,7,4,2,2016,6,14562,1890,16452
1,7,4,2,2016,7,15222,1994,17216
1,7,4,2,2016,8,15396,2099,17495
1,7,4,2,2016,9,15203,2464,17667
1,7,4,2,2016,10,15644,2820,18464
1,7,4,2,2016,11,15994,3043,19037
1,7,4,2,2016,12,15625,3130,18755
1,7,4,2,2016,13,15788,3130,18918
1,7,4,2,2016,14,15654,2996,18650
1,7,4,2,2016,15,15598,3025,18623
1,7,4,2,2016,16,16146,3027,19173
1,7,4,2,2016,17,15662,3002,18664
1,7,4,2,2016,18,14698,2887,17585
1,7,4,2,2016,19,14595,2715,17310
1,7,4,2,2016,20,15919,2739,18658
1,7,4,2,2016,21,15697,2621,18318
1,7,4,2,2016,22,15302,2358,17660
1,7,4,2,2016,23,15197,2418,17615
1,7,4,2,2016,24,15240,2426,17666
3,8,4,2,2016,1,15343,2243,17586
3,8,4,2,2016,2,14911,2076,16987
3,8,4,2,2016,3,14786,1913,16699
3,8,4,2,2016,4,14482,1830,16312
3,8,4,2,2016,5,14497,1802,16299
3,8,4,2,2016,6,15219,1852,17071
3,8,4,2,2016,7,15506,1866,17372
3,8,4,2,2016,8,15385,1904,17289
3,8,4,2,2016,9,15191,2102,17293
3,8,4,2,2016,10,14997,2334,17331
3,8,4,2,2016,11,15252,2487,17739
3,8,4,2,2016,12,15183,2554,17737
3,8,4,2,2016,13,14794,2556,17350
3,8,4,2,2016,14,14779,2451,17230
3,8,4,2,2016,15,14884,2480,17364
3,8,4,2,2016,16,14789,2496,17285
3,8,4,2,2016,17,14557,2454,17011
3,8,4,2,2016,18,13313,2378,15691
3,8,4,2,2016,19,13087,2367,15454
3,8,4,2,2016,20,14675,2490,17165
3,8,4,2,2016,21,14440,2513,16953
3,8,4,2,2016,22,14188,2419,16607
3,8,4,2,2016,23,14387,2365,16752
3,8,4,2,2016,24,14660,2405,17065
2,9,4,2,2016,1,14484,2318,16802
2,9,4,2,2016,2,14394,2086,16480
2,9,4,2,2016,3,14072,1958,16030
2,9,4,2,2016,4,13823,1872,15695
2,9,4,2,2016,5,13810,1832,15642
2,9,4,2,2016,6,14500,1885,16385
2,9,4,2,2016,7,15350,1925,17275
2,9,4,2,2016,8,15371,1962,17333
2,9,4,2,2016,9,15509,2189,17698
2,9,4,2,2016,10,15881,2480,18361
2,9,4,2,2016,11,16005,2705,18710
2,9,4,2,2016,12,16176,2821,18997
2,9,4,2,2016,13,15845,2807,18652
2,9,4,2,2016,14,15650,2691,18341
2,9,4,2,2016,15,15909,2737,18646
2,9,4,2,2016,16,16110,2739,18849
2,9,4,2,2016,17,16054,2702,18756
2,9,4,2,2016,18,14847,2594,17441
2,9,4,2,2016,19,14348,2550,16898
2,9,4,2,2016,20,16119,2636,18755
2,9,4,2,2016,21,15980,2615,18595
2,9,4,2,2016,22,15058,2512,17570
2,9,4,2,2016,23,15189,2457,17646
2,9,4,2,2016,24,15191,2484,17675
2,10,4,2,2016,1,15517,2388,17905
2,10,4,2,2016,2,15084,2172,17256
2,10,4,2,2016,3,15065,2020,17085
2,10,4,2,2016,4,14685,1919,16604
2,10,4,2,2016,5,14874,1859,16733
2,10,4,2,2016,6,15352,1889,17241
2,10,4,2,2016,7,15888,1888,17776
2,10,4,2,2016,8,15708,1889,17597
2,10,4,2,2016,9,15915,1962,17877
2,10,4,2,2016,10,15864,2088,17952
2,10,4,2,2016,11,16159,2207,18366
2,10,4,2,2016,12,16167,2288,18455
2,10,4,2,2016,13,15808,2331,18139
2,10,4,2,2016,14,15807,2288,18095
2,10,4,2,2016,15,15890,2288,18178
2,10,4,2,2016,16,16063,2265,18328
2,10,4,2,2016,17,15451,2209,17660
2,10,4,2,2016,18,14407,2146,16553
2,10,4,2,2016,19,14167,2140,16307
2,10,4,2,2016,20,15531,2345,17876
2,10,4,2,2016,21,15112,2436,17548
2,10,4,2,2016,22,14904,2387,17291
2,10,4,2,2016,23,14867,2435,17302
2,10,4,2,2016,24,15095,2547,17642
1,11,4,2,2016,1,15217,2394,17611
1,11,4,2,2016,2,15174,2165,17339
1,11,4,2,2016,3,14791,2022,16813
1,11,4,2,2016,4,14841,1910,16751
1,11,4,2,2016,5,14837,1871,16708
1,11,4,2,2016,6,15459,1959,17418
1,11,4,2,2016,7,15788,2037,17825
1,11,4,2,2016,8,15730,2185,17915
1,11,4,2,2016,9,15852,2429,18281
1,11,4,2,2016,10,16042,2786,18828
1,11,4,2,2016,11,16255,3111,19366
1,11,4,2,2016,12,16256,3188,19444
1,11,4,2,2016,13,16208,3203,19411
1,11,4,2,2016,14,16131,3108,19239
1,11,4,2,2016,15,16221,3146,19367
1,11,4,2,2016,16,16749,3177,19926
1,11,4,2,2016,17,16018,3129,19147
1,11,4,2,2016,18,15092,3024,18116
1,11,4,2,2016,19,15026,2850,17876
1,11,4,2,2016,20,15942,2864,18806
1,11,4,2,2016,21,15734,2741,18475
1,11,4,2,2016,22,15500,2668,18168
1,11,4,2,2016,23,15644,2652,18296
1,11,4,2,2016,24,15742,2645,18387
1,12,4,2,2016,1,15689,2474,18163
1,12,4,2,2016,2,15091,2261,17352
1,12,4,2,2016,3,14686,2067,16753
1,12,4,2,2016,4,14866,1975,16841
1,12,4,2,2016,5,14958,1926,16884
1,12,4,2,2016,6,15291,1994,17285
1,12,4,2,2016,7,16002,2051,18053
1,12,4,2,2016,8,15878,2177,18055
1,12,4,2,2016,9,16061,2505,18566
1,12,4,2,2016,10,16485,2847,19332
1,12,4,2,2016,11,16867,3102,19969
1,12,4,2,2016,12,16882,3222,20104
1,12,4,2,2016,13,16130,3231,19361
1,12,4,2,2016,14,16387,3147,19534
1,12,4,2,2016,15,16468,3210,19678
1,12,4,2,2016,16,16925,3226,20151
1,12,4,2,2016,17,16588,3170,19758
1,12,4,2,2016,18,15545,3084,18629
1,12,4,2,2016,19,15265,2869,18134
1,12,4,2,2016,20,16490,2894,19384
1,12,4,2,2016,21,16391,2771,19162
1,12,4,2,2016,22,15520,2722,18242
1,12,4,2,2016,23,16357,2684,19041
1,12,4,2,2016,24,15989,2655,18644
1,13,4,2,2016,1,16136,2498,18634
1,13,4,2,2016,2,15645,2267,17912
1,13,4,2,2016,3,15448,2116,17564
1,13,4,2,2016,4,16048,2022,18070
1,13,4,2,2016,5,15517,1973,17490
1,13,4,2,2016,6,15490,2030,17520
1,13,4,2,2016,7,16079,2061,18140
1,13,4,2,2016,8,15865,2203,18068
1,13,4,2,2016,9,16264,2447,18711
1,13,4,2,2016,10,16637,2809,19446
1,13,4,2,2016,11,16995,3121,20116
1,13,4,2,2016,12,16662,3214,19876
1,13,4,2,2016,13,16446,3204,19650
1,13,4,2,2016,14,16271,3129,19400
1,13,4,2,2016,15,16380,3167,19547
1,13,4,2,2016,16,16876,3183,20059
1,13,4,2,2016,17,16678,3149,19827
1,13,4,2,2016,18,15497,3080,18577
1,13,4,2,2016,19,15172,2893,18065
1,13,4,2,2016,20,16027,2903,18930
1,13,4,2,2016,21,16170,2773,18943
1,13,4,2,2016,22,15824,2739,18563
1,13,4,2,2016,23,15903,2643,18546
1,13,4,2,2016,24,16040,2554,18594
3,14,4,2,2016,1,16034,2514,18548
3,14,4,2,2016,2,15572,2289,17861
3,14,4,2,2016,3,15045,2110,17155
3,14,4,2,2016,4,15201,1994,17195
3,14,4,2,2016,5,15257,1953,17210
3,14,4,2,2016,6,15685,1987,17672
3,14,4,2,2016,7,16424,2004,18428
3,14,4,2,2016,8,16045,2085,18130
3,14,4,2,2016,9,15927,2342,18269
3,14,4,2,2016,10,16670,2597,19267
3,14,4,2,2016,11,17165,2821,19986
3,14,4,2,2016,12,16832,2937,19769
3,14,4,2,2016,13,16458,2935,19393
3,14,4,2,2016,14,16625,2865,19490
3,14,4,2,2016,15,16677,2906,19583
3,14,4,2,2016,16,16628,2936,19564
3,14,4,2,2016,17,16446,2910,19356
3,14,4,2,2016,18,15431,2843,18274
3,14,4,2,2016,19,14357,2714,17071
3,14,4,2,2016,20,15718,2776,18494
3,14,4,2,2016,21,15516,2596,18112
3,14,4,2,2016,22,15423,2595,18018
3,14,4,2,2016,23,15970,2539,18509
3,14,4,2,2016,24,15859,2590,18449
3,15,4,2,2016,1,15693,2449,18142
3,15,4,2,2016,2,15353,2243,17596
3,15,4,2,2016,3,14918,2093,17011
3,15,4,2,2016,4,14895,1980,16875
3,15,4,2,2016,5,15230,1932,17162
3,15,4,2,2016,6,15294,1971,17265
3,15,4,2,2016,7,15912,1988,17900
3,15,4,2,2016,8,15448,2100,17548
3,15,4,2,2016,9,15955,2302,18257
3,15,4,2,2016,10,16069,2631,18700
3,15,4,2,2016,11,16320,2954,19274
3,15,4,2,2016,12,16542,3027,19569
3,15,4,2,2016,13,16230,3051,19281
3,15,4,2,2016,14,16086,2956,19042
3,15,4,2,2016,15,15936,2948,18884
3,15,4,2,2016,16,15854,2965,18819
3,15,4,2,2016,17,15291,2932,18223
3,15,4,2,2016,18,14241,2845,17086
3,15,4,2,2016,19,14610,2721,17331
3,15,4,2,2016,20,15454,2782,18236
3,15,4,2,2016,21,15450,2713,18163
3,15,4,2,2016,22,15355,2599,17954
3,15,4,2,2016,23,15039,2579,17618
3,15,4,2,2016,24,15330,2549,17879
2,16,4,2,2016,1,15596,2483,18079
2,16,4,2,2016,2,15267,2230,17497
2,16,4,2,2016,3,15036,2070,17106
2,16,4,2,2016,4,15215,1970,17185
2,16,4,2,2016,5,15126,1910,17036
2,16,4,2,2016,6,15805,1949,17754
2,16,4,2,2016,7,15837,1967,17804
2,16,4,2,2016,8,15763,2063,17826
2,16,4,2,2016,9,16328,2233,18561
2,16,4,2,2016,10,16322,2546,18868
2,16,4,2,2016,11,16941,2856,19797
2,16,4,2,2016,12,16725,2932,19657
2,16,4,2,2016,13,16470,2930,19400
2,16,4,2,2016,14,16147,2885,19032
2,16,4,2,2016,15,16516,2900,19416
2,16,4,2,2016,16,16690,2885,19575
2,16,4,2,2016,17,16054,2839,18893
2,16,4,2,2016,18,14835,2755,17590
2,16,4,2,2016,19,14164,2642,16806
2,16,4,2,2016,20,15591,2727,18318
2,16,4,2,2016,21,15526,2686,18212
2,16,4,2,2016,22,15095,2569,17664
2,16,4,2,2016,23,15383,2487,17870
2,16,4,2,2016,24,15764,2443,18207
2,17,4,2,2016,1,15729,2341,18070
2,17,4,2,2016,2,15668,2200,17868
2,17,4,2,2016,3,15081,2050,17131
2,17,4,2,2016,4,15391,1941,17332
2,17,4,2,2016,5,15497,1902,17399
2,17,4,2,2016,6,15451,1926,17377
2,17,4,2,2016,7,15581,1898,17479
2,17,4,2,2016,8,15141,1890,17031
2,17,4,2,2016,9,15443,1954,17397
2,17,4,2,2016,10,15526,2054,17580
2,17,4,2,2016,11,16248,2155,18403
2,17,4,2,2016,12,16089,2235,18324
2,17,4,2,2016,13,15835,2226,18061
2,17,4,2,2016,14,15667,2207,17874
2,17,4,2,2016,15,15641,2204,17845
2,17,4,2,2016,16,16357,2200,18557
2,17,4,2,2016,17,15556,2184,17740
2,17,4,2,2016,18,14447,2155,16602
2,17,4,2,2016,19,13655,2160,15815
2,17,4,2,2016,20,15551,2381,17932
2,17,4,2,2016,21,15213,2433,17646
2,17,4,2,2016,22,15097,2430,17527
2,17,4,2,2016,23,15316,2454,17770
2,17,4,2,2016,24,15721,2475,18196
1,18,4,2,2016,1,15190,2396,17586
1,18,4,2,2016,2,14914,2141,17055
1,18,4,2,2016,3,15241,2041,17282
1,18,4,2,2016,4,15129,1939,17068
1,18,4,2,2016,5,15027,1902,16929
1,18,4,2,2016,6,15291,1948,17239
1,18,4,2,2016,7,15547,1996,17543
1,18,4,2,2016,8,15970,2158,18128
1,18,4,2,2016,9,15727,2437,18164
1,18,4,2,2016,10,16092,2849,18941
1,18,4,2,2016,11,16644,3119,19763
1,18,4,2,2016,12,17215,3172,20387
1,18,4,2,2016,13,16580,3188,19768
1,18,4,2,2016,14,16274,3108,19382
1,18,4,2,2016,15,16828,3168,19996
1,18,4,2,2016,16,16953,3164,20117
1,18,4,2,2016,17,16219,3107,19326
1,18,4,2,2016,18,14964,3002,17966
1,18,4,2,2016,19,15223,2821,18044
1,18,4,2,2016,20,16131,2865,18996
1,18,4,2,2016,21,16031,2785,18816
1,18,4,2,2016,22,15753,2689,18442
1,18,4,2,2016,23,15630,2661,18291
1,18,4,2,2016,24,15909,2652,18561
3,19,4,2,2016,1,15908,2489,18397
3,19,4,2,2016,2,15487,2258,17745
3,19,4,2,2016,3,15652,2103,17755
3,19,4,2,2016,4,14993,2003,16996
3,19,4,2,2016,5,15279,1965,17244
3,19,4,2,2016,6,15705,2006,17711
3,19,4,2,2016,7,16448,2017,18465
3,19,4,2,2016,8,16282,2112,18394
3,19,4,2,2016,9,16182,2360,18542
3,19,4,2,2016,10,16737,2647,19384
3,19,4,2,2016,11,16915,2926,19841
3,19,4,2,2016,12,17134,3073,20207
3,19,4,2,2016,13,16681,3012,19693
3,19,4,2,2016,14,16531,3069,19600
3,19,4,2,2016,15,16750,3070,19820
3,19,4,2,2016,16,16875,3033,19908
3,19,4,2,2016,17,16269,2942,19211
3,19,4,2,2016,18,14937,2829,17766
3,19,4,2,2016,19,15181,2838,18019
3,19,4,2,2016,20,16470,2790,19260
3,19,4,2,2016,21,16273,2785,19058
3,19,4,2,2016,22,15726,2706,18432
3,19,4,2,2016,23,15702,2672,18374
3,19,4,2,2016,24,15581,2668,18249
1,20,4,2,2016,1,16189,2521,18710
1,20,4,2,2016,2,16023,2262,18285
1,20,4,2,2016,3,15929,2111,18040
1,20,4,2,2016,4,15719,2030,17749
1,20,4,2,2016,5,15788,1989,17777
1,20,4,2,2016,6,16070,2012,18082
1,20,4,2,2016,7,16461,2059,18520
1,20,4,2,2016,8,16285,2197,18482
1,20,4,2,2016,9,16364,2434,18798
1,20,4,2,2016,10,16944,2799,19743
1,20,4,2,2016,11,17411,3111,20522
1,20,4,2,2016,12,17320,3193,20513
1,20,4,2,2016,13,16782,3189,19971
1,20,4,2,2016,14,16828,3118,19946
1,20,4,2,2016,15,16983,3156,20139
1,20,4,2,2016,16,16894,3176,20070
1,20,4,2,2016,17,16644,3144,19788
1,20,4,2,2016,18,15419,3031,18450
1,20,4,2,2016,19,15322,2872,18194
1,20,4,2,2016,20,16619,2870,19489
1,20,4,2,2016,21,15894,2727,18621
1,20,4,2,2016,22,15801,2692,18493
1,20,4,2,2016,23,16024,2546,18570
1,20,4,2,2016,24,16234,2721,18955
1,21,4,2,2016,1,15765,2479,18244
1,21,4,2,2016,2,15794,2252,18046
1,21,4,2,2016,3,15488,2122,17610
1,21,4,2,2016,4,15350,2020,17370
1,21,4,2,2016,5,15702,1976,17678
1,21,4,2,2016,6,16040,2028,18068
1,21,4,2,2016,7,15959,2047,18006
1,21,4,2,2016,8,16476,2180,18656
1,21,4,2,2016,9,16114,2495,18609
1,21,4,2,2016,10,16729,2810,19539
1,21,4,2,2016,11,16701,3062,19763
1,21,4,2,2016,12,16535,3169,19704
1,21,4,2,2016,13,16058,3160,19218
1,21,4,2,2016,14,16489,3097,19586
1,21,4,2,2016,15,16451,3106,19557
1,21,4,2,2016,16,16714,3139,19854
1,21,4,2,2016,17,15808,3104,18912
1,21,4,2,2016,18,15100,2967,18067
1,21,4,2,2016,19,15050,2801,17851
1,21,4,2,2016,20,15838,2828,18666
1,21,4,2,2016,21,15834,2824,18658
1,21,4,2,2016,22,15214,2698,17912
1,21,4,2,2016,23,15534,2649,18182
1,21,4,2,2016,24,15654,2613,18267
1,22,4,2,2016,1,16100,2376,18476
1,22,4,2,2016,2,15454,2169,17623
1,22,4,2,2016,3,14956,2029,16985
1,22,4,2,2016,4,15123,1926,17049
1,22,4,2,2016,5,15257,1883,17140
1,22,4,2,2016,6,15994,1940,17934
1,22,4,2,2016,7,16138,1987,18125
1,22,4,2,2016,8,15705,2093,17798
1,22,4,2,2016,9,15264,2441,17705
1,22,4,2,2016,10,16122,2773,18895
1,22,4,2,2016,11,16269,2970,19239
1,22,4,2,2016,12,15599,3074,18673
1,22,4,2,2016,13,14871,3044,17915
1,22,4,2,2016,14,14516,2922,17438
1,22,4,2,2016,15,14674,2959,17633
1,22,4,2,2016,16,14788,2984,17772
1,22,4,2,2016,17,14347,2957,17304
1,22,4,2,2016,18,13816,2902,16718
1,22,4,2,2016,19,13656,2723,16379
1,22,4,2,2016,20,15050,2754,17804
1,22,4,2,2016,21,14542,2680,17222
1,22,4,2,2016,22,14952,2542,17494
1,22,4,2,2016,23,14850,2486,17336
1,22,4,2,2016,24,15367,2469,17836
2,23,4,2,2016,1,15252,2363,17615
2,23,4,2,2016,2,14984,2156,17140
2,23,4,2,2016,3,15038,2010,17048
2,23,4,2,2016,4,14400,1924,16324
2,23,4,2,2016,5,14717,1882,16599
2,23,4,2,2016,6,15105,1931,17036
2,23,4,2,2016,7,15046,1925,16971
2,23,4,2,2016,8,15576,1986,17562
2,23,4,2,2016,9,15182,2177,17359
2,23,4,2,2016,10,15888,2481,18369
2,23,4,2,2016,11,16029,2618,18647
2,23,4,2,2016,12,16050,2752,18802
2,23,4,2,2016,13,16010,2748,18758
2,23,4,2,2016,14,15371,2676,18047
2,23,4,2,2016,15,15339,2706,18045
2,23,4,2,2016,16,15139,2731,17870
2,23,4,2,2016,17,14738,2693,17431
2,23,4,2,2016,18,14369,2623,16992
2,23,4,2,2016,19,14263,2546,16809
2,23,4,2,2016,20,16110,2648,18758
2,23,4,2,2016,21,15466,2560,18026
2,23,4,2,2016,22,15460,2500,17960
2,23,4,2,2016,23,15376,2382,17758
2,23,4,2,2016,24,15677,2422,18099
2,24,4,2,2016,1,15336,2316,17652
2,24,4,2,2016,2,15028,2150,17178
2,24,4,2,2016,3,14759,2010,16769
2,24,4,2,2016,4,14469,1912,16381
2,24,4,2,2016,5,14469,1858,16327
2,24,4,2,2016,6,14899,1879,16778
2,24,4,2,2016,7,15546,1834,17380
2,24,4,2,2016,8,15255,1838,17093
2,24,4,2,2016,9,15292,1898,17190
2,24,4,2,2016,10,16005,2012,18017
2,24,4,2,2016,11,16205,2102,18307
2,24,4,2,2016,12,16052,2175,18227
2,24,4,2,2016,13,15674,2155,17829
2,24,4,2,2016,14,14965,2114,17079
2,24,4,2,2016,15,14848,2110,16958
2,24,4,2,2016,16,15129,2106,17235
2,24,4,2,2016,17,14722,2078,16800
2,24,4,2,2016,18,13321,2058,15379
2,24,4,2,2016,19,13272,2050,15322
2,24,4,2,2016,20,14747,2351,17098
2,24,4,2,2016,21,14812,2340,17152
2,24,4,2,2016,22,14296,2325,16621
2,24,4,2,2016,23,14900,2346,17246
2,24,4,2,2016,24,15005,2362,17367
1,25,4,2,2016,1,15032,2261,17293
1,25,4,2,2016,2,14937,2077,17014
1,25,4,2,2016,3,14634,1941,16575
1,25,4,2,2016,4,14460,1863,16323
1,25,4,2,2016,5,14233,1832,16065
1,25,4,2,2016,6,14788,1890,16678
1,25,4,2,2016,7,15583,1934,17517
1,25,4,2,2016,8,15128,2048,17176
1,25,4,2,2016,9,15552,2327,17879
1,25,4,2,2016,10,16260,2729,18989
1,25,4,2,2016,11,17098,2955,20053
1,25,4,2,2016,12,16308,3036,19344
1,25,4,2,2016,13,16074,3029,19103
1,25,4,2,2016,14,15986,2921,18907
1,25,4,2,2016,15,16006,2986,18992
1,25,4,2,2016,16,15685,2998,18683
1,25,4,2,2016,17,15481,2991,18472
1,25,4,2,2016,18,14486,2883,17369
1,25,4,2,2016,19,14277,2704,16981
1,25,4,2,2016,20,15841,2719,18560
1,25,4,2,2016,21,15532,2637,18169
1,25,4,2,2016,22,14955,2505,17460
1,25,4,2,2016,23,15015,2463,17478
1,25,4,2,2016,24,15644,2430,18074
1,26,4,2,2016,1,15382,2300,17682
1,26,4,2,2016,2,15389,2080,17469
1,26,4,2,2016,3,14953,1959,16912
1,26,4,2,2016,4,14940,1882,16822
1,26,4,2,2016,5,14863,1829,16692
1,26,4,2,2016,6,14784,1895,16679
1,26,4,2,2016,7,15391,1936,17327
1,26,4,2,2016,8,15431,2050,17481
1,26,4,2,2016,9,15594,2376,17970
1,26,4,2,2016,10,15974,2689,18663
1,26,4,2,2016,11,16032,2963,18995
1,26,4,2,2016,12,16337,3087,19424
1,26,4,2,2016,13,15913,3078,18991
1,26,4,2,2016,14,15690,3007,18697
1,26,4,2,2016,15,16029,3072,19101
1,26,4,2,2016,16,16719,3090,19809
1,26,4,2,2016,17,15825,3077,18902
1,26,4,2,2016,18,14958,2982,17940
1,26,4,2,2016,19,14725,2829,17554
1,26,4,2,2016,20,15493,2833,18326
1,26,4,2,2016,21,15907,2716,18623
1,26,4,2,2016,22,15198,2630,17828
1,26,4,2,2016,23,15330,2578,17908
1,26,4,2,2016,24,15714,2562,18276
1,27,4,2,2016,1,15547,2443,17990
1,27,4,2,2016,2,15141,2225,17366
1,27,4,2,2016,3,14791,2079,16870
1,27,4,2,2016,4,14826,1993,16819
1,27,4,2,2016,5,14900,1943,16843
1,27,4,2,2016,6,14665,1995,16660
1,27,4,2,2016,7,15487,2029,17516
1,27,4,2,2016,8,15208,2151,17359
1,27,4,2,2016,9,15657,2384,18041
1,27,4,2,2016,10,16009,2812,18821
1,27,4,2,2016,11,16525,3097,19622
1,27,4,2,2016,12,16453,3122,19575
1,27,4,2,2016,13,15995,3153,19148
1,27,4,2,2016,14,15560,3163,18723
1,27,4,2,2016,15,16402,3191,19593
1,27,4,2,2016,16,16401,3192,19593
1,27,4,2,2016,17,16108,3190,19298
1,27,4,2,2016,18,14710,3034,17744
1,27,4,2,2016,19,14979,2930,17909
1,27,4,2,2016,20,15820,2874,18694
1,27,4,2,2016,21,15219,2798,18017
1,27,4,2,2016,22,14609,2713,17322
1,27,4,2,2016,23,14777,2647,17424
1,27,4,2,2016,24,14933,2661,17594
1,28,4,2,2016,1,15492,2607,18099
1,28,4,2,2016,2,15264,2364,17628
1,28,4,2,2016,3,14829,2190,17019
1,28,4,2,2016,4,14395,2076,16471
1,28,4,2,2016,5,14890,2021,16911
1,28,4,2,2016,6,15133,2054,17187
1,28,4,2,2016,7,15097,2055,17152
1,28,4,2,2016,8,15200,2135,17335
1,28,4,2,2016,9,15258,2478,17736
1,28,4,2,2016,10,15766,2844,18610
1,28,4,2,2016,11,16014,3079,19093
1,28,4,2,2016,12,16275,3177,19452
1,28,4,2,2016,13,15907,3236,19143
1,28,4,2,2016,14,15614,3190,18804
1,28,4,2,2016,15,15921,3259,19180
1,28,4,2,2016,16,16131,3264,19395
1,28,4,2,2016,17,15750,3253,19003
1,28,4,2,2016,18,14838,3101,17939
1,28,4,2,2016,19,14808,2941,17749
1,28,4,2,2016,20,15253,2946,18199
1,28,4,2,2016,21,15245,2857,18102
1,28,4,2,2016,22,15162,2762,17924
1,28,4,2,2016,23,15394,2778,18172
1,28,4,2,2016,24,15746,2790,18536
1,29,4,2,2016,1,15687,2626,18313
1,29,4,2,2016,2,15006,2435,17441
1,29,4,2,2016,3,15011,2236,17247
1,29,4,2,2016,4,14919,2120,17039
1,29,4,2,2016,5,15157,2066,17223
1,29,4,2,2016,6,15401,2087,17488
1,29,4,2,2016,7,15603,2093,17696
1,29,4,2,2016,8,15799,2187,17986
1,29,4,2,2016,9,15506,2554,18060
1,29,4,2,2016,10,15861,2897,18758
1,29,4,2,2016,11,15713,3153,18866
1,29,4,2,2016,12,15877,3261,19138
1,29,4,2,2016,13,15551,3266,18817
1,29,4,2,2016,14,15382,3159,18541
1,29,4,2,2016,15,15188,3230,18418
1,29,4,2,2016,16,15337,3264,18601
1,29,4,2,2016,17,14569,3227,17796
1,29,4,2,2016,18,13760,3070,16830
1,29,4,2,2016,19,14274,2928,17202
1,29,4,2,2016,20,14946,2906,17852
1,29,4,2,2016,21,15096,2829,17925
1,29,4,2,2016,22,14990,2740,17730
1,29,4,2,2016,23,14807,2737,17544
1,29,4,2,2016,24,15448,2765,18213
1,29,4,2,2016,1,15546,2626,18172
2,30,4,2,2016,2,14613,2400,17013
2,30,4,2,2016,3,15136,2221,17358
2,30,4,2,2016,4,14971,2140,17111
2,30,4,2,2016,5,15094,2058,17152
2,30,4,2,2016,6,15221,2061,17282
2,30,4,2,2016,7,15358,2032,17390
2,30,4,2,2016,8,15238,2059,17297
2,30,4,2,2016,9,15336,2283,17619
2,30,4,2,2016,10,16116,2633,18748
2,30,4,2,2016,11,16217,2877,19094
2,30,4,2,2016,12,16236,2960,19196
2,30,4,2,2016,13,15937,2974,18911
2,30,4,2,2016,14,15867,2938,18805
2,30,4,2,2016,15,16003,2973,18976
2,30,4,2,2016,16,16207,2969,19176
2,30,4,2,2016,17,15560,2926,18486
2,30,4,2,2016,18,14639,2825,17464
2,30,4,2,2016,19,14610,2666,17276
2,30,4,2,2016,20,15203,2756,17959
2,30,4,2,2016,21,15262,2723,17984
2,30,4,2,2016,22,15120,2685,17805
2,30,4,2,2016,23,14956,2607,17563
2,30,4,2,2016,24,15502,2615,18117
3,1,5,2,2016,1,15594,2509,18103
3,1,5,2,2016,2,15393,2316,17709
3,1,5,2,2016,3,15183,2194,17377
3,1,5,2,2016,4,15223,2089,17312
3,1,5,2,2016,5,15165,2025,17190
3,1,5,2,2016,6,15219,2021,17240
3,1,5,2,2016,7,14558,1951,16509
3,1,5,2,2016,8,14333,1913,16246
3,1,5,2,2016,9,14197,1956,16153
3,1,5,2,2016,10,14114,1997,16111
3,1,5,2,2016,11,14225,2089,16314
3,1,5,2,2016,12,13852,2165,16017
3,1,5,2,2016,13,13666,2180,15846
3,1,5,2,2016,14,13513,2183,15696
3,1,5,2,2016,15,13707,2211,15918
3,1,5,2,2016,16,13624,2223,15847
3,1,5,2,2016,17,13314,2188,15502
3,1,5,2,2016,18,12795,2145,14940
3,1,5,2,2016,19,12360,2133,14493
3,1,5,2,2016,20,13643,2331,15974
3,1,5,2,2016,21,13724,2382,16106
3,1,5,2,2016,22,13527,2439,15966
3,1,5,2,2016,23,13616,2474,16090
3,1,5,2,2016,24,14273,2535,16808
1,2,5,2,2016,1,14295,2491,16786
1,2,5,2,2016,2,14147,2276,16423
1,2,5,2,2016,3,14177,2126,16303
1,2,5,2,2016,4,13956,2021,15977
1,2,5,2,2016,5,13799,1969,15768
1,2,5,2,2016,6,14256,2008,16264
1,2,5,2,2016,7,14844,2016,16860
1,2,5,2,2016,8,15040,2160,17200
1,2,5,2,2016,9,15103,2510,17613
1,2,5,2,2016,10,15933,2847,18780
1,2,5,2,2016,11,16648,3080,19728
1,2,5,2,2016,12,16334,3161,19496
1,2,5,2,2016,13,16390,3189,19579
1,2,5,2,2016,14,16256,3155,19411
1,2,5,2,2016,15,16157,3144,19301
1,2,5,2,2016,16,16347,3187,19534
1,2,5,2,2016,17,15556,3180,18736
1,2,5,2,2016,18,14462,3080,17542
1,2,5,2,2016,19,14230,2900,17130
1,2,5,2,2016,20,15514,2881,18395
1,2,5,2,2016,21,15578,2823,18401
1,2,5,2,2016,22,15481,2718,18199
1,2,5,2,2016,23,15553,2716,18269
1,2,5,2,2016,24,15711,2722,18433
1,3,5,2,2016,1,15382,2527,17909
1,3,5,2,2016,2,15527,2341,17868
1,3,5,2,2016,3,15144,2199,17343
1,3,5,2,2016,4,14763,2089,16852
1,3,5,2,2016,5,14940,2043,16983
1,3,5,2,2016,6,14954,2082,17036
1,3,5,2,2016,7,15346,2078,17424
1,3,5,2,2016,8,15302,2158,17460
1,3,5,2,2016,9,15444,2489,17933
1,3,5,2,2016,10,16326,2836,19162
1,3,5,2,2016,11,16798,3064,19862
1,3,5,2,2016,12,16426,3216,19642
1,3,5,2,2016,13,16240,3222,19462
1,3,5,2,2016,14,16006,3217,19223
1,3,5,2,2016,15,16205,3202,19407
1,3,5,2,2016,16,16280,3255,19535
1,3,5,2,2016,17,15814,3200,19014
1,3,5,2,2016,18,14847,3154,18001
1,3,5,2,2016,19,14325,2941,17266
1,3,5,2,2016,20,15939,2938,18877
1,3,5,2,2016,21,15907,2803,18710
1,3,5,2,2016,22,15157,2692,17849
1,3,5,2,2016,23,15512,2672,18184
1,3,5,2,2016,24,15876,2685,18561
1,4,5,2,2016,1,15060,2527,17587
1,4,5,2,2016,2,15439,2338,17777
1,4,5,2,2016,3,14841,2193,17034
1,4,5,2,2016,4,14922,2088,17010
1,4,5,2,2016,5,14867,2037,16904
1,4,5,2,2016,6,15537,2059,17596
1,4,5,2,2016,7,15883,2026,17909
1,4,5,2,2016,8,16152,2143,18295
1,4,5,2,2016,9,15978,2515,18493
1,4,5,2,2016,10,16821,2827,19648
1,4,5,2,2016,11,17166,3108,20274
1,4,5,2,2016,12,16608,3213,19821
1,4,5,2,2016,13,16605,3232,19837
1,4,5,2,2016,14,16407,3182,19589
1,4,5,2,2016,15,16492,3231,19723
1,4,5,2,2016,16,15739,3235,18974
1,4,5,2,2016,17,15644,3219,18863
1,4,5,2,2016,18,14371,3103,17474
1,4,5,2,2016,19,14436,2933,17369
1,4,5,2,2016,20,15298,2919,18217
1,4,5,2,2016,21,15380,2881,18261
1,4,5,2,2016,22,14748,2706,17454
1,4,5,2,2016,23,15211,2657,17868
1,4,5,2,2016,24,15510,2705,18215
1,5,5,2,2016,1,15812,2571,18383
1,5,5,2,2016,2,15461,2383,17844
1,5,5,2,2016,3,15083,2183,17266
1,5,5,2,2016,4,14838,2082,16920
1,5,5,2,2016,5,15067,2028,17095
1,5,5,2,2016,6,15336,2057,17393
1,5,5,2,2016,7,15544,2045,17589
1,5,5,2,2016,8,15445,2171,17616
1,5,5,2,2016,9,15631,2523,18154
1,5,5,2,2016,10,16385,2835,19220
1,5,5,2,2016,11,16490,3078,19568
1,5,5,2,2016,12,16132,3171,19303
1,5,5,2,2016,13,16359,3174,19533
1,5,5,2,2016,14,15913,3117,19030
1,5,5,2,2016,15,16313,3172,19485
1,5,5,2,2016,16,15859,3177,19036
1,5,5,2,2016,17,15670,3173,18843
1,5,5,2,2016,18,14556,3048,17604
1,5,5,2,2016,19,13818,2889,16707
1,5,5,2,2016,20,14923,2875,17798
1,5,5,2,2016,21,14794,2825,17619
1,5,5,2,2016,22,13750,2731,16481
1,5,5,2,2016,23,14336,2664,17000
1,5,5,2,2016,24,14873,2667,17540
1,6,5,2,2016,1,14809,2552,17361
1,6,5,2,2016,2,14889,2364,17253
1,6,5,2,2016,3,13863,2210,16073
1,6,5,2,2016,4,13356,2101,15457
1,6,5,2,2016,5,14461,2031,16492
1,6,5,2,2016,6,14581,2043,16624
1,6,5,2,2016,7,14940,2031,16971
1,6,5,2,2016,8,14975,2149,17124
1,6,5,2,2016,9,14576,2462,17038
1,6,5,2,2016,10,15158,2891,18049
1,6,5,2,2016,11,15327,3134,18461
1,6,5,2,2016,12,15275,3166,18441
1,6,5,2,2016,13,15006,3152,18158
1,6,5,2,2016,14,14592,3079,17671
1,6,5,2,2016,15,14980,3155,18135
1,6,5,2,2016,16,15015,3161,18176
1,6,5,2,2016,17,14788,3163,17951
1,6,5,2,2016,18,13125,3028,16153
1,6,5,2,2016,19,13745,2849,16594
1,6,5,2,2016,20,14940,2856,17796
1,6,5,2,2016,21,14501,2673,17174
1,6,5,2,2016,22,14190,2608,16798
1,6,5,2,2016,23,14382,2573,16955
1,6,5,2,2016,24,14543,2599,17142
2,7,5,2,2016,1,14491,2536,17027
2,7,5,2,2016,2,14642,2303,16945
2,7,5,2,2016,3,14513,2148,16661
2,7,5,2,2016,4,14507,2050,16557
2,7,5,2,2016,5,14202,1982,16184
2,7,5,2,2016,6,14676,2010,16686
2,7,5,2,2016,7,15119,1991,17110
2,7,5,2,2016,8,14822,2057,16879
2,7,5,2,2016,9,15272,2327,17599
2,7,5,2,2016,10,15218,2576,17794
2,7,5,2,2016,11,15575,2852,18427
2,7,5,2,2016,12,15956,2930,18886
2,7,5,2,2016,13,15326,2931,18257
2,7,5,2,2016,14,15574,2870,18444
2,7,5,2,2016,15,15356,2913,18269
2,7,5,2,2016,16,15727,2935,18662
2,7,5,2,2016,17,15190,2931,18121
2,7,5,2,2016,18,13486,2826,16312
2,7,5,2,2016,19,14029,2708,16737
2,7,5,2,2016,20,15377,2771,18148
2,7,5,2,2016,21,15428,2694,18122
2,7,5,2,2016,22,15109,2587,17696
2,7,5,2,2016,23,15141,2528,17669
2,7,5,2,2016,24,15912,2552,18464
2,8,5,2,2016,1,15130,2463,17593
2,8,5,2,2016,2,14999,2342,17341
2,8,5,2,2016,3,14676,2220,16896
2,8,5,2,2016,4,14572,2111,16683
2,8,5,2,2016,5,14300,2051,16351
2,8,5,2,2016,6,14730,2046,16776
2,8,5,2,2016,7,14385,1984,16369
2,8,5,2,2016,8,14917,1969,16886
2,8,5,2,2016,9,15177,2009,17186
2,8,5,2,2016,10,15817,2098,17915
2,8,5,2,2016,11,15757,2187,17944
2,8,5,2,2016,12,15606,2269,17875
2,8,5,2,2016,13,15094,2287,17381
2,8,5,2,2016,14,15165,2269,17434
2,8,5,2,2016,15,15305,2286,17591
2,8,5,2,2016,16,15166,2303,17469
2,8,5,2,2016,17,14787,2285,17072
2,8,5,2,2016,18,13433,2223,15656
2,8,5,2,2016,19,13840,2205,16045
2,8,5,2,2016,20,14137,2314,16451
2,8,5,2,2016,21,14408,2374,16782
2,8,5,2,2016,22,14017,2415,16432
2,8,5,2,2016,23,14213,2488,16701
2,8,5,2,2016,24,14880,2529,17409
1,9,5,2,2016,1,14442,2466,16908
1,9,5,2,2016,2,14243,2274,16517
1,9,5,2,2016,3,14304,2128,16432
1,9,5,2,2016,4,13809,2033,15842
1,9,5,2,2016,5,14182,1972,16154
1,9,5,2,2016,6,14698,1995,16693
1,9,5,2,2016,7,15366,2020,17386
1,9,5,2,2016,8,14881,2141,17022
1,9,5,2,2016,9,15038,2501,17539
1,9,5,2,2016,10,15820,2828,18648
1,9,5,2,2016,11,15768,3092,18860
1,9,5,2,2016,12,16174,3184,19358
1,9,5,2,2016,13,16131,3186,19317
1,9,5,2,2016,14,15785,3152,18937
1,9,5,2,2016,15,15898,3183,19081
1,9,5,2,2016,16,16302,3185,19487
1,9,5,2,2016,17,15064,3185,18249
1,9,5,2,2016,18,13935,3093,17028
1,9,5,2,2016,19,14079,2935,17014
1,9,5,2,2016,20,14619,2926,17545
1,9,5,2,2016,21,14241,2792,17033
1,9,5,2,2016,22,13754,2681,16435
1,9,5,2,2016,23,14214,2695,16909
1,9,5,2,2016,24,13977,2733,16710
1,10,5,2,2016,1,13891,2614,16505
1,10,5,2,2016,2,13734,2404,16138
1,10,5,2,2016,3,13722,2251,15973
1,10,5,2,2016,4,13254,2141,15395
1,10,5,2,2016,5,13271,2091,15362
1,10,5,2,2016,6,13931,2127,16058
1,10,5,2,2016,7,14022,2120,16142
1,10,5,2,2016,8,14212,2217,16429
1,10,5,2,2016,9,14324,2458,16782
1,10,5,2,2016,10,15130,2888,18018
1,10,5,2,2016,11,15493,3118,18611
1,10,5,2,2016,12,15330,3186,18516
1,10,5,2,2016,13,15484,3207,18691
1,10,5,2,2016,14,15462,3122,18584
1,10,5,2,2016,15,15734,3188,18922
1,10,5,2,2016,16,15489,3210,18699
1,10,5,2,2016,17,14998,3201,18199
1,10,5,2,2016,18,14039,3092,17131
1,10,5,2,2016,19,13898,2907,16805
1,10,5,2,2016,20,15793,2914,18707
1,10,5,2,2016,21,15390,2837,18227
1,10,5,2,2016,22,15104,2729,17833
1,10,5,2,2016,23,15109,2710,17819
1,10,5,2,2016,24,15248,2727,17975
1,11,5,2,2016,1,15382,2559,17941
1,11,5,2,2016,2,14485,2396,16881
1,11,5,2,2016,3,14143,2243,16386
1,11,5,2,2016,4,13915,2134,16049
1,11,5,2,2016,5,13967,2083,16050
1,11,5,2,2016,6,14468,2094,16562
1,11,5,2,2016,7,15217,2105,17322
1,11,5,2,2016,8,14839,2186,17025
1,11,5,2,2016,9,15208,2550,17758
1,11,5,2,2016,10,15698,2835,18533
1,11,5,2,2016,11,16329,3212,19541
1,11,5,2,2016,12,16380,3269,19649
1,11,5,2,2016,13,16063,3289,19352
1,11,5,2,2016,14,15707,3201,18908
1,11,5,2,2016,15,15845,3250,19095
1,11,5,2,2016,16,15116,3267,18383
1,11,5,2,2016,17,14147,3240,17387
1,11,5,2,2016,18,13832,3145,16977
1,11,5,2,2016,19,12997,2929,15926
1,11,5,2,2016,20,14284,2927,17211
1,11,5,2,2016,21,14497,2837,17334
1,11,5,2,2016,22,14478,2788,17266
1,11,5,2,2016,23,15189,2687,17876
1,11,5,2,2016,24,15277,2740,18017
1,12,5,2,2016,1,15174,2625,17799
1,12,5,2,2016,2,14825,2448,17273
1,12,5,2,2016,3,14687,2280,16967
1,12,5,2,2016,4,14827,2167,16994
1,12,5,2,2016,5,14715,2109,16824
1,12,5,2,2016,6,14718,2125,16843
1,12,5,2,2016,7,14861,2109,16970
1,12,5,2,2016,8,14681,2238,16919
1,12,5,2,2016,9,15123,2533,17656
1,12,5,2,2016,10,15688,2839,18527
1,12,5,2,2016,11,15403,3205,18608
1,12,5,2,2016,12,15554,3244,18798
1,12,5,2,2016,13,15463,3286,18749
1,12,5,2,2016,14,15264,3208,18472
1,12,5,2,2016,15,15500,3283,18783
1,12,5,2,2016,16,15787,3300,19087
1,12,5,2,2016,17,14677,3274,17951
1,12,5,2,2016,18,13883,3124,17007
1,12,5,2,2016,19,13903,2974,16877
1,12,5,2,2016,20,15499,2942,18441
1,12,5,2,2016,21,15664,2876,18540
1,12,5,2,2016,22,15414,2808,18222
1,12,5,2,2016,23,15507,2809,18316
1,12,5,2,2016,24,15633,2830,18463
1,13,5,2,2016,1,15229,2674,17903
1,13,5,2,2016,2,15033,2464,17497
1,13,5,2,2016,3,14676,2309,16985
1,13,5,2,2016,4,14660,2195,16855
1,13,5,2,2016,5,14636,2126,16762
1,13,5,2,2016,6,14979,2151,17130
1,13,5,2,2016,7,15283,2136,17419
1,13,5,2,2016,8,14596,2288,16884
1,13,5,2,2016,9,14918,2545,17463
1,13,5,2,2016,10,15143,2899,18042
1,13,5,2,2016,11,15349,3207,18556
1,13,5,2,2016,12,15064,3294,18358
1,13,5,2,2016,13,14966,3312,18278
1,13,5,2,2016,14,14733,3215,17948
1,13,5,2,2016,15,15186,3280,18466
1,13,5,2,2016,16,15200,3327,18527
1,13,5,2,2016,17,14566,3283,17849
1,13,5,2,2016,18,13675,3147,16822
1,13,5,2,2016,19,13760,2984,16744
1,13,5,2,2016,20,15150,2977,18127
1,13,5,2,2016,21,15314,2915,18229
1,13,5,2,2016,22,15302,2838,18140
1,13,5,2,2016,23,15092,2830,17922
1,13,5,2,2016,24,15352,2833,18185
2,14,5,2,2016,1,15089,2724,17813
2,14,5,2,2016,2,15021,2500,17521
2,14,5,2,2016,3,14795,2337,17132
2,14,5,2,2016,4,14571,2237,16808
2,14,5,2,2016,5,14454,2166,16620
2,14,5,2,2016,6,14820,2171,16991
2,14,5,2,2016,7,14853,2119,16972
2,14,5,2,2016,8,14920,2142,17062
2,14,5,2,2016,9,14863,2360,17223
2,14,5,2,2016,10,15270,2602,17872
2,14,5,2,2016,11,15583,2887,18470
2,14,5,2,2016,12,15387,2977,18364
2,14,5,2,2016,13,15451,2941,18392
2,14,5,2,2016,14,15086,2944,18030
2,14,5,2,2016,15,15662,2894,18556
2,14,5,2,2016,16,15977,2971,18948
2,14,5,2,2016,17,16017,3008,19025
2,14,5,2,2016,18,15124,2965,18089
2,14,5,2,2016,19,14708,2864,17572
2,14,5,2,2016,20,15887,2744,18631
2,14,5,2,2016,21,15684,2825,18509
2,14,5,2,2016,22,15359,2745,18104
2,14,5,2,2016,23,15322,2724,18046
2,14,5,2,2016,24,15464,2785,18249
2,15,5,2,2016,1,15563,2629,18192
2,15,5,2,2016,2,15072,2458,17530
2,15,5,2,2016,3,14740,2326,17066
2,15,5,2,2016,4,14391,2205,16596
2,15,5,2,2016,5,14559,2141,16700
2,15,5,2,2016,6,14695,2128,16823
2,15,5,2,2016,7,14727,2041,16768
2,15,5,2,2016,8,14533,2010,16543
2,15,5,2,2016,9,14748,2086,16834
2,15,5,2,2016,10,15683,2182,17865
2,15,5,2,2016,11,16046,2310,18356
2,15,5,2,2016,12,15710,2411,18121
2,15,5,2,2016,13,15432,2448,17880
2,15,5,2,2016,14,15282,2459,17741
2,15,5,2,2016,15,15477,2489,17966
2,15,5,2,2016,16,15906,2521,18427
2,15,5,2,2016,17,15716,2456,18172
2,15,5,2,2016,18,14399,2376,16775
2,15,5,2,2016,19,14208,2289,16497
2,15,5,2,2016,20,15216,2468,17684
2,15,5,2,2016,21,15059,2568,17627
2,15,5,2,2016,22,14806,2610,17416
2,15,5,2,2016,23,14858,2663,17521
2,15,5,2,2016,24,15054,2725,17779
1,16,5,2,2016,1,15180,2687,17867
1,16,5,2,2016,2,14938,2467,17405
1,16,5,2,2016,3,14569,2305,16874
1,16,5,2,2016,4,14722,2195,16917
1,16,5,2,2016,5,14380,2144,16524
1,16,5,2,2016,6,15111,2148,17259
1,16,5,2,2016,7,15367,2133,17500
1,16,5,2,2016,8,15218,2207,17425
1,16,5,2,2016,9,15523,2583,18106
1,16,5,2,2016,10,16169,2912,19081
1,16,5,2,2016,11,16450,3274,19724
1,16,5,2,2016,12,16302,3322,19624
1,16,5,2,2016,13,16010,3369,19379
1,16,5,2,2016,14,16259,3314,19573
1,16,5,2,2016,15,16387,3379,19766
1,16,5,2,2016,16,16536,3382,19918
1,16,5,2,2016,17,16187,3374,19561
1,16,5,2,2016,18,15210,3184,18394
1,16,5,2,2016,19,14617,3048,17665
1,16,5,2,2016,20,16109,3007,19116
1,16,5,2,2016,21,16205,2952,19157
1,16,5,2,2016,22,15991,2883,18874
1,16,5,2,2016,23,15996,2870,18866
1,16,5,2,2016,24,16317,2896,19213
1,17,5,2,2016,1,15849,2820,18669
1,17,5,2,2016,2,15551,2530,18081
1,17,5,2,2016,3,15126,2363,17489
1,17,5,2,2016,4,14839,2238,17077
1,17,5,2,2016,5,15270,2178,17448
1,17,5,2,2016,6,15507,2186,17693
1,17,5,2,2016,7,16063,2173,18236
1,17,5,2,2016,8,15775,2237,18012
1,17,5,2,2016,9,15979,2621,18600
1,17,5,2,2016,10,16234,2965,19199
1,17,5,2,2016,11,16607,3344,19951
1,17,5,2,2016,12,16629,3393,20022
1,17,5,2,2016,13,16400,3394,19794
1,17,5,2,2016,14,16210,3349,19559
1,17,5,2,2016,15,16627,3389,20016
1,17,5,2,2016,16,16733,3401,20134
1,17,5,2,2016,17,16620,3387,20007
1,17,5,2,2016,18,15709,3210,18919
1,17,5,2,2016,19,15268,3061,18329
1,17,5,2,2016,20,16210,3058,19268
1,17,5,2,2016,21,16046,3065,19111
1,17,5,2,2016,22,15783,2907,18690
1,17,5,2,2016,23,16211,2873,19084
1,17,5,2,2016,24,16276,2896,19172
1,18,5,2,2016,1,16235,2787,19022
1,18,5,2,2016,2,16095,2554,18649
1,18,5,2,2016,3,15858,2415,18273
1,18,5,2,2016,4,15810,2306,18116
1,18,5,2,2016,5,16042,2249,18291
1,18,5,2,2016,6,16187,2254,18441
1,18,5,2,2016,7,15970,2212,18182
1,18,5,2,2016,8,15713,2280,17993
1,18,5,2,2016,9,15990,2652,18642
1,18,5,2,2016,10,16674,2941,19615
1,18,5,2,2016,11,16795,3324,20119
1,18,5,2,2016,12,16693,3397,20090
1,18,5,2,2016,13,16400,3427,19827
1,18,5,2,2016,14,16142,3344,19486
1,18,5,2,2016,15,16357,3432,19789
1,18,5,2,2016,16,16352,3433,19785
1,18,5,2,2016,17,15861,3375,19236
1,18,5,2,2016,18,14466,3244,17710
1,18,5,2,2016,19,14421,3048,17469
1,18,5,2,2016,20,15422,3050,18472
1,18,5,2,2016,21,15357,2987,18344
1,18,5,2,2016,22,15205,2911,18116
1,18,5,2,2016,23,15292,2894,18186
1,18,5,2,2016,24,15467,2850,18317
1,19,5,2,2016,1,15150,2728,17878
1,19,5,2,2016,2,15437,2509,17946
1,19,5,2,2016,3,14781,2339,17120
1,19,5,2,2016,4,14556,2233,16789
1,19,5,2,2016,5,14124,2172,16296
1,19,5,2,2016,6,14306,2173,16479
1,19,5,2,2016,7,14273,2139,16412
1,19,5,2,2016,8,15118,2216,17334
1,19,5,2,2016,9,15104,2579,17683
1,19,5,2,2016,10,16040,2881,18921
1,19,5,2,2016,11,16060,3243,19303
1,19,5,2,2016,12,15847,3268,19115
1,19,5,2,2016,13,15793,3311,19104
1,19,5,2,2016,14,15418,3274,18692
1,19,5,2,2016,15,15969,3327,19296
1,19,5,2,2016,16,15916,3332,19248
1,19,5,2,2016,17,15350,3312,18662
1,19,5,2,2016,18,14323,3129,17452
1,19,5,2,2016,19,13962,2990,16952
1,19,5,2,2016,20,15075,2945,18020
1,19,5,2,2016,21,15606,2831,18437
1,19,5,2,2016,22,15094,2801,17895
1,19,5,2,2016,23,15053,2828,17881
1,19,5,2,2016,24,15732,2791,18523
1,20,5,2,2016,1,15182,2819,18001
1,20,5,2,2016,2,14790,2596,17386
1,20,5,2,2016,3,14495,2419,16914
1,20,5,2,2016,4,14136,2307,16443
1,20,5,2,2016,5,14209,2257,16466
1,20,5,2,2016,6,14314,2257,16571
1,20,5,2,2016,7,14418,2223,16641
1,20,5,2,2016,8,14272,2321,16593
1,20,5,2,2016,9,14458,2590,17048
1,20,5,2,2016,10,14534,3007,17541
1,20,5,2,2016,11,14423,3279,17702
1,20,5,2,2016,12,14247,3388,17635
1,20,5,2,2016,13,13845,3409,17254
1,20,5,2,2016,14,14139,3319,17458
1,20,5,2,2016,15,14344,3405,17749
1,20,5,2,2016,16,14593,3444,18037
1,20,5,2,2016,17,13995,3400,17395
1,20,5,2,2016,18,13147,3297,16444
1,20,5,2,2016,19,13287,3064,16351
1,20,5,2,2016,20,14512,3015,17527
1,20,5,2,2016,21,14837,2978,17815
1,20,5,2,2016,22,14457,2892,17349
1,20,5,2,2016,23,15352,2863,18215
1,20,5,2,2016,24,15181,2904,18085
3,21,5,2,2016,1,14896,2821,17717
3,21,5,2,2016,2,14506,2606,17112
3,21,5,2,2016,3,14108,2442,16550
3,21,5,2,2016,4,13835,2328,16163
3,21,5,2,2016,5,13872,2267,16139
3,21,5,2,2016,6,13799,2259,16058
3,21,5,2,2016,7,13990,2191,16181
3,21,5,2,2016,8,13594,2223,15817
3,21,5,2,2016,9,13918,2365,16283
3,21,5,2,2016,10,13953,2579,16532
3,21,5,2,2016,11,14569,2944,17513
3,21,5,2,2016,12,14769,3022,17791
3,21,5,2,2016,13,14666,3051,17717
3,21,5,2,2016,14,14740,3002,17742
3,21,5,2,2016,15,14848,3080,17928
3,21,5,2,2016,16,15449,3087,18536
3,21,5,2,2016,17,14912,3038,17950
3,21,5,2,2016,18,14154,2923,17077
3,21,5,2,2016,19,13640,2829,16469
3,21,5,2,2016,20,14602,2844,17446
3,21,5,2,2016,21,14986,2890,17876
3,21,5,2,2016,22,14818,2726,17544
3,21,5,2,2016,23,14882,2748,17630
3,21,5,2,2016,24,15217,2839,18056
2,22,5,2,2016,1,14969,2749,17718
2,22,5,2,2016,2,14481,2560,17041
2,22,5,2,2016,3,14721,2419,17140
2,22,5,2,2016,4,14309,2307,16616
2,22,5,2,2016,5,14169,2236,16405
2,22,5,2,2016,6,14745,2223,16968
2,22,5,2,2016,7,14900,2116,17016
2,22,5,2,2016,8,14580,2037,16617
2,22,5,2,2016,9,14660,2097,16757
2,22,5,2,2016,10,14875,2189,17064
2,22,5,2,2016,11,15057,2329,17386
2,22,5,2,2016,12,15354,2412,17766
2,22,5,2,2016,13,15018,2463,17481
2,22,5,2,2016,14,14779,2456,17235
2,22,5,2,2016,15,15062,2515,17577
2,22,5,2,2016,16,14925,2543,17468
2,22,5,2,2016,17,14125,2488,16613
2,22,5,2,2016,18,14098,2398,16496
2,22,5,2,2016,19,13114,2358,15472
2,22,5,2,2016,20,14117,2482,16599
2,22,5,2,2016,21,14547,2624,17171
2,22,5,2,2016,22,13932,2696,16628
2,22,5,2,2016,23,14336,2707,17043
2,22,5,2,2016,24,14234,2795,17029
1,23,5,2,2016,1,14475,2769,17244
1,23,5,2,2016,2,14352,2578,16930
1,23,5,2,2016,3,14036,2423,16459
1,23,5,2,2016,4,14104,2314,16418
1,23,5,2,2016,5,14027,2249,16276
1,23,5,2,2016,6,14485,2259,16744
1,23,5,2,2016,7,14581,2187,16768
1,23,5,2,2016,8,14760,2336,17096
1,23,5,2,2016,9,14796,2603,17399
1,23,5,2,2016,10,15153,2906,18059
1,23,5,2,2016,11,15648,3308,18956
1,23,5,2,2016,12,15705,3357,19062
1,23,5,2,2016,13,15033,3423,18456
1,23,5,2,2016,14,15301,3364,18665
1,23,5,2,2016,15,15243,3437,18680
1,23,5,2,2016,16,15721,3446,19167
1,23,5,2,2016,17,15246,3402,18648
1,23,5,2,2016,18,14640,3221,17861
1,23,5,2,2016,19,14040,3060,17100
1,23,5,2,2016,20,15180,3046,18226
1,23,5,2,2016,21,15248,2978,18226
1,23,5,2,2016,22,14802,2828,17630
1,23,5,2,2016,23,15001,2906,17907
1,23,5,2,2016,24,15090,2959,18049
1,24,5,2,2016,1,15115,2845,17960
1,24,5,2,2016,2,15150,2613,17763
1,24,5,2,2016,3,14640,2440,17080
1,24,5,2,2016,4,14804,2348,17152
1,24,5,2,2016,5,14478,2271,16749
1,24,5,2,2016,6,14929,2262,17191
1,24,5,2,2016,7,15314,2222,17536
1,24,5,2,2016,8,15621,2305,17926
1,24,5,2,2016,9,15582,2638,18220
1,24,5,2,2016,10,15869,2994,18863
1,24,5,2,2016,11,15906,3308,19214
1,24,5,2,2016,12,15868,3402,19270
1,24,5,2,2016,13,15972,3461,19433
1,24,5,2,2016,14,15889,3389,19278
1,24,5,2,2016,15,16051,3476,19527
1,24,5,2,2016,16,16529,3487,20016
1,24,5,2,2016,17,15899,3476,19375
1,24,5,2,2016,18,14886,3283,18169
1,24,5,2,2016,19,14097,3104,17201
1,24,5,2,2016,20,15116,3069,18185
1,24,5,2,2016,21,15572,3012,18584
1,24,5,2,2016,22,15080,2948,18028
1,24,5,2,2016,23,15075,2968,18043
1,24,5,2,2016,24,15148,3016,18164
1,25,5,2,2016,1,15223,2904,18127
1,25,5,2,2016,2,15113,2679,17792
1,25,5,2,2016,3,14927,2502,17429
1,25,5,2,2016,4,14984,2382,17366
1,25,5,2,2016,5,14735,2328,17063
1,25,5,2,2016,6,15166,2333,17499
1,25,5,2,2016,7,15213,2262,17475
1,25,5,2,2016,8,15311,2310,17621
1,25,5,2,2016,9,15030,2701,17731
1,25,5,2,2016,10,15758,3047,18805
1,25,5,2,2016,11,15888,3408,19296
1,25,5,2,2016,12,16080,3459,19539
1,25,5,2,2016,13,15781,3490,19271
1,25,5,2,2016,14,15531,3418,18949
1,25,5,2,2016,15,15740,3479,19219
1,25,5,2,2016,16,16178,3503,19681
1,25,5,2,2016,17,15511,3485,18996
1,25,5,2,2016,18,14739,3299,18038
1,25,5,2,2016,19,14018,3117,17135
1,25,5,2,2016,20,15149,3105,18254
1,25,5,2,2016,21,15520,3018,18538
1,25,5,2,2016,22,14887,2883,17770
1,25,5,2,2016,23,14911,2891,17802
1,25,5,2,2016,24,15313,2947,18260
1,26,5,2,2016,1,15273,2898,18171
1,26,5,2,2016,2,15282,2687,17969
1,26,5,2,2016,3,14988,2531,17519
1,26,5,2,2016,4,14762,2424,17186
1,26,5,2,2016,5,14554,2360,16914
1,26,5,2,2016,6,14762,2343,17105
1,26,5,2,2016,7,14976,2271,17247
1,26,5,2,2016,8,15169,2330,17499
1,26,5,2,2016,9,15113,2715,17828
1,26,5,2,2016,10,15742,3032,18774
1,26,5,2,2016,11,15806,3353,19159
1,26,5,2,2016,12,16078,3428,19506
1,26,5,2,2016,13,15635,3475,19110
1,26,5,2,2016,14,15290,3394,18684
1,26,5,2,2016,15,15378,3462,18840
1,26,5,2,2016,16,16146,3490,19636
1,26,5,2,2016,17,15892,3457,19350
1,26,5,2,2016,18,14472,3319,17791
1,26,5,2,2016,19,13906,3049,16955
1,26,5,2,2016,20,14737,3062,17799
1,26,5,2,2016,21,15135,2942,18077
1,26,5,2,2016,22,14690,2874,17564
1,26,5,2,2016,23,14743,2897,17640
1,26,5,2,2016,24,14989,2964,17953
1,27,5,2,2016,1,14958,2879,17837
1,27,5,2,2016,2,14868,2671,17539
1,27,5,2,2016,3,14628,2504,17132
1,27,5,2,2016,4,14653,2383,17036
1,27,5,2,2016,5,14309,2318,16627
1,27,5,2,2016,6,14809,2317,17126
1,27,5,2,2016,7,15101,2255,17356
1,27,5,2,2016,8,14718,2349,17067
1,27,5,2,2016,9,14754,2779,17533
1,27,5,2,2016,10,15098,3040,18138
1,27,5,2,2016,11,15084,3330,18414
1,27,5,2,2016,12,14662,3453,18115
1,27,5,2,2016,13,14910,3478,18388
1,27,5,2,2016,14,14904,3351,18255
1,27,5,2,2016,15,14893,3481,18374
1,27,5,2,2016,16,15220,3537,18757
1,27,5,2,2016,17,15212,3481,18693
1,27,5,2,2016,18,13971,3355,17326
1,27,5,2,2016,19,13698,3125,16823
1,27,5,2,2016,20,14857,3072,17929
1,27,5,2,2016,21,14947,3030,17977
1,27,5,2,2016,22,14595,2933,17528
1,27,5,2,2016,23,15056,2945,18001
1,27,5,2,2016,24,14937,2994,17931
2,28,5,2,2016,1,15438,2918,18356
2,28,5,2,2016,2,14994,2700,17694
2,28,5,2,2016,3,14741,2541,17282
2,28,5,2,2016,4,14342,2403,16746
2,28,5,2,2016,5,14306,2322,16628
2,28,5,2,2016,6,14647,2323,16970
2,28,5,2,2016,7,15042,2238,17280
2,28,5,2,2016,8,15319,2264,17583
2,28,5,2,2016,9,15051,2386,17437
2,28,5,2,2016,10,15377,2751,18128
2,28,5,2,2016,11,15284,2992,18276
2,28,5,2,2016,12,15534,3093,18627
2,28,5,2,2016,13,15363,3136,18499
2,28,5,2,2016,14,15429,3071,18500
2,28,5,2,2016,15,15535,3139,18674
2,28,5,2,2016,16,15596,3140,18736
2,28,5,2,2016,17,15333,3097,18430
2,28,5,2,2016,18,14478,2995,17473
2,28,5,2,2016,19,14057,2861,16918
2,28,5,2,2016,20,15015,2890,17905
2,28,5,2,2016,21,15050,2885,17935
2,28,5,2,2016,22,14867,2844,17711
2,28,5,2,2016,23,14909,2805,17714
2,28,5,2,2016,24,15221,2807,18028
2,29,5,2,2016,1,15287,2796,18083
2,29,5,2,2016,2,15219,2659,17878
2,29,5,2,2016,3,14997,2510,17507
2,29,5,2,2016,4,14979,2399,17378
2,29,5,2,2016,5,14948,2317,17265
2,29,5,2,2016,6,15025,2290,17315
2,29,5,2,2016,7,15157,2183,17340
2,29,5,2,2016,8,15132,2146,17278
2,29,5,2,2016,9,15288,2178,17466
2,29,5,2,2016,10,14936,2267,17203
2,29,5,2,2016,11,15301,2365,17666
2,29,5,2,2016,12,15689,2456,18145
2,29,5,2,2016,13,15479,2486,17965
2,29,5,2,2016,14,15483,2511,17994
2,29,5,2,2016,15,15526,2577,18103
2,29,5,2,2016,16,15714,2605,18319
2,29,5,2,2016,17,15064,2531,17595
2,29,5,2,2016,18,14101,2418,16519
2,29,5,2,2016,19,13363,2344,15707
2,29,5,2,2016,20,14359,2546,16905
2,29,5,2,2016,21,15093,2650,17743
2,29,5,2,2016,22,14586,2674,17260
2,29,5,2,2016,23,14618,2699,17317
2,29,5,2,2016,24,15053,2875,17928
1,30,5,2,2016,1,14848,2874,17722
1,30,5,2,2016,2,14800,2649,17449
1,30,5,2,2016,3,14705,2488,17193
1,30,5,2,2016,4,14575,2362,16937
1,30,5,2,2016,5,14378,2281,16659
1,30,5,2,2016,6,14855,2289,17144
1,30,5,2,2016,7,15105,2243,17348
1,30,5,2,2016,8,15251,2337,17588
1,30,5,2,2016,9,15366,2721,18087
1,30,5,2,2016,10,16099,3038,19137
1,30,5,2,2016,11,16592,3300,19892
1,30,5,2,2016,12,16174,3411,19585
1,30,5,2,2016,13,16296,3477,19773
1,30,5,2,2016,14,16196,3367,19563
1,30,5,2,2016,15,16172,3485,19657
1,30,5,2,2016,16,16950,3501,20451
1,30,5,2,2016,17,15789,3495,19284
1,30,5,2,2016,18,14734,3364,18098
1,30,5,2,2016,19,14317,3044,17361
1,30,5,2,2016,20,15528,3013,18541
1,30,5,2,2016,21,15523,2955,18478
1,30,5,2,2016,22,14968,2906,17874
1,30,5,2,2016,23,14998,2919,17917
1,30,5,2,2016,24,15441,3017,18458
1,31,5,2,2016,1,15169,2912,18081
1,31,5,2,2016,2,14805,2690,17495
1,31,5,2,2016,3,14770,2524,17294
1,31,5,2,2016,4,14956,2393,17349
1,31,5,2,2016,5,15029,2324,17353
1,31,5,2,2016,6,15055,2321,17376
1,31,5,2,2016,7,15143,2251,17394
1,31,5,2,2016,8,15454,2303,17757
1,31,5,2,2016,9,15436,2668,18104
1,31,5,2,2016,10,16249,3026,19275
1,31,5,2,2016,11,16459,3390,19849
1,31,5,2,2016,12,16472,3441,19913
1,31,5,2,2016,13,16395,3482,19877
1,31,5,2,2016,14,16162,3404,19566
1,31,5,2,2016,15,16443,3507,19950
1,31,5,2,2016,16,16723,3552,20275
1,31,5,2,2016,17,16227,3488,19715
1,31,5,2,2016,18,15091,3371,18462
1,31,5,2,2016,19,14389,3172,17561
1,31,5,2,2016,20,15491,3073,18564
1,31,5,2,2016,21,15538,3020,18558
1,31,5,2,2016,22,15183,2969,18152
1,31,5,2,2016,23,15006,2990,17996
1,31,5,2,2016,24,15122,3056,18178
1,1,6,2,2016,1,15373,2928,18301
1,1,6,2,2016,2,14742,2701,17443
1,1,6,2,2016,3,14537,2537,17074
1,1,6,2,2016,4,14602,2412,17014
1,1,6,2,2016,5,14603,2337,16940
1,1,6,2,2016,6,14788,2310,17098
1,1,6,2,2016,7,15023,2264,17287
1,1,6,2,2016,8,14823,2347,17170
1,1,6,2,2016,9,15189,2670,17859
1,1,6,2,2016,10,15873,3043,18916
1,1,6,2,2016,11,16228,3395,19623
1,1,6,2,2016,12,16229,3472,19701
1,1,6,2,2016,13,15772,3528,19300
1,1,6,2,2016,14,15963,3456,19419
1,1,6,2,2016,15,16301,3535,19836
1,1,6,2,2016,16,16779,3539,20318
1,1,6,2,2016,17,16337,3498,19835
1,1,6,2,2016,18,15278,3351,18629
1,1,6,2,2016,19,14742,3125,17867
1,1,6,2,2016,20,15134,3034,18168
1,1,6,2,2016,21,15747,2962,18709
1,1,6,2,2016,22,15362,2852,18214
1,1,6,2,2016,23,15106,2944,18050
1,1,6,2,2016,24,15306,3015,18321
1,2,6,2,2016,1,14820,2912,17732
1,2,6,2,2016,2,14633,2692,17325
1,2,6,2,2016,3,14772,2526,17298
1,2,6,2,2016,4,14526,2410,16936
1,2,6,2,2016,5,14574,2345,16919
1,2,6,2,2016,6,14882,2336,17218
1,2,6,2,2016,7,14865,2273,17138
1,2,6,2,2016,8,15113,2396,17509
1,2,6,2,2016,9,15405,2667,18072
1,2,6,2,2016,10,16275,2988,19263
1,2,6,2,2016,11,16312,3357,19669
1,2,6,2,2016,12,16291,3425,19716
1,2,6,2,2016,13,16123,3444,19567
1,2,6,2,2016,14,15694,3372,19066
1,2,6,2,2016,15,16430,3473,19903
1,2,6,2,2016,16,16210,3506,19716
1,2,6,2,2016,17,15633,3459,19092
1,2,6,2,2016,18,14815,3323,18138
1,2,6,2,2016,19,14138,3070,17208
1,2,6,2,2016,20,15103,3039,18142
1,2,6,2,2016,21,14783,2951,17734
1,2,6,2,2016,22,14498,2901,17399
1,2,6,2,2016,23,14562,2941,17503
1,2,6,2,2016,24,14639,3011,17650
1,3,6,2,2016,1,14962,2928,17890
1,3,6,2,2016,2,14800,2655,17455
1,3,6,2,2016,3,14290,2505,16795
1,3,6,2,2016,4,14361,2364,16725
1,3,6,2,2016,5,14073,2296,16369
1,3,6,2,2016,6,13971,2302,16273
1,3,6,2,2016,7,14017,2253,16270
1,3,6,2,2016,8,13928,2338,16266
1,3,6,2,2016,9,14255,2645,16900
1,3,6,2,2016,10,14622,3022,17644
1,3,6,2,2016,11,14782,3314,18096
1,3,6,2,2016,12,14786,3448,18234
1,3,6,2,2016,13,14535,3464,17999
1,3,6,2,2016,14,14879,3352,18231
1,3,6,2,2016,15,14960,3492,18452
1,3,6,2,2016,16,15381,3519,18900
1,3,6,2,2016,17,15057,3502,18559
1,3,6,2,2016,18,14190,3319,17509
1,3,6,2,2016,19,13468,3118,16586
1,3,6,2,2016,20,14280,3044,17324
1,3,6,2,2016,21,14371,2986,17357
1,3,6,2,2016,22,14364,2932,17296
1,3,6,2,2016,23,14240,2939,17179
1,3,6,2,2016,24,14419,2992,17411
2,4,6,2,2016,1,14272,2924,17196
2,4,6,2,2016,2,14158,2716,16874
2,4,6,2,2016,3,13649,2544,16193
2,4,6,2,2016,4,13688,2424,16112
2,4,6,2,2016,5,13592,2341,15933
2,4,6,2,2016,6,13877,2342,16219
2,4,6,2,2016,7,13810,2267,16077
2,4,6,2,2016,8,13701,2289,15990
2,4,6,2,2016,9,14124,2472,16596
2,4,6,2,2016,10,14794,2821,17615
2,4,6,2,2016,11,14870,3129,17999
2,4,6,2,2016,12,14836,3202,18038
2,4,6,2,2016,13,14964,3214,18178
2,4,6,2,2016,14,14946,3129,18075
2,4,6,2,2016,15,15424,3255,18679
2,4,6,2,2016,16,15727,3269,18996
2,4,6,2,2016,17,15547,3193,18740
2,4,6,2,2016,18,14516,3023,17539
2,4,6,2,2016,19,14171,2881,17052
2,4,6,2,2016,20,14595,2896,17491
2,4,6,2,2016,21,14031,2985,17016
2,4,6,2,2016,22,13477,2864,16341
2,4,6,2,2016,23,13319,2801,16120
2,4,6,2,2016,24,13202,2936,16138
2,5,6,2,2016,1,13084,2866,15950
2,5,6,2,2016,2,12354,2718,15072
2,5,6,2,2016,3,11864,2543,14407
2,5,6,2,2016,4,11577,2401,13978
2,5,6,2,2016,5,11571,2319,13890
2,5,6,2,2016,6,11860,2291,14151
2,5,6,2,2016,7,11685,2178,13863
2,5,6,2,2016,8,11972,2110,14082
2,5,6,2,2016,9,12575,2113,14688
2,5,6,2,2016,10,12889,2173,15062
2,5,6,2,2016,11,13347,2264,15611
2,5,6,2,2016,12,13625,2329,15954
2,5,6,2,2016,13,13832,2334,16166
2,5,6,2,2016,14,13885,2366,16251
2,5,6,2,2016,15,14101,2423,16524
2,5,6,2,2016,16,14423,2528,16951
2,5,6,2,2016,17,14239,2425,16664
2,5,6,2,2016,18,13459,2331,15790
2,5,6,2,2016,19,12902,2363,15265
2,5,6,2,2016,20,13560,2510,16070
2,5,6,2,2016,21,13600,2578,16178
2,5,6,2,2016,22,13328,2604,15932
2,5,6,2,2016,23,12986,2672,15658
2,5,6,2,2016,24,12715,2855,15570
1,6,6,2,2016,1,13181,2796,15977
1,6,6,2,2016,2,12634,2610,15244
1,6,6,2,2016,3,12722,2438,15160
1,6,6,2,2016,4,12652,2318,14970
1,6,6,2,2016,5,12529,2256,14785
1,6,6,2,2016,6,13006,2246,15252
1,6,6,2,2016,7,13035,2207,15242
1,6,6,2,2016,8,13428,2272,15700
1,6,6,2,2016,9,13902,2663,16565
1,6,6,2,2016,10,14378,3011,17389
1,6,6,2,2016,11,14537,3313,17850
1,6,6,2,2016,12,14597,3390,17987
1,6,6,2,2016,13,14461,3392,17853
1,6,6,2,2016,14,14107,3345,17452
1,6,6,2,2016,15,14569,3390,17959
1,6,6,2,2016,16,14660,3362,18022
1,6,6,2,2016,17,14638,3302,17940
1,6,6,2,2016,18,14113,3216,17329
1,6,6,2,2016,19,13847,3029,16876
1,6,6,2,2016,20,14754,2989,17743
1,6,6,2,2016,21,14874,2902,17776
1,6,6,2,2016,22,14424,2855,17279
1,6,6,2,2016,23,14497,2936,17433
1,6,6,2,2016,24,14400,2989,17389
1,7,6,2,2016,1,14138,2886,17024
1,7,6,2,2016,2,13914,2664,16578
1,7,6,2,2016,3,13477,2486,15963
1,7,6,2,2016,4,13388,2384,15772
1,7,6,2,2016,5,13263,2329,15592
1,7,6,2,2016,6,13574,2344,15918
1,7,6,2,2016,7,13765,2263,16028
1,7,6,2,2016,8,14148,2360,16508
1,7,6,2,2016,9,14290,2688,16978
1,7,6,2,2016,10,14804,3095,17899
1,7,6,2,2016,11,15202,3346,18548
1,7,6,2,2016,12,14926,3459,18385
1,7,6,2,2016,13,14850,3471,18321
1,7,6,2,2016,14,15231,3385,18616
1,7,6,2,2016,15,15245,3523,18768
1,7,6,2,2016,16,15611,3526,19137
1,7,6,2,2016,17,15330,3505,18835
1,7,6,2,2016,18,14660,3313,17973
1,7,6,2,2016,19,14285,3111,17396
1,7,6,2,2016,20,14802,3030,17832
1,7,6,2,2016,21,15096,3032,18128
1,7,6,2,2016,22,14718,2965,17683
1,7,6,2,2016,23,14906,3013,17919
1,7,6,2,2016,24,14573,3069,17642
1,8,6,2,2016,1,14532,2949,17480
1,8,6,2,2016,2,14233,2664,16897
1,8,6,2,2016,3,14195,2538,16733
1,8,6,2,2016,4,13925,2407,16332
1,8,6,2,2016,5,14106,2337,16443
1,8,6,2,2016,6,14168,2341,16509
1,8,6,2,2016,7,14383,2284,16667
1,8,6,2,2016,8,14386,2346,16732
1,8,6,2,2016,9,14486,2673,17160
1,8,6,2,2016,10,15012,3006,18018
1,8,6,2,2016,11,15290,3374,18664
1,8,6,2,2016,12,15577,3451,19028
1,8,6,2,2016,13,15246,3464,18710
1,8,6,2,2016,14,15272,3401,18673
1,8,6,2,2016,15,15743,3518,19261
1,8,6,2,2016,16,15674,3546,19220
1,8,6,2,2016,17,15695,3509,19204
1,8,6,2,2016,18,14905,3388,18293
1,8,6,2,2016,19,13868,3116,16984
1,8,6,2,2016,20,14519,3057,17576
1,8,6,2,2016,21,15213,3034,18247
1,8,6,2,2016,22,14913,2924,17837
1,8,6,2,2016,23,14416,3048,17464
1,8,6,2,2016,24,14533,3135,17668
1,9,6,2,2016,1,14696,2982,17678
1,9,6,2,2016,2,14043,2760,16803
1,9,6,2,2016,3,13894,2585,16479
1,9,6,2,2016,4,13669,2453,16122
1,9,6,2,2016,5,13559,2391,15950
1,9,6,2,2016,6,13830,2390,16220
1,9,6,2,2016,7,14103,2312,16415
1,9,6,2,2016,8,14534,2356,16890
1,9,6,2,2016,9,14519,2746,17265
1,9,6,2,2016,10,14990,3080,18070
1,9,6,2,2016,11,14961,3426,18387
1,9,6,2,2016,12,14842,3477,18319
1,9,6,2,2016,13,14520,3469,17989
1,9,6,2,2016,14,14612,3406,18018
1,9,6,2,2016,15,14947,3557,18504
1,9,6,2,2016,16,15416,3581,18997
1,9,6,2,2016,17,15321,3526,18847
1,9,6,2,2016,18,14629,3358,17987
1,9,6,2,2016,19,14009,3142,17151
1,9,6,2,2016,20,14830,3065,17895
1,9,6,2,2016,21,14989,2976,17965
1,9,6,2,2016,22,14922,2933,17855
1,9,6,2,2016,23,14363,3002,17365
1,9,6,2,2016,24,14313,3044,17357
1,10,6,2,2016,1,14356,2976,17332
1,10,6,2,2016,2,13559,2707,16266
1,10,6,2,2016,3,13301,2587,15888
1,10,6,2,2016,4,13247,2454,15701
1,10,6,2,2016,5,13349,2398,15747
1,10,6,2,2016,6,13635,2409,16044
1,10,6,2,2016,7,13682,2366,16048
1,10,6,2,2016,8,13887,2433,16320
1,10,6,2,2016,9,13405,2804,16209
1,10,6,2,2016,10,14262,3095,17357
1,10,6,2,2016,11,14391,3345,17736
1,10,6,2,2016,12,14351,3490,17841
1,10,6,2,2016,13,13910,3504,17414
1,10,6,2,2016,14,13762,3423,17185
1,10,6,2,2016,15,14120,3536,17656
1,10,6,2,2016,16,14354,3550,17904
1,10,6,2,2016,17,14223,3509,17732
1,10,6,2,2016,18,13919,3318,17237
1,10,6,2,2016,19,13635,3134,16769
1,10,6,2,2016,20,13979,3076,17055
1,10,6,2,2016,21,14447,3036,17483
1,10,6,2,2016,22,14254,2978,17232
1,10,6,2,2016,23,14073,3038,17111
1,10,6,2,2016,24,13942,3085,17027
2,11,6,2,2016,1,14263,2986,17249
2,11,6,2,2016,2,13848,2740,16588
2,11,6,2,2016,3,13799,2582,16381
2,11,6,2,2016,4,13293,2474,15767
2,11,6,2,2016,5,13100,2414,15514
2,11,6,2,2016,6,13783,2419,16202
2,11,6,2,2016,7,13721,2317,16038
2,11,6,2,2016,8,14174,2303,16477
2,11,6,2,2016,9,13975,2393,16368
2,11,6,2,2016,10,14186,2557,16743
2,11,6,2,2016,11,14283,2821,17104
2,11,6,2,2016,12,14175,2901,17076
2,11,6,2,2016,13,14266,2918,17184
2,11,6,2,2016,14,14398,2852,17250
2,11,6,2,2016,15,14528,2912,17440
2,11,6,2,2016,16,14692,2957,17649
2,11,6,2,2016,17,13982,2875,16857
2,11,6,2,2016,18,13390,2791,16181
2,11,6,2,2016,19,13127,2728,15855
2,11,6,2,2016,20,14274,2741,17015
2,11,6,2,2016,21,14735,2782,17517
2,11,6,2,2016,22,14253,2720,16973
2,11,6,2,2016,23,14266,2726,16992
2,11,6,2,2016,24,13938,2785,16723
2,12,6,2,2016,1,14309,2697,17006
2,12,6,2,2016,2,13690,2509,16199
2,12,6,2,2016,3,13705,2373,16078
2,12,6,2,2016,4,13788,2279,16067
2,12,6,2,2016,5,13375,2244,15619
2,12,6,2,2016,6,13598,2250,15848
2,12,6,2,2016,7,14032,2143,16175
2,12,6,2,2016,8,13854,2104,15958
2,12,6,2,2016,9,13752,2153,15905
2,12,6,2,2016,10,13816,2226,16042
2,12,6,2,2016,11,14036,2335,16371
2,12,6,2,2016,12,13842,2394,16236
2,12,6,2,2016,13,13772,2465,16237
2,12,6,2,2016,14,13625,2449,16074
2,12,6,2,2016,15,13805,2483,16288
2,12,6,2,2016,16,13855,2616,16471
2,12,6,2,2016,17,13517,2448,15965
2,12,6,2,2016,18,12874,2405,15279
2,12,6,2,2016,19,12460,2376,14836
2,12,6,2,2016,20,13737,2529,16266
2,12,6,2,2016,21,13901,2612,16513
2,12,6,2,2016,22,13740,2682,16422
2,12,6,2,2016,23,14019,2793,16812
2,12,6,2,2016,24,14022,2876,16898
1,13,6,2,2016,1,14074,2792,16866
1,13,6,2,2016,2,13917,2601,16518
1,13,6,2,2016,3,13561,2441,16002
1,13,6,2,2016,4,13816,2333,16149
1,13,6,2,2016,5,13510,2280,15790
1,13,6,2,2016,6,14066,2311,16377
1,13,6,2,2016,7,14285,2276,16561
1,13,6,2,2016,8,14514,2373,16887
1,13,6,2,2016,9,14417,2689,17106
1,13,6,2,2016,10,14868,3071,17939
1,13,6,2,2016,11,15029,3311,18340
1,13,6,2,2016,12,14506,3428,17934
1,13,6,2,2016,13,14714,3441,18155
1,13,6,2,2016,14,14531,3382,17913
1,13,6,2,2016,15,14888,3473,18361
1,13,6,2,2016,16,15310,3516,18826
1,13,6,2,2016,17,15061,3452,18513
1,13,6,2,2016,18,14427,3311,17738
1,13,6,2,2016,19,13316,3108,16424
1,13,6,2,2016,20,14416,3047,17463
1,13,6,2,2016,21,14990,2993,17983
1,13,6,2,2016,22,14681,2947,17628
1,13,6,2,2016,23,14699,3031,17730
1,13,6,2,2016,24,14572,3020,17592
1,14,6,2,2016,1,14542,2936,17478
1,14,6,2,2016,2,14662,2671,17333
1,14,6,2,2016,3,13751,2505,16256
1,14,6,2,2016,4,13881,2381,16262
1,14,6,2,2016,5,13876,2337,16213
1,14,6,2,2016,6,14122,2356,16478
1,14,6,2,2016,7,14798,2307,17105
1,14,6,2,2016,8,15078,2399,17477
1,14,6,2,2016,9,15156,2796,17952
1,14,6,2,2016,10,14976,3073,18049
1,14,6,2,2016,11,15192,3294,18486
1,14,6,2,2016,12,15190,3446,18636
1,14,6,2,2016,13,14835,3447,18282
1,14,6,2,2016,14,14733,3405,18138
1,14,6,2,2016,15,15061,3448,18509
1,14,6,2,2016,16,15157,3438,18595
1,14,6,2,2016,17,14831,3429,18260
1,14,6,2,2016,18,14195,3324,17519
1,14,6,2,2016,19,13714,3081,16795
1,14,6,2,2016,20,14735,3077,17812
1,14,6,2,2016,21,15187,3052,18239
1,14,6,2,2016,22,15455,2979,18434
1,14,6,2,2016,23,15155,2985,18140
1,14,6,2,2016,24,14953,2998,17951
1,15,6,2,2016,1,14841,2881,17722
1,15,6,2,2016,2,14393,2668,17061
1,15,6,2,2016,3,14168,2491,16659
1,15,6,2,2016,4,13881,2375,16256
1,15,6,2,2016,5,13993,2318,16311
1,15,6,2,2016,6,14496,2348,16844
1,15,6,2,2016,7,14779,2303,17082
1,15,6,2,2016,8,15014,2381,17395
1,15,6,2,2016,9,14661,2799,17460
1,15,6,2,2016,10,14820,3062,17882
1,15,6,2,2016,11,15083,3301,18384
1,15,6,2,2016,12,15021,3409,18430
1,15,6,2,2016,13,14690,3409,18099
1,15,6,2,2016,14,14633,3358,17991
1,15,6,2,2016,15,14723,3454,18177
1,15,6,2,2016,16,14969,3479,18448
1,15,6,2,2016,17,14961,3427,18388
1,15,6,2,2016,18,14188,3303,17491
1,15,6,2,2016,19,13983,3054,17037
1,15,6,2,2016,20,14720,3027,17747
1,15,6,2,2016,21,15124,3005,18129
1,15,6,2,2016,22,15148,2972,18120
1,15,6,2,2016,23,14877,3008,17885
1,15,6,2,2016,24,14763,3028,17791
1,16,6,2,2016,1,14829,2906,17735
1,16,6,2,2016,2,14485,2663,17148
1,16,6,2,2016,3,14413,2507,16920
1,16,6,2,2016,4,14411,2401,16812
1,16,6,2,2016,5,14156,2329,16485
1,16,6,2,2016,6,14766,2354,17120
1,16,6,2,2016,7,15124,2319,17443
1,16,6,2,2016,8,15397,2406,17803
1,16,6,2,2016,9,15153,2626,17779
1,16,6,2,2016,10,15186,3091,18277
1,16,6,2,2016,11,15163,3315,18478
1,16,6,2,2016,12,15186,3406,18592
1,16,6,2,2016,13,14776,3403,18179
1,16,6,2,2016,14,14840,3350,18190
1,16,6,2,2016,15,15199,3444,18643
1,16,6,2,2016,16,15346,3464,18810
1,16,6,2,2016,17,14964,3418,18382
1,16,6,2,2016,18,14088,3282,17370
1,16,6,2,2016,19,13459,3098,16557
1,16,6,2,2016,20,14606,3013,17619
1,16,6,2,2016,21,14813,2991,17804
1,16,6,2,2016,22,14864,2907,17771
1,16,6,2,2016,23,14829,2996,17825
1,16,6,2,2016,24,14889,3050,17939
1,17,6,2,2016,1,14957,2892,17849
1,17,6,2,2016,2,14706,2666,17372
1,17,6,2,2016,3,14458,2499,16957
1,17,6,2,2016,4,14641,2392,17033
1,17,6,2,2016,5,14733,2323,17056
1,17,6,2,2016,6,14919,2342,17261
1,17,6,2,2016,7,15275,2302,17577
1,17,6,2,2016,8,15355,2399,17754
1,17,6,2,2016,9,15261,2697,17958
1,17,6,2,2016,10,14834,3149,17983
1,17,6,2,2016,11,14662,3359,18022
1,17,6,2,2016,12,14521,3432,17953
1,17,6,2,2016,13,14743,3437,18180
1,17,6,2,2016,14,14535,3355,17890
1,17,6,2,2016,15,14674,3453,18127
1,17,6,2,2016,16,14591,3483,18074
1,17,6,2,2016,17,14380,3438,17818
1,17,6,2,2016,18,13469,3307,16776
1,17,6,2,2016,19,13375,3085,16460
1,17,6,2,2016,20,13456,3033,16489
1,17,6,2,2016,21,13877,3009,16886
1,17,6,2,2016,22,13376,2972,16348
1,17,6,2,2016,23,13510,2995,16505
1,17,6,2,2016,24,13447,3042,16489
2,18,6,2,2016,1,13871,2915,16786
2,18,6,2,2016,2,13562,2700,16262
2,18,6,2,2016,3,13214,2524,15738
2,18,6,2,2016,4,13475,2396,15871
2,18,6,2,2016,5,13268,2332,15600
2,18,6,2,2016,6,13595,2287,15882
2,18,6,2,2016,7,13900,2212,16112
2,18,6,2,2016,8,14068,2254,16322
2,18,6,2,2016,9,14224,2495,16719
2,18,6,2,2016,10,14383,2809,17192
2,18,6,2,2016,11,14691,3035,17726
2,18,6,2,2016,12,14591,3192,17783
2,18,6,2,2016,13,14199,3205,17404
2,18,6,2,2016,14,14030,3144,17174
2,18,6,2,2016,15,14752,3203,17955
2,18,6,2,2016,16,14775,3207,17982
2,18,6,2,2016,17,14244,3138,17382
2,18,6,2,2016,18,13472,3010,16482
2,18,6,2,2016,19,13678,2860,16538
2,18,6,2,2016,20,14119,2889,17008
2,18,6,2,2016,21,14369,2910,17279
2,18,6,2,2016,22,14075,2823,16898
2,18,6,2,2016,23,13918,2861,16779
2,18,6,2,2016,24,14025,2905,16930
2,19,6,2,2016,1,13741,2837,16578
2,19,6,2,2016,2,13484,2661,16145
2,19,6,2,2016,3,13204,2526,15730
2,19,6,2,2016,4,13282,2418,15700
2,19,6,2,2016,5,13531,2354,15885
2,19,6,2,2016,6,13547,2343,15890
2,19,6,2,2016,7,13828,2229,16057
2,19,6,2,2016,8,13966,2187,16153
2,19,6,2,2016,9,13915,2199,16114
2,19,6,2,2016,10,14227,2276,16503
2,19,6,2,2016,11,14233,2374,16607
2,19,6,2,2016,12,13614,2394,16008
2,19,6,2,2016,13,13845,2380,16225
2,19,6,2,2016,14,13565,2353,15918
2,19,6,2,2016,15,13305,2341,15646
2,19,6,2,2016,16,13333,2332,15665
2,19,6,2,2016,17,12705,2278,14983
2,19,6,2,2016,18,12573,2266,14839
2,19,6,2,2016,19,13127,2333,15460
2,19,6,2,2016,20,13485,2371,15856
2,19,6,2,2016,21,13129,2400,15529
2,19,6,2,2016,22,13109,2409,15518
2,19,6,2,2016,23,12952,2400,15352
2,19,6,2,2016,24,12852,2415,15267
1,20,6,2,2016,1,12950,2289,15239
1,20,6,2,2016,2,12421,2117,14538
1,20,6,2,2016,3,12234,1999,14233
1,20,6,2,2016,4,11810,1914,13724
1,20,6,2,2016,5,11604,1886,13490
1,20,6,2,2016,6,12038,1945,13983
1,20,6,2,2016,7,12238,1992,14230
1,20,6,2,2016,8,12532,2182,14714
1,20,6,2,2016,9,12712,2455,15167
1,20,6,2,2016,10,13316,2795,16111
1,20,6,2,2016,11,13802,3111,16913
1,20,6,2,2016,12,13944,3113,17057
1,20,6,2,2016,13,13529,3056,16585
1,20,6,2,2016,14,13466,2968,16434
1,20,6,2,2016,15,13751,2990,16741
1,20,6,2,2016,16,13970,3010,16980
1,20,6,2,2016,17,13798,2995,16793
1,20,6,2,2016,18,13075,2958,16033
1,20,6,2,2016,19,13638,2807,16445
1,20,6,2,2016,20,13941,2804,16745
1,20,6,2,2016,21,14338,2743,17081
1,20,6,2,2016,22,13910,2663,16573
1,20,6,2,2016,23,13880,2609,16489
1,20,6,2,2016,24,13341,2550,15891
1,21,6,2,2016,1,13073,2383,15456
1,21,6,2,2016,2,12869,2148,15017
1,21,6,2,2016,3,12937,2026,14963
1,21,6,2,2016,4,12965,1945,14910
1,21,6,2,2016,5,12878,1872,14750
1,21,6,2,2016,6,13293,1876,15169
1,21,6,2,2016,7,13508,1967,15475
1,21,6,2,2016,8,13704,2112,15816
1,21,6,2,2016,9,13909,2358,16267
1,21,6,2,2016,10,13900,2808,16708
1,21,6,2,2016,11,14570,3064,17634
1,21,6,2,2016,12,14209,3178,17387
1,21,6,2,2016,13,13973,3168,17141
1,21,6,2,2016,14,14167,3078,17245
1,21,6,2,2016,15,14022,3126,17148
1,21,6,2,2016,16,14174,3144,17318
1,21,6,2,2016,17,14351,3069,17420
1,21,6,2,2016,18,13393,3031,16424
1,21,6,2,2016,19,12927,2916,15843
1,21,6,2,2016,20,13943,2835,16778
1,21,6,2,2016,21,13842,2736,16578
1,21,6,2,2016,22,13418,2561,15979
1,21,6,2,2016,23,14143,2491,16634
1,21,6,2,2016,24,13650,2419,16069
1,22,6,2,2016,1,12972,2270,15242
1,22,6,2,2016,2,12777,2077,14854
1,22,6,2,2016,3,12377,1970,14347
1,22,6,2,2016,4,12528,1894,14422
1,22,6,2,2016,5,12628,1880,14508
1,22,6,2,2016,6,13019,1945,14964
1,22,6,2,2016,7,13754,2025,15779
1,22,6,2,2016,8,13824,2135,15959
1,22,6,2,2016,9,14218,2498,16716
1,22,6,2,2016,10,14227,2819,17046
1,22,6,2,2016,11,14443,3097,17540
1,22,6,2,2016,12,14348,3134,17482
1,22,6,2,2016,13,14124,3128,17252
1,22,6,2,2016,14,13944,3001,16945
1,22,6,2,2016,15,14349,3029,17378
1,22,6,2,2016,16,14542,3091,17633
1,22,6,2,2016,17,14406,3080,17486
1,22,6,2,2016,18,13755,2985,16740
1,22,6,2,2016,19,13379,2871,16250
1,22,6,2,2016,20,14252,2816,17068
1,22,6,2,2016,21,14576,2714,17290
1,22,6,2,2016,22,14251,2674,16925
1,22,6,2,2016,23,13767,2513,16280
1,22,6,2,2016,24,13295,2421,15716
1,23,6,2,2016,1,13077,2263,15340
1,23,6,2,2016,2,12808,2077,14885
1,23,6,2,2016,3,12812,1959,14771
1,23,6,2,2016,4,12826,1886,14712
1,23,6,2,2016,5,12721,1880,14601
1,23,6,2,2016,6,13162,1936,15098
1,23,6,2,2016,7,13519,2001,15520
1,23,6,2,2016,8,13718,2153,15871
1,23,6,2,2016,9,13663,2558,16221
1,23,6,2,2016,10,14420,2811,17231
1,23,6,2,2016,11,14246,3107,17353
1,23,6,2,2016,12,14318,3119,17437
1,23,6,2,2016,13,13768,3083,16851
1,23,6,2,2016,14,13622,2956,16578
1,23,6,2,2016,15,13664,2980,16644
1,23,6,2,2016,16,13917,2979,16896
1,23,6,2,2016,17,13897,2969,16866
1,23,6,2,2016,18,13175,2910,16085
1,23,6,2,2016,19,13277,2763,16040
1,23,6,2,2016,20,13773,2760,16533
1,23,6,2,2016,21,13917,2657,16574
1,23,6,2,2016,22,14249,2561,16810
1,23,6,2,2016,23,13850,2483,16333
1,23,6,2,2016,24,13463,2334,15797
1,24,6,2,2016,1,13407,2138,15545
1,24,6,2,2016,2,12911,1979,14890
1,24,6,2,2016,3,12743,1866,14609
1,24,6,2,2016,4,12491,1813,14304
1,24,6,2,2016,5,12458,1802,14260
1,24,6,2,2016,6,12737,1887,14624
1,24,6,2,2016,7,13629,1975,15604
1,24,6,2,2016,8,13625,2122,15747
1,24,6,2,2016,9,14256,2527,16783
1,24,6,2,2016,10,14471,2784,17255
1,24,6,2,2016,11,13763,3050,16813
1,24,6,2,2016,12,13177,3105,16282
1,24,6,2,2016,13,12817,3086,15903
1,24,6,2,2016,14,12708,2967,15675
1,24,6,2,2016,15,12852,2915,15767
1,24,6,2,2016,16,13093,2874,15967
1,24,6,2,2016,17,12727,2860,15587
1,24,6,2,2016,18,12507,2831,15338
1,24,6,2,2016,19,12607,2748,15355
1,24,6,2,2016,20,13073,2723,15796
1,24,6,2,2016,21,13457,2653,16110
1,24,6,2,2016,22,12545,2528,15073
1,24,6,2,2016,23,12482,2367,14849
1,24,6,2,2016,24,12172,2189,14361
2,25,6,2,2016,1,11770,2058,13828
2,25,6,2,2016,2,11803,1897,13700
2,25,6,2,2016,3,11571,1782,13353
2,25,6,2,2016,4,11637,1732,13369
2,25,6,2,2016,5,11799,1731,13530
2,25,6,2,2016,6,12244,1798,14042
2,25,6,2,2016,7,12716,1854,14570
2,25,6,2,2016,8,13030,1948,14978
2,25,6,2,2016,9,13087,2147,15234
2,25,6,2,2016,10,13116,2376,15492
2,25,6,2,2016,11,12607,2660,15267
2,25,6,2,2016,12,12546,2685,15231
2,25,6,2,2016,13,12744,2640,15384
2,25,6,2,2016,14,12347,2510,14857
2,25,6,2,2016,15,12579,2471,15050
2,25,6,2,2016,16,12646,2438,15084
2,25,6,2,2016,17,12536,2436,14972
2,25,6,2,2016,18,12073,2415,14488
2,25,6,2,2016,19,12010,2385,14395
2,25,6,2,2016,20,13029,2419,15448
2,25,6,2,2016,21,13768,2403,16171
2,25,6,2,2016,22,12880,2336,15216
2,25,6,2,2016,23,12543,2222,14765
2,25,6,2,2016,24,12990,2107,15097
2,26,6,2,2016,1,12132,1956,14088
2,26,6,2,2016,2,12012,1826,13838
2,26,6,2,2016,3,11747,1739,13486
2,26,6,2,2016,4,11968,1662,13630
2,26,6,2,2016,5,12023,1635,13658
2,26,6,2,2016,6,12368,1698,14066
2,26,6,2,2016,7,12722,1698,14420
2,26,6,2,2016,8,12978,1750,14728
2,26,6,2,2016,9,13232,1847,15079
2,26,6,2,2016,10,13242,1941,15183
2,26,6,2,2016,11,12952,2114,15066
2,26,6,2,2016,12,13059,2168,15227
2,26,6,2,2016,13,12949,2164,15113
2,26,6,2,2016,14,12843,2107,14950
2,26,6,2,2016,15,13007,2052,15059
2,26,6,2,2016,16,13271,2000,15271
2,26,6,2,2016,17,12877,1977,14854
2,26,6,2,2016,18,12188,2002,14190
2,26,6,2,2016,19,12054,2071,14125
2,26,6,2,2016,20,12801,2170,14971
2,26,6,2,2016,21,12945,2230,15175
2,26,6,2,2016,22,12718,2219,14937
2,26,6,2,2016,23,12841,2150,14991
2,26,6,2,2016,24,12588,2059,14648
1,27,6,2,2016,1,12375,1871,14246
1,27,6,2,2016,2,12148,1726,13874
1,27,6,2,2016,3,11742,1652,13394
1,27,6,2,2016,4,12100,1621,13721
1,27,6,2,2016,5,12337,1627,13964
1,27,6,2,2016,6,12800,1733,14533
1,27,6,2,2016,7,13353,1838,15191
1,27,6,2,2016,8,13577,2040,15617
1,27,6,2,2016,9,13514,2346,15860
1,27,6,2,2016,10,13646,2718,16364
1,27,6,2,2016,11,13783,2897,16680
1,27,6,2,2016,12,13639,2951,16590
1,27,6,2,2016,13,12945,2919,15864
1,27,6,2,2016,14,13063,2773,15836
1,27,6,2,2016,15,12915,2792,15707
1,27,6,2,2016,16,13002,2779,15780
1,27,6,2,2016,17,12549,2765,15314
1,27,6,2,2016,18,12361,2694,15055
1,27,6,2,2016,19,12363,2626,14989
1,27,6,2,2016,20,13382,2614,15996
1,27,6,2,2016,21,13412,2532,15944
1,27,6,2,2016,22,13428,2423,15851
1,27,6,2,2016,23,12935,2286,15221
1,27,6,2,2016,24,12708,2128,14836
1,28,6,2,2016,1,12699,1936,14635
1,28,6,2,2016,2,12473,1814,14287
1,28,6,2,2016,3,12340,1730,14070
1,28,6,2,2016,4,12526,1679,14205
1,28,6,2,2016,5,12412,1691,14103
1,28,6,2,2016,6,13051,1802,14853
1,28,6,2,2016,7,13351,1912,15263
1,28,6,2,2016,8,13628,2053,15681
1,28,6,2,2016,9,13655,2438,16093
1,28,6,2,2016,10,13735,2683,16418
1,28,6,2,2016,11,13755,2952,16707
1,28,6,2,2016,12,13214,2965,16179
1,28,6,2,2016,13,12879,2892,15771
1,28,6,2,2016,14,12683,2765,15448
1,28,6,2,2016,15,12563,2779,15342
1,28,6,2,2016,16,12802,2756,15558
1,28,6,2,2016,17,12950,2731,15681
1,28,6,2,2016,18,12880,2716,15596
1,28,6,2,2016,19,13123,2582,15705
1,28,6,2,2016,20,13114,2637,15751
1,28,6,2,2016,21,13534,2543,16077
1,28,6,2,2016,22,13042,2463,15505
1,28,6,2,2016,23,12623,2327,14950
1,28,6,2,2016,24,12123,2179,14302
1,29,6,2,2016,1,11794,1998,13792
1,29,6,2,2016,2,11466,1845,13311
1,29,6,2,2016,3,11371,1785,13156
1,29,6,2,2016,4,11084,1675,12759
1,29,6,2,2016,5,11359,1675,13034
1,29,6,2,2016,6,11900,1742,13642
1,29,6,2,2016,7,12657,1891,14548
1,29,6,2,2016,8,12937,2047,14984
1,29,6,2,2016,9,13106,2291,15397
1,29,6,2,2016,10,13036,2374,15410
1,29,6,2,2016,11,12671,2493,15164
1,29,6,2,2016,12,12581,2650,15231
1,29,6,2,2016,13,12239,2696,14935
1,29,6,2,2016,14,12056,2687,14743
1,29,6,2,2016,15,12358,2721,15079
1,29,6,2,2016,16,12507,2717,15224
1,29,6,2,2016,17,12641,2718,15359
1,29,6,2,2016,18,12264,2710,14974
1,29,6,2,2016,19,12514,2635,15149
1,29,6,2,2016,20,13160,2615,15775
1,29,6,2,2016,21,13103,2606,15709
1,29,6,2,2016,22,12711,2431,15142
1,29,6,2,2016,23,12378,2295,14673
1,29,6,2,2016,24,12004,2081,14085
1,30,6,2,2016,1,11869,1880,13749
1,30,6,2,2016,2,11523,1782,13305
1,30,6,2,2016,3,11220,1698,12918
1,30,6,2,2016,4,10906,1652,12558
1,30,6,2,2016,5,11203,1655,12858
1,30,6,2,2016,6,12101,1759,13860
1,30,6,2,2016,7,12626,1859,14485
1,30,6,2,2016,8,12559,2089,14648
1,30,6,2,2016,9,13097,2329,15426
1,30,6,2,2016,10,12869,2783,15652
1,30,6,2,2016,11,13046,2928,15974
1,30,6,2,2016,12,12359,2951,15310
1,30,6,2,2016,13,12292,2936,15228
1,30,6,2,2016,14,11753,2876,14629
1,30,6,2,2016,15,11839,2878,14717
1,30,6,2,2016,16,12336,2830,15166
1,30,6,2,2016,17,12135,2801,14936
1,30,6,2,2016,18,11877,2762,14639
1,30,6,2,2016,19,12064,2704,14768
1,30,6,2,2016,20,13255,2579,15834
1,30,6,2,2016,21,13450,2492,15942
1,30,6,2,2016,22,13122,2426,15548
1,30,6,2,2016,23,12591,2216,14807
1,30,6,2,2016,24,12224,2070,14294
1,1,7,3,2016,1,12112,1914,14026
1,1,7,3,2016,2,11673,1722,13395
1,1,7,3,2016,3,11545,1672,13217
1,1,7,3,2016,4,11147,1658,12805
1,1,7,3,2016,5,11499,1663,13162
1,1,7,3,2016,6,12000,1763,13763
1,1,7,3,2016,7,12603,1901,14504
1,1,7,3,2016,8,12860,2029,14889
1,1,7,3,2016,9,12657,2407,15064
1,1,7,3,2016,10,12699,2681,15380
1,1,7,3,2016,11,12168,2951,15119
1,1,7,3,2016,12,12257,2974,15231
1,1,7,3,2016,13,11596,2892,14488
1,1,7,3,2016,14,11308,2815,14123
1,1,7,3,2016,15,11523,2836,14359
1,1,7,3,2016,16,11541,2849,14390
1,1,7,3,2016,17,11327,2746,14073
1,1,7,3,2016,18,11204,2800,14004
1,1,7,3,2016,19,11645,2710,14355
1,1,7,3,2016,20,12411,2639,15050
1,1,7,3,2016,21,13052,2563,15615
1,1,7,3,2016,22,12696,2420,15116
1,1,7,3,2016,23,11928,2342,14270
1,1,7,3,2016,24,11700,2152,13852
2,2,7,3,2016,1,11527,1989,13516
2,2,7,3,2016,2,11672,1835,13507
2,2,7,3,2016,3,11165,1740,12905
2,2,7,3,2016,4,11048,1697,12745
2,2,7,3,2016,5,11129,1705,12834
2,2,7,3,2016,6,11533,1775,13308
2,2,7,3,2016,7,12184,1849,14033
2,2,7,3,2016,8,12583,1946,14529
2,2,7,3,2016,9,12486,2217,14703
2,2,7,3,2016,10,12690,2514,15204
2,2,7,3,2016,11,12538,2777,15315
2,2,7,3,2016,12,12572,2793,15365
2,2,7,3,2016,13,12094,2769,14863
2,2,7,3,2016,14,11586,2612,14198
2,2,7,3,2016,15,11706,2561,14267
2,2,7,3,2016,16,11639,2510,14149
2,2,7,3,2016,17,11682,2506,14188
2,2,7,3,2016,18,11534,2512,14046
2,2,7,3,2016,19,11870,2518,14388
2,2,7,3,2016,20,12687,2515,15202
2,2,7,3,2016,21,13105,2490,15595
2,2,7,3,2016,22,12386,2393,14779
2,2,7,3,2016,23,12343,2296,14639
2,2,7,3,2016,24,11888,2115,14003
2,3,7,3,2016,1,11397,1951,13348
2,3,7,3,2016,2,11247,1819,13066
2,3,7,3,2016,3,10979,1730,12709
2,3,7,3,2016,4,11112,1689,12801
2,3,7,3,2016,5,10731,1680,12411
2,3,7,3,2016,6,11130,1730,12860
2,3,7,3,2016,7,11713,1741,13454
2,3,7,3,2016,8,11714,1826,13540
2,3,7,3,2016,9,11814,1932,13746
2,3,7,3,2016,10,12191,2084,14275
2,3,7,3,2016,11,12228,2224,14452
2,3,7,3,2016,12,12010,2232,14242
2,3,7,3,2016,13,11598,2233,13831
2,3,7,3,2016,14,11549,2155,13704
2,3,7,3,2016,15,11399,2087,13486
2,3,7,3,2016,16,11278,2034,13312
2,3,7,3,2016,17,11207,2016,13223
2,3,7,3,2016,18,11362,2038,13400
2,3,7,3,2016,19,11480,2091,13571
2,3,7,3,2016,20,12674,2183,14857
2,3,7,3,2016,21,12726,2230,14956
2,3,7,3,2016,22,12168,2206,14374
2,3,7,3,2016,23,11694,2173,13867
2,3,7,3,2016,24,11446,2053,13499
1,4,7,3,2016,1,11031,1922,12953
1,4,7,3,2016,2,11011,1773,12784
1,4,7,3,2016,3,10879,1690,12569
1,4,7,3,2016,4,10952,1655,12607
1,4,7,3,2016,5,11028,1667,12695
1,4,7,3,2016,6,11898,1757,13655
1,4,7,3,2016,7,12120,1896,14016
1,4,7,3,2016,8,12420,2113,14533
1,4,7,3,2016,9,11615,2431,14046
1,4,7,3,2016,10,11874,2688,14562
1,4,7,3,2016,11,12197,3013,15210
1,4,7,3,2016,12,12359,3047,15406
1,4,7,3,2016,13,11671,2995,14666
1,4,7,3,2016,14,11340,2844,14184
1,4,7,3,2016,15,11385,2837,14222
1,4,7,3,2016,16,11383,2815,14198
1,4,7,3,2016,17,11501,2794,14295
1,4,7,3,2016,18,11478,2730,14208
1,4,7,3,2016,19,11818,2679,14497
1,4,7,3,2016,20,12918,2634,15552
1,4,7,3,2016,21,12738,2514,15252
1,4,7,3,2016,22,12312,2417,14729
1,4,7,3,2016,23,12005,2288,14293
1,4,7,3,2016,24,11578,2080,13658
1,5,7,3,2016,1,11481,1939,13420
1,5,7,3,2016,2,11100,1802,12902
1,5,7,3,2016,3,11155,1750,12905
1,5,7,3,2016,4,11163,1691,12854
1,5,7,3,2016,5,11219,1684,12903
1,5,7,3,2016,6,12016,1779,13795
1,5,7,3,2016,7,12584,1908,14492
1,5,7,3,2016,8,12827,2093,14920
1,5,7,3,2016,9,12618,2353,14971
1,5,7,3,2016,10,12546,2767,15313
1,5,7,3,2016,11,12418,2973,15391
1,5,7,3,2016,12,12149,3049,15198
1,5,7,3,2016,13,11787,2995,14782
1,5,7,3,2016,14,11619,2892,14511
1,5,7,3,2016,15,11468,2867,14335
1,5,7,3,2016,16,11474,2853,14327
1,5,7,3,2016,17,11557,2845,14402
1,5,7,3,2016,18,11430,2813,14243
1,5,7,3,2016,19,12199,2721,14920
1,5,7,3,2016,20,12629,2658,15287
1,5,7,3,2016,21,12456,2569,15025
1,5,7,3,2016,22,11956,2425,14381
1,5,7,3,2016,23,11795,2273,14068
1,5,7,3,2016,24,11500,2119,13619
1,6,7,3,2016,1,11041,1911,12952
1,6,7,3,2016,2,10952,1790,12742
1,6,7,3,2016,3,10955,1704,12659
1,6,7,3,2016,4,10771,1663,12434
1,6,7,3,2016,5,11117,1678,12795
1,6,7,3,2016,6,11441,1751,13192
1,6,7,3,2016,7,12027,1808,13835
1,6,7,3,2016,8,12367,1945,14312
1,6,7,3,2016,9,12732,2254,14986
1,6,7,3,2016,10,12781,2535,15316
1,6,7,3,2016,11,12854,2746,15600
1,6,7,3,2016,12,12531,2771,15302
1,6,7,3,2016,13,11990,2739,14729
1,6,7,3,2016,14,11569,2610,14179
1,6,7,3,2016,15,11519,2638,14157
1,6,7,3,2016,16,11633,2621,14254
1,6,7,3,2016,17,11599,2606,14205
1,6,7,3,2016,18,11383,2590,13973
1,6,7,3,2016,19,11990,2537,14527
1,6,7,3,2016,20,12743,2561,15304
1,6,7,3,2016,21,12869,2558,15427
1,6,7,3,2016,22,12437,2444,14881
1,6,7,3,2016,23,12069,2313,14382
1,6,7,3,2016,24,11656,2209,13865
3,7,7,3,2016,1,11319,2072,13391
3,7,7,3,2016,2,11121,1894,13015
3,7,7,3,2016,3,11036,1816,12852
3,7,7,3,2016,4,11162,1746,12908
3,7,7,3,2016,5,11332,1747,13079
3,7,7,3,2016,6,11936,1877,13813
3,7,7,3,2016,7,12949,2020,14969
3,7,7,3,2016,8,12975,2149,15124
3,7,7,3,2016,9,12955,2512,15467
3,7,7,3,2016,10,12632,2781,15413
3,7,7,3,2016,11,12464,2928,15392
3,7,7,3,2016,12,12305,2933,15238
3,7,7,3,2016,13,11609,2902,14511
3,7,7,3,2016,14,11197,2767,13964
3,7,7,3,2016,15,11265,2757,14022
3,7,7,3,2016,16,11272,2735,14007
3,7,7,3,2016,17,11209,2718,13927
3,7,7,3,2016,18,11084,2683,13767
3,7,7,3,2016,19,11657,2576,14233
3,7,7,3,2016,20,12549,2599,15148
3,7,7,3,2016,21,12574,2533,15107
3,7,7,3,2016,22,12315,2415,14730
3,7,7,3,2016,23,12111,2306,14417
3,7,7,3,2016,24,11464,2249,13713
1,8,7,3,2016,1,11400,2027,13427
1,8,7,3,2016,2,11228,1872,13100
1,8,7,3,2016,3,11172,1773,12945
1,8,7,3,2016,4,10882,1713,12595
1,8,7,3,2016,5,10988,1707,12695
1,8,7,3,2016,6,11733,1826,13559
1,8,7,3,2016,7,12284,1953,14237
1,8,7,3,2016,8,12462,2184,14646
1,8,7,3,2016,9,12518,2442,14960
1,8,7,3,2016,10,12541,2743,15284
1,8,7,3,2016,11,12050,2962,15012
1,8,7,3,2016,12,11477,3002,14479
1,8,7,3,2016,13,11079,2913,13992
1,8,7,3,2016,14,10669,2803,13472
1,8,7,3,2016,15,11021,2797,13818
1,8,7,3,2016,16,10647,2803,13450
1,8,7,3,2016,17,10804,2791,13595
1,8,7,3,2016,18,10713,2757,13470
1,8,7,3,2016,19,11379,2682,14061
1,8,7,3,2016,20,12058,2652,14710
1,8,7,3,2016,21,12304,2585,14889
1,8,7,3,2016,22,11596,2466,14062
1,8,7,3,2016,23,11354,2304,13658
1,8,7,3,2016,24,10811,2178,12989
2,9,7,3,2016,1,10601,2043,12644
2,9,7,3,2016,2,10415,1885,12300
2,9,7,3,2016,3,10136,1791,11927
2,9,7,3,2016,4,10496,1747,12243
2,9,7,3,2016,5,10558,1731,12289
2,9,7,3,2016,6,11253,1817,13070
2,9,7,3,2016,7,11864,1884,13748
2,9,7,3,2016,8,11927,1998,13925
2,9,7,3,2016,9,11401,2212,13613
2,9,7,3,2016,10,11706,2434,14140
2,9,7,3,2016,11,11914,2696,14610
2,9,7,3,2016,12,11465,2733,14198
2,9,7,3,2016,13,10930,2708,13638
2,9,7,3,2016,14,10509,2594,13103
2,9,7,3,2016,15,10875,2577,13452
2,9,7,3,2016,16,10656,2551,13207
2,9,7,3,2016,17,10969,2526,13495
2,9,7,3,2016,18,10978,2512,13490
2,9,7,3,2016,19,11693,2509,14202
2,9,7,3,2016,20,12105,2526,14631
2,9,7,3,2016,21,11866,2480,14346
2,9,7,3,2016,22,11170,2388,13558
2,9,7,3,2016,23,10903,2301,13204
2,9,7,3,2016,24,10290,2188,12478
2,10,7,3,2016,1,10519,2026,12545
2,10,7,3,2016,2,10766,1883,12649
2,10,7,3,2016,3,10381,1788,12169
2,10,7,3,2016,4,10131,1738,11869
2,10,7,3,2016,5,10120,1722,11842
2,10,7,3,2016,6,10436,1786,12222
2,10,7,3,2016,7,11439,1804,13243
2,10,7,3,2016,8,11401,1879,13280
2,10,7,3,2016,9,11287,1967,13254
2,10,7,3,2016,10,11762,2076,13838
2,10,7,3,2016,11,11558,2182,13740
2,10,7,3,2016,12,11430,2233,13663
2,10,7,3,2016,13,10609,2230,12839
2,10,7,3,2016,14,10605,2179,12784
2,10,7,3,2016,15,10358,2079,12437
2,10,7,3,2016,16,10461,2020,12481
2,10,7,3,2016,17,10111,2005,12116
2,10,7,3,2016,18,10438,2048,12486
2,10,7,3,2016,19,11261,2144,13405
2,10,7,3,2016,20,11565,2214,13779
2,10,7,3,2016,21,11619,2251,13870
2,10,7,3,2016,22,11045,2235,13280
2,10,7,3,2016,23,10438,2210,12648
2,10,7,3,2016,24,10158,2174,12332
1,11,7,3,2016,1,9820,1991,11811
1,11,7,3,2016,2,10145,1851,11996
1,11,7,3,2016,3,10083,1766,11849
1,11,7,3,2016,4,10139,1720,11859
1,11,7,3,2016,5,9944,1712,11656
1,11,7,3,2016,6,10263,1820,12083
1,11,7,3,2016,7,11013,1971,12984
1,11,7,3,2016,8,11316,2149,13465
1,11,7,3,2016,9,11675,2375,14050
1,11,7,3,2016,10,11893,2778,14671
1,11,7,3,2016,11,11946,2990,14936
1,11,7,3,2016,12,11472,3035,14507
1,11,7,3,2016,13,11253,2988,14241
1,11,7,3,2016,14,11198,2864,14062
1,11,7,3,2016,15,10756,2862,13618
1,11,7,3,2016,16,10578,2845,13423
1,11,7,3,2016,17,10742,2818,13560
1,11,7,3,2016,18,11095,2794,13889
1,11,7,3,2016,19,11687,2667,14354
1,11,7,3,2016,20,12120,2663,14783
1,11,7,3,2016,21,11914,2561,14475
1,11,7,3,2016,22,11487,2438,13925
1,11,7,3,2016,23,11060,2346,13406
1,11,7,3,2016,24,10876,2205,13081
1,12,7,3,2016,1,10185,2012,12197
1,12,7,3,2016,2,10004,1854,11858
1,12,7,3,2016,3,9855,1768,11623
1,12,7,3,2016,4,9920,1713,11633
1,12,7,3,2016,5,10283,1714,11997
1,12,7,3,2016,6,10886,1823,12709
1,12,7,3,2016,7,11762,1946,13708
1,12,7,3,2016,8,12087,2157,14244
1,12,7,3,2016,9,12145,2475,14620
1,12,7,3,2016,10,12006,2876,14882
1,12,7,3,2016,11,11822,3012,14834
1,12,7,3,2016,12,11511,3030,14541
1,12,7,3,2016,13,11157,2983,14140
1,12,7,3,2016,14,10803,2888,13691
1,12,7,3,2016,15,10710,2882,13592
1,12,7,3,2016,16,10834,2894,13728
1,12,7,3,2016,17,11104,2888,13992
1,12,7,3,2016,18,11062,2849,13911
1,12,7,3,2016,19,11844,2736,14580
1,12,7,3,2016,20,12460,2738,15198
1,12,7,3,2016,21,12636,2654,15290
1,12,7,3,2016,22,11852,2530,14382
1,12,7,3,2016,23,11499,2418,13917
1,12,7,3,2016,24,10724,2222,12946
1,13,7,3,2016,1,10456,2027,12483
1,13,7,3,2016,2,10409,1867,12276
1,13,7,3,2016,3,9955,1773,11728
1,13,7,3,2016,4,10271,1720,11991
1,13,7,3,2016,5,10315,1711,12026
1,13,7,3,2016,6,11027,1816,12843
1,13,7,3,2016,7,12104,1970,14074
1,13,7,3,2016,8,12133,2231,14364
1,13,7,3,2016,9,12237,2481,14718
1,13,7,3,2016,10,12253,2794,15047
1,13,7,3,2016,11,11916,3029,14945
1,13,7,3,2016,12,11607,3081,14688
1,13,7,3,2016,13,10970,3006,13976
1,13,7,3,2016,14,10910,2897,13807
1,13,7,3,2016,15,10650,2939,13589
1,13,7,3,2016,16,10708,2958,13666
1,13,7,3,2016,17,11116,2926,14042
1,13,7,3,2016,18,10898,2907,13805
1,13,7,3,2016,19,11330,2769,14099
1,13,7,3,2016,20,12405,2767,15172
1,13,7,3,2016,21,12838,2703,15541
1,13,7,3,2016,22,12406,2531,14937
1,13,7,3,2016,23,11833,2412,14245
1,13,7,3,2016,24,11340,2298,13638
1,14,7,3,2016,1,11182,2095,13277
1,14,7,3,2016,2,11074,1867,12941
1,14,7,3,2016,3,10952,1794,12746
1,14,7,3,2016,4,11099,1735,12834
1,14,7,3,2016,5,11251,1734,12985
1,14,7,3,2016,6,11764,1845,13609
1,14,7,3,2016,7,12438,1982,14420
1,14,7,3,2016,8,12779,2131,14910
1,14,7,3,2016,9,12548,2527,15075
1,14,7,3,2016,10,12428,2843,15271
1,14,7,3,2016,11,12404,3072,15476
1,14,7,3,2016,12,11855,3075,14930
1,14,7,3,2016,13,11468,3009,14477
1,14,7,3,2016,14,11286,2841,14127
1,14,7,3,2016,15,10861,2815,13676
1,14,7,3,2016,16,11186,2790,13976
1,14,7,3,2016,17,11028,2759,13787
1,14,7,3,2016,18,11210,2723,13933
1,14,7,3,2016,19,11676,2687,14363
1,14,7,3,2016,20,12780,2660,15440
1,14,7,3,2016,21,12846,2601,15447
1,14,7,3,2016,22,12388,2438,14826
1,14,7,3,2016,23,11626,2287,13913
1,14,7,3,2016,24,11300,2175,13475
1,15,7,3,2016,1,11105,1978,13083
1,15,7,3,2016,2,10980,1822,12802
1,15,7,3,2016,3,10903,1732,12635
1,15,7,3,2016,4,10960,1687,12647
1,15,7,3,2016,5,11260,1693,12953
1,15,7,3,2016,6,11854,1798,13652
1,15,7,3,2016,7,12476,1953,14428
1,15,7,3,2016,8,12831,2138,14969
1,15,7,3,2016,9,13174,2361,15535
1,15,7,3,2016,10,13044,2767,15811
1,15,7,3,2016,11,12461,2963,15424
1,15,7,3,2016,12,12075,3029,15104
1,15,7,3,2016,13,11794,3001,14796
1,15,7,3,2016,14,11396,2887,14282
1,15,7,3,2016,15,11422,2922,14344
1,15,7,3,2016,16,11292,2934,14226
1,15,7,3,2016,17,11329,2917,14246
1,15,7,3,2016,18,10863,2849,13712
1,15,7,3,2016,19,11002,2741,13742
1,15,7,3,2016,20,12826,2715,15541
1,15,7,3,2016,21,13192,2655,15847
1,15,7,3,2016,22,12978,2461,15439
1,15,7,3,2016,23,12064,2424,14488
1,15,7,3,2016,24,11718,2229,13948
2,16,7,3,2016,1,11250,2050,13300
2,16,7,3,2016,2,11233,1890,13123
2,16,7,3,2016,3,11108,1808,12916
2,16,7,3,2016,4,10949,1740,12689
2,16,7,3,2016,5,11409,1740,13149
2,16,7,3,2016,6,12434,1832,14266
2,16,7,3,2016,7,12310,1912,14222
2,16,7,3,2016,8,13194,2013,15207
2,16,7,3,2016,9,13281,2277,15558
2,16,7,3,2016,10,12136,2566,14702
2,16,7,3,2016,11,12627,2872,15499
2,16,7,3,2016,12,12380,2893,15273
2,16,7,3,2016,13,12126,2889,15015
2,16,7,3,2016,14,12207,2724,14931
2,16,7,3,2016,15,12119,2737,14856
2,16,7,3,2016,16,12171,2707,14878
2,16,7,3,2016,17,11916,2675,14591
2,16,7,3,2016,18,11562,2624,14186
2,16,7,3,2016,19,12046,2577,14623
2,16,7,3,2016,20,12781,2624,15405
2,16,7,3,2016,21,12746,2622,15368
2,16,7,3,2016,22,12138,2461,14599
2,16,7,3,2016,23,12180,2278,14458
2,16,7,3,2016,24,11996,2258,14254
2,17,7,3,2016,1,11934,2045,13979
2,17,7,3,2016,2,11585,1875,13460
2,17,7,3,2016,3,11610,1786,13396
2,17,7,3,2016,4,11564,1733,13297
2,17,7,3,2016,5,11641,1708,13349
2,17,7,3,2016,6,12240,1763,14003
2,17,7,3,2016,7,12857,1777,14634
2,17,7,3,2016,8,13030,1840,14870
2,17,7,3,2016,9,13053,1943,14996
2,17,7,3,2016,10,13189,2105,15294
2,17,7,3,2016,11,12925,2235,15160
2,17,7,3,2016,12,12923,2275,15198
2,17,7,3,2016,13,12431,2307,14738
2,17,7,3,2016,14,12334,2222,14556
2,17,7,3,2016,15,12196,2153,14349
2,17,7,3,2016,16,12104,2097,14201
2,17,7,3,2016,17,11790,2068,13858
2,17,7,3,2016,18,11421,2053,13474
2,17,7,3,2016,19,11684,2066,13750
2,17,7,3,2016,20,13075,2215,15290
2,17,7,3,2016,21,13233,2300,15533
2,17,7,3,2016,22,12962,2301,15263
2,17,7,3,2016,23,12420,2237,14657
2,17,7,3,2016,24,12003,2175,14178
1,18,7,3,2016,1,11632,2004,13636
1,18,7,3,2016,2,11534,1845,13379
1,18,7,3,2016,3,11451,1742,13193
1,18,7,3,2016,4,11421,1689,13110
1,18,7,3,2016,5,11586,1679,13265
1,18,7,3,2016,6,12210,1802,14012
1,18,7,3,2016,7,12966,1954,14920
1,18,7,3,2016,8,13344,2191,15535
1,18,7,3,2016,9,13453,2459,15912
1,18,7,3,2016,10,13436,2741,16177
1,18,7,3,2016,11,13330,3003,16333
1,18,7,3,2016,12,12658,3022,15680
1,18,7,3,2016,13,12430,2960,15390
1,18,7,3,2016,14,12216,2823,15039
1,18,7,3,2016,15,12358,2805,15163
1,18,7,3,2016,16,12558,2799,15357
1,18,7,3,2016,17,12109,2785,14894
1,18,7,3,2016,18,11957,2750,14707
1,18,7,3,2016,19,12508,2769,15277
1,18,7,3,2016,20,13416,2692,16108
1,18,7,3,2016,21,13307,2611,15918
1,18,7,3,2016,22,12856,2464,15320
1,18,7,3,2016,23,12501,2358,14859
1,18,7,3,2016,24,11892,2203,14095
1,19,7,3,2016,1,11640,1969,13609
1,19,7,3,2016,2,11677,1769,13446
1,19,7,3,2016,3,11375,1721,13096
1,19,7,3,2016,4,11564,1676,13240
1,19,7,3,2016,5,11621,1667,13288
1,19,7,3,2016,6,12055,1791,13846
1,19,7,3,2016,7,13068,1969,15037
1,19,7,3,2016,8,13144,2138,15282
1,19,7,3,2016,9,13414,2443,15857
1,19,7,3,2016,10,13334,2835,16169
1,19,7,3,2016,11,13301,2953,16254
1,19,7,3,2016,12,12408,2954,15362
1,19,7,3,2016,13,12556,2844,15400
1,19,7,3,2016,14,11451,2715,14166
1,19,7,3,2016,15,11807,2721,14528
1,19,7,3,2016,16,12168,2725,14893
1,19,7,3,2016,17,12537,2704,15241
1,19,7,3,2016,18,12356,2669,15025
1,19,7,3,2016,19,12012,2615,14627
1,19,7,3,2016,20,12930,2636,15566
1,19,7,3,2016,21,12949,2586,15535
1,19,7,3,2016,22,12532,2405,14937
1,19,7,3,2016,23,11964,2298,14262
1,19,7,3,2016,24,11737,2169,13906
1,20,7,3,2016,1,11380,1955,13336
1,20,7,3,2016,2,11268,1793,13060
1,20,7,3,2016,3,11310,1714,13024
1,20,7,3,2016,4,11406,1669,13075
1,20,7,3,2016,5,11627,1676,13303
1,20,7,3,2016,6,12038,1797,13836
1,20,7,3,2016,7,12902,1931,14832
1,20,7,3,2016,8,13296,2170,15466
1,20,7,3,2016,9,13349,2452,15801
1,20,7,3,2016,10,13285,2730,16015
1,20,7,3,2016,11,12971,2990,15961
1,20,7,3,2016,12,12861,3011,15872
1,20,7,3,2016,13,12546,3005,15551
1,20,7,3,2016,14,12404,2883,15287
1,20,7,3,2016,15,12162,2862,15024
1,20,7,3,2016,16,12180,2860,15040
1,20,7,3,2016,17,11948,2823,14770
1,20,7,3,2016,18,12004,2783,14788
1,20,7,3,2016,19,12476,2732,15208
1,20,7,3,2016,20,13464,2712,16176
1,20,7,3,2016,21,13401,2647,16048
1,20,7,3,2016,22,12737,2493,15230
1,20,7,3,2016,23,12333,2364,14697
1,20,7,3,2016,24,11902,2182,14084
1,21,7,3,2016,1,11459,1951,13410
1,21,7,3,2016,2,11492,1781,13273
1,21,7,3,2016,3,11021,1687,12708
1,21,7,3,2016,4,11114,1639,12753
1,21,7,3,2016,5,11351,1638,12989
1,21,7,3,2016,6,11941,1757,13698
1,21,7,3,2016,7,12645,1926,14571
1,21,7,3,2016,8,12958,2102,15060
1,21,7,3,2016,9,12936,2417,15353
1,21,7,3,2016,10,13168,2726,15894
1,21,7,3,2016,11,12825,2887,15712
1,21,7,3,2016,12,12242,2900,15142
1,21,7,3,2016,13,12006,2872,14878
1,21,7,3,2016,14,11819,2739,14558
1,21,7,3,2016,15,11927,2729,14656
1,21,7,3,2016,16,11928,2722,14650
1,21,7,3,2016,17,12130,2698,14828
1,21,7,3,2016,18,11566,2679,14245
1,21,7,3,2016,19,12496,2635,15131
1,21,7,3,2016,20,13352,2658,16010
1,21,7,3,2016,21,13191,2589,15780
1,21,7,3,2016,22,12817,2449,15266
1,21,7,3,2016,23,12095,2303,14398
1,21,7,3,2016,24,11767,2122,13889
1,22,7,3,2016,1,11545,1911,13456
1,22,7,3,2016,2,11477,1752,13229
1,22,7,3,2016,3,11395,1673,13068
1,22,7,3,2016,4,11475,1625,13100
1,22,7,3,2016,5,11411,1637,13048
1,22,7,3,2016,6,12237,1746,13983
1,22,7,3,2016,7,12985,1924,14909
1,22,7,3,2016,8,13296,2108,15404
1,22,7,3,2016,9,13366,2517,15883
1,22,7,3,2016,10,13062,2753,15815
1,22,7,3,2016,11,12751,2943,15694
1,22,7,3,2016,12,11935,2986,14921
1,22,7,3,2016,13,11844,2951,14795
1,22,7,3,2016,14,11718,2799,14517
1,22,7,3,2016,15,11304,2808,14112
1,22,7,3,2016,16,10926,2809,13735
1,22,7,3,2016,17,10945,2775,13720
1,22,7,3,2016,18,10989,2744,13733
1,22,7,3,2016,19,11982,2678,14660
1,22,7,3,2016,20,12933,2670,15603
1,22,7,3,2016,21,12908,2566,15474
1,22,7,3,2016,22,12382,2486,14868
1,22,7,3,2016,23,11856,2272,14128
1,22,7,3,2016,24,11209,2161,13370
2,23,7,3,2016,1,11137,1938,13075
2,23,7,3,2016,2,10819,1802,12621
2,23,7,3,2016,3,10856,1714,12570
2,23,7,3,2016,4,10787,1676,12463
2,23,7,3,2016,5,10979,1670,12649
2,23,7,3,2016,6,11490,1763,13253
2,23,7,3,2016,7,12134,1851,13985
2,23,7,3,2016,8,12698,1969,14667
2,23,7,3,2016,9,12540,2230,14770
2,23,7,3,2016,10,12690,2438,15128
2,23,7,3,2016,11,12793,2621,15414
2,23,7,3,2016,12,12374,2756,15130
2,23,7,3,2016,13,12221,2752,14973
2,23,7,3,2016,14,11975,2609,14584
2,23,7,3,2016,15,12162,2606,14768
2,23,7,3,2016,16,12131,2587,14718
2,23,7,3,2016,17,11860,2559,14419
2,23,7,3,2016,18,11809,2521,14330
2,23,7,3,2016,19,12356,2493,14849
2,23,7,3,2016,20,13414,2576,15990
2,23,7,3,2016,21,13162,2581,15743
2,23,7,3,2016,22,12814,2429,15243
2,23,7,3,2016,23,12314,2292,14606
2,23,7,3,2016,24,11496,2190,13686
2,24,7,3,2016,1,11249,1976,13225
2,24,7,3,2016,2,11172,1794,12966
2,24,7,3,2016,3,11104,1722,12826
2,24,7,3,2016,4,11150,1666,12816
2,24,7,3,2016,5,11291,1654,12945
2,24,7,3,2016,6,11683,1740,13423
2,24,7,3,2016,7,12215,1764,13979
2,24,7,3,2016,8,12349,1834,14183
2,24,7,3,2016,9,12609,1943,14552
2,24,7,3,2016,10,12865,2111,14976
2,24,7,3,2016,11,12801,2218,15019
2,24,7,3,2016,12,12487,2243,14730
2,24,7,3,2016,13,12357,2335,14692
2,24,7,3,2016,14,12030,2206,14236
2,24,7,3,2016,15,12092,2074,14166
2,24,7,3,2016,16,11898,2031,13929
2,24,7,3,2016,17,11725,2009,13734
2,24,7,3,2016,18,11335,2000,13335
2,24,7,3,2016,19,11979,2069,14048
2,24,7,3,2016,20,13127,2242,15369
2,24,7,3,2016,21,12982,2278,15260
2,24,7,3,2016,22,12591,2279,14870
2,24,7,3,2016,23,11911,2226,14137
2,24,7,3,2016,24,11477,2148,13625
1,25,7,3,2016,1,11366,1960,13326
1,25,7,3,2016,2,11204,1799,13003
1,25,7,3,2016,3,11279,1700,12979
1,25,7,3,2016,4,11259,1640,12899
1,25,7,3,2016,5,11272,1637,12910
1,25,7,3,2016,6,11920,1795,13715
1,25,7,3,2016,7,12614,1955,14570
1,25,7,3,2016,8,13304,2151,15455
1,25,7,3,2016,9,13321,2473,15794
1,25,7,3,2016,10,13276,2801,16077
1,25,7,3,2016,11,13421,2991,16412
1,25,7,3,2016,12,13116,3033,16150
1,25,7,3,2016,13,13232,2956,16188
1,25,7,3,2016,14,12300,2858,15158
1,25,7,3,2016,15,12724,2868,15592
1,25,7,3,2016,16,12698,2830,15528
1,25,7,3,2016,17,13388,2792,16180
1,25,7,3,2016,18,11816,2752,14568
1,25,7,3,2016,19,12984,2648,15632
1,25,7,3,2016,20,13460,2708,16168
1,25,7,3,2016,21,13392,2658,16050
1,25,7,3,2016,22,12746,2509,15256
1,25,7,3,2016,23,12246,2361,14606
1,25,7,3,2016,24,12838,2290,15128
1,26,7,3,2016,1,12320,1975,14295
1,26,7,3,2016,2,12323,1856,14179
1,26,7,3,2016,3,12022,1749,13771
1,26,7,3,2016,4,12006,1689,13695
1,26,7,3,2016,5,12140,1703,13843
1,26,7,3,2016,6,12553,1824,14377
1,26,7,3,2016,7,13155,1974,15129
1,26,7,3,2016,8,12831,2163,14994
1,26,7,3,2016,9,13307,2557,15864
1,26,7,3,2016,10,13209,2791,16000
1,26,7,3,2016,11,13145,2946,16091
1,26,7,3,2016,12,13211,2941,16152
1,26,7,3,2016,13,12610,2861,15471
1,26,7,3,2016,14,12706,2696,15402
1,26,7,3,2016,15,12735,2702,15437
1,26,7,3,2016,16,12820,2713,15533
1,26,7,3,2016,17,12685,2710,15395
1,26,7,3,2016,18,12216,2664,14880
1,26,7,3,2016,19,12344,2623,14967
1,26,7,3,2016,20,13554,2636,16190
1,26,7,3,2016,21,13682,2524,16206
1,26,7,3,2016,22,12991,2458,15449
1,26,7,3,2016,23,12721,2274,14995
1,26,7,3,2016,24,12141,2206,14347
1,27,7,3,2016,1,12019,1920,13939
1,27,7,3,2016,2,11653,1777,13430
1,27,7,3,2016,3,11696,1659,13355
1,27,7,3,2016,4,11498,1622,13120
1,27,7,3,2016,5,11912,1632,13544
1,27,7,3,2016,6,12367,1746,14113
1,27,7,3,2016,7,12936,1920,14856
1,27,7,3,2016,8,13397,2102,15499
1,27,7,3,2016,9,13689,2337,16026
1,27,7,3,2016,10,13456,2734,16190
1,27,7,3,2016,11,13263,2895,16158
1,27,7,3,2016,12,13422,2905,16327
1,27,7,3,2016,13,12664,2862,15526
1,27,7,3,2016,14,12587,2733,15320
1,27,7,3,2016,15,12670,2745,15415
1,27,7,3,2016,16,12710,2728,15438
1,27,7,3,2016,17,12740,2716,15456
1,27,7,3,2016,18,12460,2672,15132
1,27,7,3,2016,19,13049,2638,15687
1,27,7,3,2016,20,13830,2633,16463
1,27,7,3,2016,21,13475,2566,16041
1,27,7,3,2016,22,13045,2440,15485
1,27,7,3,2016,23,12522,2244,14766
1,27,7,3,2016,24,11970,2093,14063
1,28,7,3,2016,1,11616,1914,13530
1,28,7,3,2016,2,11533,1727,13260
1,28,7,3,2016,3,11448,1637,13085
1,28,7,3,2016,4,11534,1595,13129
1,28,7,3,2016,5,11739,1598,13337
1,28,7,3,2016,6,12312,1726,14038
1,28,7,3,2016,7,13007,1888,14895
1,28,7,3,2016,8,13433,2023,15456
1,28,7,3,2016,9,13091,2372,15463
1,28,7,3,2016,10,13231,2692,15923
1,28,7,3,2016,11,13201,2898,16099
1,28,7,3,2016,12,12735,2927,15662
1,28,7,3,2016,13,12577,2895,15472
1,28,7,3,2016,14,12079,2731,14810
1,28,7,3,2016,15,11894,2748,14642
1,28,7,3,2016,16,12489,2751,15240
1,28,7,3,2016,17,12269,2763,15032
1,28,7,3,2016,18,12004,2729,14733
1,28,7,3,2016,19,12460,2663,15123
1,28,7,3,2016,20,13658,2623,16281
1,28,7,3,2016,21,13676,2495,16171
1,28,7,3,2016,22,12980,2316,15296
1,28,7,3,2016,23,12449,2174,14623
1,28,7,3,2016,24,11887,2059,13946
1,29,7,3,2016,1,11792,1856,13648
1,29,7,3,2016,2,11266,1698,12964
1,29,7,3,2016,3,11356,1614,12970
1,29,7,3,2016,4,11269,1567,12836
1,29,7,3,2016,5,11371,1568,12939
1,29,7,3,2016,6,12208,1696,13904
1,29,7,3,2016,7,12576,1875,14451
1,29,7,3,2016,8,12985,2013,14998
1,29,7,3,2016,9,12917,2314,15231
1,29,7,3,2016,10,12681,2573,15254
1,29,7,3,2016,11,12687,2750,15437
1,29,7,3,2016,12,12351,2865,15216
1,29,7,3,2016,13,11891,2864,14755
1,29,7,3,2016,14,11790,2729,14519
1,29,7,3,2016,15,11544,2725,14269
1,29,7,3,2016,16,11777,2699,14476
1,29,7,3,2016,17,11514,2665,14179
1,29,7,3,2016,18,11578,2640,14218
1,29,7,3,2016,19,12063,2607,14670
1,29,7,3,2016,20,13261,2631,15892
1,29,7,3,2016,21,12836,2579,15415
1,29,7,3,2016,22,12628,2399,15027
1,29,7,3,2016,23,11892,2221,14113
1,29,7,3,2016,24,11574,2059,13633
2,30,7,3,2016,1,11362,1903,13265
2,30,7,3,2016,2,11259,1725,12984
2,30,7,3,2016,3,11274,1666,12940
2,30,7,3,2016,4,11130,1612,12742
2,30,7,3,2016,5,11211,1597,12808
2,30,7,3,2016,6,11483,1675,13158
2,30,7,3,2016,7,12330,1694,14024
2,30,7,3,2016,8,12473,1772,14245
2,30,7,3,2016,9,12636,1894,14530
2,30,7,3,2016,10,12422,2072,14494
2,30,7,3,2016,11,12277,2192,14469
2,30,7,3,2016,12,11951,2298,14249
2,30,7,3,2016,13,11648,2198,13846
2,30,7,3,2016,14,11309,2137,13446
2,30,7,3,2016,15,11315,2036,13351
2,30,7,3,2016,16,11234,1981,13215
2,30,7,3,2016,17,10951,1944,12895
2,30,7,3,2016,18,10880,1959,12839
2,30,7,3,2016,19,11359,2069,13428
2,30,7,3,2016,20,12544,2173,14717
2,30,7,3,2016,21,12274,2201,14475
2,30,7,3,2016,22,11703,2171,13874
2,30,7,3,2016,23,11618,2068,13686
2,30,7,3,2016,24,11057,1965,13022
2,31,7,3,2016,1,11542,1856,13398
2,31,7,3,2016,2,11046,1701,12747
2,31,7,3,2016,3,11130,1615,12745
2,31,7,3,2016,4,11065,1577,12642
2,31,7,3,2016,5,11236,1574,12810
2,31,7,3,2016,6,11948,1671,13619
2,31,7,3,2016,7,12630,1748,14378
2,31,7,3,2016,8,12787,1944,14731
2,31,7,3,2016,9,13133,2166,15299
2,31,7,3,2016,10,13160,2404,15564
2,31,7,3,2016,11,12988,2699,15687
2,31,7,3,2016,12,12708,2746,15454
2,31,7,3,2016,13,12670,2725,15395
2,31,7,3,2016,14,12310,2615,14925
2,31,7,3,2016,15,12287,2598,14885
2,31,7,3,2016,16,12235,2572,14807
2,31,7,3,2016,17,12116,2557,14673
2,31,7,3,2016,18,11708,2531,14239
2,31,7,3,2016,19,11971,2488,14459
2,31,7,3,2016,20,13330,2547,15877
2,31,7,3,2016,21,13300,2489,15789
2,31,7,3,2016,22,12792,2353,15145
2,31,7,3,2016,23,12184,2226,14410
2,31,7,3,2016,24,11666,2113,13779
1,1,8,3,2016,1,10794,1772,12566
1,1,8,3,2016,2,10448,1645,12093
1,1,8,3,2016,3,10456,1560,12016
1,1,8,3,2016,4,10444,1528,11972
1,1,8,3,2016,5,10764,1534,12298
1,1,8,3,2016,6,11465,1671,13136
1,1,8,3,2016,7,11896,1875,13771
1,1,8,3,2016,8,12304,2031,14335
1,1,8,3,2016,9,12632,2368,15000
1,1,8,3,2016,10,12332,2682,15014
1,1,8,3,2016,11,12289,2843,15132
1,1,8,3,2016,12,11764,2876,14640
1,1,8,3,2016,13,11457,2781,14238
1,1,8,3,2016,14,10967,2655,13622
1,1,8,3,2016,15,11114,2650,13764
1,1,8,3,2016,16,11245,2666,13911
1,1,8,3,2016,17,11211,2668,13879
1,1,8,3,2016,18,10680,2639,13319
1,1,8,3,2016,19,12100,2578,14678
1,1,8,3,2016,20,12394,2566,14960
1,1,8,3,2016,21,12131,2481,14612
1,1,8,3,2016,22,11965,2362,14327
1,1,8,3,2016,23,11795,2258,14053
1,1,8,3,2016,24,11149,2017,13166
1,2,8,3,2016,1,10824,1855,12680
1,2,8,3,2016,2,10658,1715,12372
1,2,8,3,2016,3,10426,1629,12054
1,2,8,3,2016,4,10264,1596,11860
1,2,8,3,2016,5,10654,1601,12256
1,2,8,3,2016,6,11404,1735,13140
1,2,8,3,2016,7,12110,1910,14020
1,2,8,3,2016,8,12235,2079,14314
1,2,8,3,2016,9,12144,2418,14562
1,2,8,3,2016,10,12096,2730,14826
1,2,8,3,2016,11,11930,2929,14859
1,2,8,3,2016,12,11694,2935,14630
1,2,8,3,2016,13,10974,2848,13822
1,2,8,3,2016,14,10918,2754,13672
1,2,8,3,2016,15,11318,2732,14050
1,2,8,3,2016,16,11632,2705,14337
1,2,8,3,2016,17,11209,2718,13927
1,2,8,3,2016,18,11394,2719,14113
1,2,8,3,2016,19,11838,2658,14496
1,2,8,3,2016,20,12461,2649,15110
1,2,8,3,2016,21,12342,2558,14900
1,2,8,3,2016,22,11815,2382,14197
1,2,8,3,2016,23,11285,2231,13516
1,2,8,3,2016,24,10725,2093,12818
1,4,8,3,2016,1,10346,1901,12247
1,4,8,3,2016,2,10460,1748,12208
1,4,8,3,2016,3,10266,1658,11924
1,4,8,3,2016,4,10155,1618,11773
1,4,8,3,2016,5,10409,1621,12030
1,4,8,3,2016,6,10908,1747,12655
1,4,8,3,2016,7,11891,1919,13810
1,4,8,3,2016,8,12318,2116,14434
1,4,8,3,2016,9,12226,2456,14682
1,4,8,3,2016,10,12118,2762,14880
1,4,8,3,2016,11,11508,2975,14483
1,4,8,3,2016,12,11224,3048,14272
1,4,8,3,2016,13,10842,2986,13828
1,4,8,3,2016,14,10582,2870,13452
1,4,8,3,2016,15,10744,2878,13622
1,4,8,3,2016,16,10639,2876,13515
1,4,8,3,2016,17,10477,2862,13339
1,4,8,3,2016,18,10776,2800,13576
1,4,8,3,2016,19,11317,2718,14035
1,4,8,3,2016,20,12886,2702,15588
1,4,8,3,2016,21,12803,2624,15427
1,4,8,3,2016,22,12416,2501,14917
1,4,8,3,2016,23,11687,2351,14038
1,4,8,3,2016,24,10996,2143,13139
1,5,8,3,2016,1,10884,1949,12833
1,5,8,3,2016,2,10553,1786,12339
1,5,8,3,2016,3,10411,1698,12109
1,5,8,3,2016,4,10461,1647,12108
1,5,8,3,2016,5,10687,1656,12343
1,5,8,3,2016,6,11844,1753,13597
1,5,8,3,2016,7,12183,1961,14144
1,5,8,3,2016,8,12394,2140,14534
1,5,8,3,2016,9,12590,2428,15018
1,5,8,3,2016,10,12084,2771,14855
1,5,8,3,2016,11,11692,2900,14592
1,5,8,3,2016,12,10928,2957,13885
1,5,8,3,2016,13,10572,2905,13477
1,5,8,3,2016,14,10302,2732,13034
1,5,8,3,2016,15,10095,2693,12788
1,5,8,3,2016,16,10155,2703,12858
1,5,8,3,2016,17,10336,2684,13020
1,5,8,3,2016,18,10375,2651,13026
1,5,8,3,2016,19,11528,2628,14156
1,5,8,3,2016,20,12367,2623,14990
1,5,8,3,2016,21,12385,2560,14945
1,5,8,3,2016,22,11803,2425,14228
1,5,8,3,2016,23,11111,2263,13374
1,5,8,3,2016,24,10590,2134,12724
2,6,8,3,2016,1,10247,1916,12163
2,6,8,3,2016,2,9905,1784,11689
2,6,8,3,2016,3,9822,1674,11496
2,6,8,3,2016,4,9818,1618,11436
2,6,8,3,2016,5,10221,1629,11850
2,6,8,3,2016,6,10535,1744,12279
2,6,8,3,2016,7,11247,1856,13103
2,6,8,3,2016,8,11647,1998,13645
2,6,8,3,2016,9,11795,2335,14130
2,6,8,3,2016,10,11838,2594,14432
2,6,8,3,2016,11,11493,2845,14338
2,6,8,3,2016,12,11091,2847,13938
2,6,8,3,2016,13,10803,2811,13614
2,6,8,3,2016,14,10449,2618,13067
2,6,8,3,2016,15,10525,2607,13132
2,6,8,3,2016,16,10438,2590,13028
2,6,8,3,2016,17,10483,2553,13036
2,6,8,3,2016,18,10591,2523,13114
2,6,8,3,2016,19,11336,2512,13848
2,6,8,3,2016,20,12175,2538,14713
2,6,8,3,2016,21,11994,2513,14507
2,6,8,3,2016,22,11413,2412,13825
2,6,8,3,2016,23,11108,2215,13323
2,6,8,3,2016,24,10615,2119,12734
2,7,8,3,2016,1,10558,1971,12529
2,7,8,3,2016,2,10598,1757,12355
2,7,8,3,2016,3,10251,1677,11928
2,7,8,3,2016,4,10246,1626,11872
2,7,8,3,2016,5,10327,1627,11954
2,7,8,3,2016,6,10711,1695,12406
2,7,8,3,2016,7,11652,1741,13393
2,7,8,3,2016,8,11697,1796,13493
2,7,8,3,2016,9,12040,1981,14021
2,7,8,3,2016,10,11994,2113,14107
2,7,8,3,2016,11,11567,2217,13784
2,7,8,3,2016,12,11337,2223,13560
2,7,8,3,2016,13,10973,2213,13186
2,7,8,3,2016,14,10596,2130,12726
2,7,8,3,2016,15,10458,2072,12530
2,7,8,3,2016,16,10686,2045,12731
2,7,8,3,2016,17,10404,2018,12422
2,7,8,3,2016,18,10424,2012,12436
2,7,8,3,2016,19,10881,2040,12921
2,7,8,3,2016,20,11849,2200,14049
2,7,8,3,2016,21,11994,2246,14240
2,7,8,3,2016,22,11617,2233,13850
2,7,8,3,2016,23,11069,2150,13219
2,7,8,3,2016,24,10639,2108,12747
1,8,8,3,2016,1,10413,1904,12317
1,8,8,3,2016,2,10307,1742,12049
1,8,8,3,2016,3,10381,1652,12033
1,8,8,3,2016,4,10297,1611,11908
1,8,8,3,2016,5,10744,1611,12355
1,8,8,3,2016,6,11085,1744,12829
1,8,8,3,2016,7,12022,1927,13949
1,8,8,3,2016,8,12305,2108,14413
1,8,8,3,2016,9,12240,2542,14782
1,8,8,3,2016,10,12285,2777,15062
1,8,8,3,2016,11,11898,2959,14857
1,8,8,3,2016,12,11643,3053,14696
1,8,8,3,2016,13,11091,3023,14114
1,8,8,3,2016,14,10938,2855,13793
1,8,8,3,2016,15,11090,2877,13967
1,8,8,3,2016,16,10793,2870,13663
1,8,8,3,2016,17,11110,2840,13950
1,8,8,3,2016,18,11071,2797,13868
1,8,8,3,2016,19,11726,2731,14457
1,8,8,3,2016,20,12723,2730,15453
1,8,8,3,2016,21,12604,2626,15230
1,8,8,3,2016,22,12134,2499,14633
1,8,8,3,2016,23,11539,2385,13924
1,8,8,3,2016,24,11150,2246,13396
1,9,8,3,2016,1,11019,1995,13014
1,9,8,3,2016,2,10830,1833,12663
1,9,8,3,2016,3,10820,1737,12557
1,9,8,3,2016,4,10729,1689,12418
1,9,8,3,2016,5,11033,1695,12728
1,9,8,3,2016,6,11535,1797,13332
1,9,8,3,2016,7,12385,2020,14405
1,9,8,3,2016,8,12733,2202,14935
1,9,8,3,2016,9,12892,2422,15314
1,9,8,3,2016,10,12658,2837,15495
1,9,8,3,2016,11,12223,3051,15274
1,9,8,3,2016,12,12054,3091,15145
1,9,8,3,2016,13,11587,3025,14612
1,9,8,3,2016,14,11475,2890,14365
1,9,8,3,2016,15,11391,2924,14315
1,9,8,3,2016,16,11564,2910,14474
1,9,8,3,2016,17,11600,2911,14511
1,9,8,3,2016,18,11212,2822,14034
1,9,8,3,2016,19,11953,2742,14695
1,9,8,3,2016,20,13221,2748,15969
1,9,8,3,2016,21,13019,2660,15679
1,9,8,3,2016,22,12224,2532,14756
1,9,8,3,2016,23,12179,2376,14555
1,9,8,3,2016,24,11638,2197,13835
1,10,8,3,2016,1,11372,1982,13354
1,10,8,3,2016,2,11111,1830,12941
1,10,8,3,2016,3,11069,1742,12811
1,10,8,3,2016,4,11038,1690,12728
1,10,8,3,2016,5,11293,1684,12977
1,10,8,3,2016,6,11981,1817,13798
1,10,8,3,2016,7,13022,1967,14989
1,10,8,3,2016,8,13130,2194,15324
1,10,8,3,2016,9,12909,2470,15379
1,10,8,3,2016,10,12900,2813,15713
1,10,8,3,2016,11,12780,3033,15813
1,10,8,3,2016,12,12290,3084,15374
1,10,8,3,2016,13,11926,3062,14988
1,10,8,3,2016,14,11606,2916,14522
1,10,8,3,2016,15,11632,2919,14551
1,10,8,3,2016,16,11721,2922,14643
1,10,8,3,2016,17,11873,2925,14798
1,10,8,3,2016,18,11266,2833,14099
1,10,8,3,2016,19,11516,2788,14304
1,10,8,3,2016,20,13544,2763,16307
1,10,8,3,2016,21,13367,2639,16006
1,10,8,3,2016,22,12847,2488,15335
1,10,8,3,2016,23,12384,2353,14737
1,10,8,3,2016,24,11834,2239,14073
1,11,8,3,2016,1,11706,1983,13689
1,11,8,3,2016,2,11672,1822,13494
1,11,8,3,2016,3,11562,1734,13296
1,11,8,3,2016,4,11588,1679,13267
1,11,8,3,2016,5,11601,1679,13280
1,11,8,3,2016,6,12409,1802,14211
1,11,8,3,2016,7,12805,1966,14771
1,11,8,3,2016,8,13540,2166,15706
1,11,8,3,2016,9,13261,2484,15745
1,11,8,3,2016,10,12986,2844,15830
1,11,8,3,2016,11,13033,3037,16070
1,11,8,3,2016,12,12587,3092,15679
1,11,8,3,2016,13,12873,3028,15901
1,11,8,3,2016,14,12238,2880,15118
1,11,8,3,2016,15,11902,2878,14780
1,11,8,3,2016,16,12105,2882,14987
1,11,8,3,2016,17,12012,2842,14854
1,11,8,3,2016,18,10585,2815,13400
1,11,8,3,2016,19,11748,2775,14522
1,11,8,3,2016,20,13660,2780,16440
1,11,8,3,2016,21,13435,2715,16150
1,11,8,3,2016,22,12658,2527,15185
1,11,8,3,2016,23,12460,2330,14790
1,11,8,3,2016,24,11789,2234,14023
1,12,8,3,2016,1,11557,1988,13545
1,12,8,3,2016,2,11598,1828,13426
1,12,8,3,2016,3,11543,1734,13277
1,12,8,3,2016,4,11564,1697,13261
1,12,8,3,2016,5,11768,1694,13462
1,12,8,3,2016,6,12263,1816,14079
1,12,8,3,2016,7,13211,1996,15207
1,12,8,3,2016,8,13628,2235,15863
1,12,8,3,2016,9,13636,2500,16136
1,12,8,3,2016,10,13209,2832,16041
1,12,8,3,2016,11,12624,3003,15627
1,12,8,3,2016,12,12404,3066,15470
1,12,8,3,2016,13,12484,3031,15515
1,12,8,3,2016,14,12266,2879,15145
1,12,8,3,2016,15,11816,2932,14748
1,12,8,3,2016,16,11692,2948,14640
1,12,8,3,2016,17,11720,2925,14645
1,12,8,3,2016,18,11273,2858,14131
1,12,8,3,2016,19,12019,2766,14785
1,12,8,3,2016,20,13023,2765,15788
1,12,8,3,2016,21,13188,2674,15862
1,12,8,3,2016,22,12444,2513,14957
1,12,8,3,2016,23,12053,2413,14466
1,12,8,3,2016,24,12066,2291,14357
2,13,8,3,2016,1,11660,2061,13721
2,13,8,3,2016,2,11534,1880,13414
2,13,8,3,2016,3,11377,1775,13152
2,13,8,3,2016,4,11655,1718,13373
2,13,8,3,2016,5,12124,1714,13838
2,13,8,3,2016,6,12431,1826,14257
2,13,8,3,2016,7,13178,1921,15099
2,13,8,3,2016,8,13460,2057,15517
2,13,8,3,2016,9,13455,2260,15715
2,13,8,3,2016,10,13531,2555,16086
2,13,8,3,2016,11,13494,2752,16246
2,13,8,3,2016,12,13066,2816,15882
2,13,8,3,2016,13,12664,2767,15431
2,13,8,3,2016,14,12146,2649,14795
2,13,8,3,2016,15,12424,2636,15060
2,13,8,3,2016,16,12349,2626,14975
2,13,8,3,2016,17,12173,2592,14765
2,13,8,3,2016,18,11695,2562,14257
2,13,8,3,2016,19,12020,2557,14577
2,13,8,3,2016,20,13857,2635,16492
2,13,8,3,2016,21,13561,2569,16130
2,13,8,3,2016,22,12889,2470,15359
2,13,8,3,2016,23,12366,2320,14686
2,13,8,3,2016,24,12115,2215,14330
2,14,8,3,2016,1,11758,2048,13806
2,14,8,3,2016,2,11777,1890,13667
2,14,8,3,2016,3,11549,1780,13329
2,14,8,3,2016,4,11581,1714,13295
2,14,8,3,2016,5,11762,1705,13467
2,14,8,3,2016,6,12161,1779,13940
2,14,8,3,2016,7,12880,1823,14703
2,14,8,3,2016,8,13345,1884,15229
2,14,8,3,2016,9,13537,2017,15554
2,14,8,3,2016,10,13509,2189,15698
2,14,8,3,2016,11,13251,2283,15534
2,14,8,3,2016,12,13237,2294,15531
2,14,8,3,2016,13,12679,2241,14920
2,14,8,3,2016,14,12356,2170,14526
2,14,8,3,2016,15,12385,2130,14515
2,14,8,3,2016,16,12401,2093,14494
2,14,8,3,2016,17,12207,2071,14278
2,14,8,3,2016,18,11582,2048,13630
2,14,8,3,2016,19,11967,2090,14057
2,14,8,3,2016,20,12902,2224,15126
2,14,8,3,2016,21,13147,2265,15412
2,14,8,3,2016,22,12760,2248,15008
2,14,8,3,2016,23,12273,2238,14511
2,14,8,3,2016,24,11934,2154,14088
3,15,8,3,2016,1,11633,1979,13612
3,15,8,3,2016,2,11418,1838,13256
3,15,8,3,2016,3,11427,1742,13169
3,15,8,3,2016,4,11442,1687,13129
3,15,8,3,2016,5,11528,1679,13207
3,15,8,3,2016,6,12726,1756,14482
3,15,8,3,2016,7,12899,1842,14741
3,15,8,3,2016,8,12744,1907,14651
3,15,8,3,2016,9,12270,1995,14265
3,15,8,3,2016,10,11317,2104,13421
3,15,8,3,2016,11,11481,2150,13631
3,15,8,3,2016,12,11201,2174,13375
3,15,8,3,2016,13,10868,2193,13061
3,15,8,3,2016,14,10755,2125,12880
3,15,8,3,2016,15,10452,2092,12544
3,15,8,3,2016,16,10760,2071,12831
3,15,8,3,2016,17,10174,2058,12232
3,15,8,3,2016,18,9660,2072,11732
3,15,8,3,2016,19,9943,2107,12050
3,15,8,3,2016,20,11669,2205,13874
3,15,8,3,2016,21,11801,2289,14090
3,15,8,3,2016,22,11265,2281,13546
3,15,8,3,2016,23,11025,2278,13303
3,15,8,3,2016,24,10646,2148,12794
1,16,8,3,2016,1,10722,1967,12689
1,16,8,3,2016,2,10524,1815,12339
1,16,8,3,2016,3,10529,1723,12252
1,16,8,3,2016,4,10666,1676,12342
1,16,8,3,2016,5,11042,1678,12720
1,16,8,3,2016,6,11450,1787,13237
1,16,8,3,2016,7,12428,1949,14377
1,16,8,3,2016,8,13405,2129,15534
1,16,8,3,2016,9,13918,2552,16470
1,16,8,3,2016,10,13515,2857,16372
1,16,8,3,2016,11,13499,3078,16577
1,16,8,3,2016,12,13025,3117,16142
1,16,8,3,2016,13,12727,3066,15793
1,16,8,3,2016,14,12603,2955,15558
1,16,8,3,2016,15,12752,2951,15703
1,16,8,3,2016,16,12790,2963,15753
1,16,8,3,2016,17,12996,2937,15933
1,16,8,3,2016,18,12261,2895,15156
1,16,8,3,2016,19,12633,2813,15446
1,16,8,3,2016,20,13615,2795,16410
1,16,8,3,2016,21,13746,2735,16481
1,16,8,3,2016,22,13086,2573,15659
1,16,8,3,2016,23,12665,2433,15098
1,16,8,3,2016,24,12166,2311,14477
3,17,8,3,2016,1,12256,2073,14329
3,17,8,3,2016,2,12055,1918,13973
3,17,8,3,2016,3,12056,1820,13876
3,17,8,3,2016,4,12127,1756,13883
3,17,8,3,2016,5,12115,1756,13871
3,17,8,3,2016,6,12781,1838,14619
3,17,8,3,2016,7,13426,1943,15369
3,17,8,3,2016,8,13914,2167,16081
3,17,8,3,2016,9,14642,2448,17090
3,17,8,3,2016,10,14325,2745,17070
3,17,8,3,2016,11,14067,3027,17094
3,17,8,3,2016,12,13938,3051,16989
3,17,8,3,2016,13,13966,3017,16983
3,17,8,3,2016,14,13268,2882,16150
3,17,8,3,2016,15,13501,2886,16387
3,17,8,3,2016,16,13693,2857,16550
3,17,8,3,2016,17,13522,2824,16346
3,17,8,3,2016,18,12756,2815,15571
3,17,8,3,2016,19,12913,2741,15654
3,17,8,3,2016,20,14228,2753,16981
3,17,8,3,2016,21,14017,2696,16713
3,17,8,3,2016,22,13312,2537,15849
3,17,8,3,2016,23,13125,2391,15516
3,17,8,3,2016,24,12771,2310,15081
1,18,8,3,2016,1,12687,2042,14729
1,18,8,3,2016,2,12572,1922,14494
1,18,8,3,2016,3,12615,1820,14435
1,18,8,3,2016,4,12850,1762,14612
1,18,8,3,2016,5,12909,1753,14662
1,18,8,3,2016,6,13371,1846,15217
1,18,8,3,2016,7,14091,1957,16048
1,18,8,3,2016,8,14893,2123,17016
1,18,8,3,2016,9,14964,2484,17448
1,18,8,3,2016,10,14914,2743,17657
1,18,8,3,2016,11,14706,2913,17619
1,18,8,3,2016,12,14741,2936,17677
1,18,8,3,2016,13,14011,2877,16888
1,18,8,3,2016,14,13691,2748,16439
1,18,8,3,2016,15,13986,2723,16709
1,18,8,3,2016,16,13830,2704,16534
1,18,8,3,2016,17,13452,2657,16109
1,18,8,3,2016,18,12031,2599,14630
1,18,8,3,2016,19,12281,2473,14754
1,18,8,3,2016,20,13497,2532,16029
1,18,8,3,2016,21,13530,2523,16053
1,18,8,3,2016,22,13003,2381,15384
1,18,8,3,2016,23,12864,2358,15222
1,18,8,3,2016,24,12704,2242,14946
1,19,8,3,2016,1,12726,2077,14803
1,19,8,3,2016,2,12572,1903,14475
1,19,8,3,2016,3,12606,1798,14404
1,19,8,3,2016,4,12787,1739,14526
1,19,8,3,2016,5,12826,1752,14578
1,19,8,3,2016,6,13415,1856,15271
1,19,8,3,2016,7,14295,2016,16311
1,19,8,3,2016,8,14952,2153,17105
1,19,8,3,2016,9,14896,2562,17458
1,19,8,3,2016,10,14613,2868,17481
1,19,8,3,2016,11,14490,3073,17563
1,19,8,3,2016,12,14488,3164,17652
1,19,8,3,2016,13,14019,3127,17146
1,19,8,3,2016,14,14027,2973,17000
1,19,8,3,2016,15,13901,2998,16899
1,19,8,3,2016,16,14003,2996,16999
1,19,8,3,2016,17,13655,2982,16637
1,19,8,3,2016,18,12683,2871,15554
1,19,8,3,2016,19,12729,2795,15524
1,19,8,3,2016,20,13984,2832,16816
1,19,8,3,2016,21,13847,2761,16608
1,19,8,3,2016,22,13386,2555,15941
1,19,8,3,2016,23,13099,2392,15491
1,19,8,3,2016,24,12852,2333,15185
2,20,8,3,2016,1,12645,2132,14777
2,20,8,3,2016,2,12678,1935,14613
2,20,8,3,2016,3,12726,1823,14550
2,20,8,3,2016,4,12740,1774,14514
2,20,8,3,2016,5,13028,1757,14784
2,20,8,3,2016,6,13633,1858,15491
2,20,8,3,2016,7,14496,1965,16461
2,20,8,3,2016,8,15224,2097,17322
2,20,8,3,2016,9,15128,2361,17489
2,20,8,3,2016,10,15120,2681,17800
2,20,8,3,2016,11,14901,2883,17784
2,20,8,3,2016,12,15047,2979,18026
2,20,8,3,2016,13,14438,2960,17398
2,20,8,3,2016,14,14245,2820,17065
2,20,8,3,2016,15,14489,2807,17296
2,20,8,3,2016,16,14464,2809,17272
2,20,8,3,2016,17,14206,2795,17002
2,20,8,3,2016,18,13085,2752,15837
2,20,8,3,2016,19,13315,2676,15991
2,20,8,3,2016,20,14262,2725,16988
2,20,8,3,2016,21,14076,2662,16738
2,20,8,3,2016,22,13471,2475,15946
2,20,8,3,2016,23,13319,2403,15722
2,20,8,3,2016,24,13279,2292,15571
2,21,8,3,2016,1,12912,2154,15066
2,21,8,3,2016,2,12924,1997,14921
2,21,8,3,2016,3,12893,1912,14805
2,21,8,3,2016,4,12969,1861,14830
2,21,8,3,2016,5,13377,1842,15219
2,21,8,3,2016,6,13266,1918,15184
2,21,8,3,2016,7,14408,1910,16318
2,21,8,3,2016,8,15296,1912,17208
2,21,8,3,2016,9,15181,2029,17210
2,21,8,3,2016,10,15233,2137,17370
2,21,8,3,2016,11,15517,2187,17704
2,21,8,3,2016,12,15719,2199,17918
2,21,8,3,2016,13,15219,2240,17459
2,21,8,3,2016,14,14922,2192,17114
2,21,8,3,2016,15,14830,2198,17028
2,21,8,3,2016,16,14852,2186,17038
2,21,8,3,2016,17,14163,2204,16367
2,21,8,3,2016,18,13076,2174,15250
2,21,8,3,2016,19,13329,2210,15539
2,21,8,3,2016,20,14386,2327,16713
2,21,8,3,2016,21,14091,2370,16461
2,21,8,3,2016,22,13635,2255,15890
2,21,8,3,2016,23,13583,2236,15819
2,21,8,3,2016,24,13096,2293,15390
1,22,8,3,2016,1,13516,2099,15615
1,22,8,3,2016,2,13010,1925,14936
1,22,8,3,2016,3,12944,1817,14761
1,22,8,3,2016,4,12974,1771,14745
1,22,8,3,2016,5,13287,1753,15040
1,22,8,3,2016,6,14005,1878,15883
1,22,8,3,2016,7,15345,2026,17371
1,22,8,3,2016,8,15613,2153,17766
1,22,8,3,2016,9,15760,2529,18289
1,22,8,3,2016,10,15876,2852,18728
1,22,8,3,2016,11,15816,3055,18871
1,22,8,3,2016,12,15619,3123,18742
1,22,8,3,2016,13,15577,3107,18684
1,22,8,3,2016,14,15044,2972,18016
1,22,8,3,2016,15,15070,3005,18075
1,22,8,3,2016,16,15443,2989,18432
1,22,8,3,2016,17,14636,2973,17609
1,22,8,3,2016,18,13478,2897,16375
1,22,8,3,2016,19,13416,2810,16226
1,22,8,3,2016,20,14513,2813,17326
1,22,8,3,2016,21,14592,2700,17292
1,22,8,3,2016,22,13664,2564,16228
1,22,8,3,2016,23,13686,2449,16135
1,22,8,3,2016,24,13222,2337,15559
1,23,8,3,2016,1,13492,2126,15618
1,23,8,3,2016,2,13582,1907,15489
1,23,8,3,2016,3,13192,1823,15015
1,23,8,3,2016,4,13586,1740,15326
1,23,8,3,2016,5,13824,1727,15551
1,23,8,3,2016,6,14473,1866,16339
1,23,8,3,2016,7,15303,2021,17324
1,23,8,3,2016,8,15784,2217,18001
1,23,8,3,2016,9,15834,2498,18332
1,23,8,3,2016,10,15805,2821,18626
1,23,8,3,2016,11,15751,3045,18796
1,23,8,3,2016,12,15925,3069,18994
1,23,8,3,2016,13,15350,3041,18391
1,23,8,3,2016,14,15261,2898,18159
1,23,8,3,2016,15,15638,2932,18570
1,23,8,3,2016,16,15440,2942,18382
1,23,8,3,2016,17,15137,2940,18077
1,23,8,3,2016,18,13618,2878,16496
1,23,8,3,2016,19,14030,2834,16864
1,23,8,3,2016,20,15233,2801,18034
1,23,8,3,2016,21,14807,2707,17514
1,23,8,3,2016,22,13968,2495,16463
1,23,8,3,2016,23,13743,2359,16102
1,23,8,3,2016,24,13631,2240,15871
1,24,8,3,2016,1,13816,2024,15840
1,24,8,3,2016,2,13406,1906,15312
1,24,8,3,2016,3,13180,1809,14989
1,24,8,3,2016,4,13140,1755,14895
1,24,8,3,2016,5,13317,1751,15068
1,24,8,3,2016,6,14393,1865,16258
1,24,8,3,2016,7,15135,2023,17158
1,24,8,3,2016,8,15573,2208,17781
1,24,8,3,2016,9,15946,2500,18446
1,24,8,3,2016,10,15616,2865,18481
1,24,8,3,2016,11,15855,3059,18914
1,24,8,3,2016,12,15977,3091,19068
1,24,8,3,2016,13,15256,3072,18328
1,24,8,3,2016,14,15788,2941,18729
1,24,8,3,2016,15,15199,2969,18168
1,24,8,3,2016,16,15401,2951,18352
1,24,8,3,2016,17,14984,2922,17906
1,24,8,3,2016,18,14270,2856,17126
1,24,8,3,2016,19,13812,2786,16598
1,24,8,3,2016,20,15171,2801,17972
1,24,8,3,2016,21,14813,2715,17528
1,24,8,3,2016,22,14469,2514,16983
1,24,8,3,2016,23,14001,2396,16397
1,24,8,3,2016,24,13832,2302,16134
1,25,8,3,2016,1,13735,2145,15880
1,25,8,3,2016,2,13389,1936,15325
1,25,8,3,2016,3,13501,1841,15342
1,25,8,3,2016,4,13519,1773,15292
1,25,8,3,2016,5,13807,1752,15559
1,25,8,3,2016,6,14244,1835,16079
1,25,8,3,2016,7,14915,1911,16826
1,25,8,3,2016,8,15595,2078,17673
1,25,8,3,2016,9,16028,2386,18414
1,25,8,3,2016,10,15988,2701,18689
1,25,8,3,2016,11,15517,2874,18391
1,25,8,3,2016,12,15630,2877,18507
1,25,8,3,2016,13,15454,2873,18327
1,25,8,3,2016,14,15380,2726,18106
1,25,8,3,2016,15,15424,2724,18148
1,25,8,3,2016,16,15466,2723,18189
1,25,8,3,2016,17,14765,2641,17406
1,25,8,3,2016,18,13697,2562,16259
1,25,8,3,2016,19,13262,2466,15728
1,25,8,3,2016,20,14741,2551,17292
1,25,8,3,2016,21,14276,2489,16765
1,25,8,3,2016,22,13926,2396,16322
1,25,8,3,2016,23,13441,2378,15819
1,25,8,3,2016,24,13663,2246,15909
1,26,8,3,2016,1,13347,2048,15395
1,26,8,3,2016,2,13535,1875,15410
1,26,8,3,2016,3,13913,1776,15689
1,26,8,3,2016,4,13436,1716,15152
1,26,8,3,2016,5,13687,1713,15400
1,26,8,3,2016,6,14574,1821,16395
1,26,8,3,2016,7,15259,2006,17265
1,26,8,3,2016,8,15734,2179,17913
1,26,8,3,2016,9,15936,2489,18425
1,26,8,3,2016,10,15710,2893,18603
1,26,8,3,2016,11,15847,3038,18885
1,26,8,3,2016,12,15627,3070,18697
1,26,8,3,2016,13,15477,3007,18484
1,26,8,3,2016,14,15407,2846,18253
1,26,8,3,2016,15,15379,2832,18211
1,26,8,3,2016,16,15440,2819,18259
1,26,8,3,2016,17,14746,2809,17555
1,26,8,3,2016,18,13614,2780,16394
1,26,8,3,2016,19,13465,2739,16204
1,26,8,3,2016,20,14444,2730,17174
1,26,8,3,2016,21,14051,2627,16678
1,26,8,3,2016,22,13730,2434,16164
1,26,8,3,2016,23,13411,2308,15719
1,26,8,3,2016,24,13245,2202,15447
2,27,8,3,2016,1,13486,1974,15460
2,27,8,3,2016,2,13428,1832,15260
2,27,8,3,2016,3,13565,1732,15297
2,27,8,3,2016,4,13603,1685,15288
2,27,8,3,2016,5,13642,1680,15322
2,27,8,3,2016,6,14097,1781,15878
2,27,8,3,2016,7,15049,1878,16927
2,27,8,3,2016,8,15746,1990,17736
2,27,8,3,2016,9,15766,2178,17944
2,27,8,3,2016,10,15809,2497,18306
2,27,8,3,2016,11,15879,2681,18560
2,27,8,3,2016,12,16063,2742,18805
2,27,8,3,2016,13,15452,2707,18159
2,27,8,3,2016,14,15706,2532,18238
2,27,8,3,2016,15,15555,2522,18077
2,27,8,3,2016,16,15557,2503,18060
2,27,8,3,2016,17,14835,2497,17332
2,27,8,3,2016,18,13688,2497,16185
2,27,8,3,2016,19,13800,2524,16324
2,27,8,3,2016,20,14645,2582,17227
2,27,8,3,2016,21,14408,2548,16956
2,27,8,3,2016,22,13869,2412,16281
2,27,8,3,2016,23,13587,2240,15827
2,27,8,3,2016,24,13319,2141,15460
2,28,8,3,2016,1,13402,1990,15392
2,28,8,3,2016,2,13241,1791,15032
2,28,8,3,2016,3,13231,1697,14928
2,28,8,3,2016,4,13119,1649,14768
2,28,8,3,2016,5,13119,1639,14758
2,28,8,3,2016,6,13574,1701,15275
2,28,8,3,2016,7,14497,1749,16246
2,28,8,3,2016,8,15091,1810,16901
2,28,8,3,2016,9,15176,1950,17126
2,28,8,3,2016,10,15551,2096,17647
2,28,8,3,2016,11,15633,2259,17892
2,28,8,3,2016,12,15736,2275,18011
2,28,8,3,2016,13,15571,2274,17845
2,28,8,3,2016,14,14862,2198,17060
2,28,8,3,2016,15,15170,2141,17311
2,28,8,3,2016,16,15410,2099,17509
2,28,8,3,2016,17,14634,2062,16696
2,28,8,3,2016,18,13304,2083,15387
2,28,8,3,2016,19,13386,2165,15551
2,28,8,3,2016,20,14437,2282,16719
2,28,8,3,2016,21,14127,2303,16430
2,28,8,3,2016,22,13535,2275,15810
2,28,8,3,2016,23,13360,2218,15578
2,28,8,3,2016,24,13342,2156,15498
1,29,8,3,2016,1,13283,1935,15218
1,29,8,3,2016,2,13074,1777,14851
1,29,8,3,2016,3,13153,1689,14842
1,29,8,3,2016,4,13074,1648,14722
1,29,8,3,2016,5,13374,1643,15017
1,29,8,3,2016,6,14019,1774,15793
1,29,8,3,2016,7,15044,2001,17045
1,29,8,3,2016,8,15598,2170,17768
1,29,8,3,2016,9,15748,2479,18227
1,29,8,3,2016,10,15783,2799,18582
1,29,8,3,2016,11,16045,2975,19020
1,29,8,3,2016,12,15766,3051,18817
1,29,8,3,2016,13,15611,3011,18622
1,29,8,3,2016,14,15715,2893,18608
1,29,8,3,2016,15,15751,2936,18687
1,29,8,3,2016,16,16028,2942,18970
1,29,8,3,2016,17,15373,2928,18301
1,29,8,3,2016,18,13853,2852,16705
1,29,8,3,2016,19,14059,2761,16820
1,29,8,3,2016,20,14797,2799,17596
1,29,8,3,2016,21,14727,2645,17372
1,29,8,3,2016,22,13906,2515,16421
1,29,8,3,2016,23,13774,2359,16133
1,29,8,3,2016,24,13626,2255,15881
1,30,8,3,2016,1,13663,2034,15697
1,30,8,3,2016,2,13375,1865,15240
1,30,8,3,2016,3,13412,1770,15182
1,30,8,3,2016,4,13411,1705,15116
1,30,8,3,2016,5,13750,1712,15462
1,30,8,3,2016,6,14318,1809,16127
1,30,8,3,2016,7,14862,2043,16906
1,30,8,3,2016,8,15769,2226,17995
1,30,8,3,2016,9,15912,2663,18575
1,30,8,3,2016,10,16019,2864,18883
1,30,8,3,2016,11,16034,3071,19105
1,30,8,3,2016,12,15855,3096,18951
1,30,8,3,2016,13,15865,3052,18917
1,30,8,3,2016,14,15280,2916,18196
1,30,8,3,2016,15,15667,2940,18607
1,30,8,3,2016,16,15681,2929,18610
1,30,8,3,2016,17,15250,2922,18172
1,30,8,3,2016,18,14251,2901,17152
1,30,8,3,2016,19,14226,2852,17078
1,30,8,3,2016,20,15062,2840,17902
1,30,8,3,2016,21,14699,2711,17410
1,30,8,3,2016,22,14260,2540,16800
1,30,8,3,2016,23,13776,2376,16152
1,30,8,3,2016,24,13460,2236,15696
1,31,8,3,2016,1,13635,2046,15681
1,31,8,3,2016,2,13454,1909,15363
1,31,8,3,2016,3,13016,1780,14796
1,31,8,3,2016,4,12863,1735,14598
1,31,8,3,2016,5,12732,1735,14467
1,31,8,3,2016,6,13484,1847,15331
1,31,8,3,2016,7,13899,2016,15915
1,31,8,3,2016,8,14707,2209,16916
1,31,8,3,2016,9,14833,2537,17370
1,31,8,3,2016,10,15207,2830,18037
1,31,8,3,2016,11,15150,3087,18237
1,31,8,3,2016,12,14969,3126,18095
1,31,8,3,2016,13,14887,3101,17988
1,31,8,3,2016,14,14786,2967,17753
1,31,8,3,2016,15,14749,2983,17732
1,31,8,3,2016,16,14959,2986,17945
1,31,8,3,2016,17,14314,2967,17281
1,31,8,3,2016,18,13236,2848,16084
1,31,8,3,2016,19,13467,2823,16290
1,31,8,3,2016,20,14419,2813,17232
1,31,8,3,2016,21,13902,2718,16620
1,31,8,3,2016,22,13803,2589,16392
1,31,8,3,2016,23,13299,2432,15731
1,31,8,3,2016,24,13332,2315,15647
1,1,9,3,2016,1,13023,2101,15124
1,1,9,3,2016,2,12654,1920,14574
1,1,9,3,2016,3,12559,1806,14365
1,1,9,3,2016,4,12664,1759,14423
1,1,9,3,2016,5,12493,1759,14252
1,1,9,3,2016,6,13188,1863,15051
1,1,9,3,2016,7,13877,2033,15910
1,1,9,3,2016,8,14480,2272,16752
1,1,9,3,2016,9,14623,2529,17152
1,1,9,3,2016,10,14941,2837,17778
1,1,9,3,2016,11,14663,3080,17743
1,1,9,3,2016,12,14525,3082,17607
1,1,9,3,2016,13,13778,3058,16836
1,1,9,3,2016,14,13437,2902,16339
1,1,9,3,2016,15,13562,2966,16528
1,1,9,3,2016,16,13729,2973,16702
1,1,9,3,2016,17,13437,2964,16401
1,1,9,3,2016,18,12277,2922,15199
1,1,9,3,2016,19,12784,2836,15620
1,1,9,3,2016,20,13892,2823,16715
1,1,9,3,2016,21,13592,2637,16229
1,1,9,3,2016,22,13135,2528,15663
1,1,9,3,2016,23,12856,2436,15292
1,1,9,3,2016,24,12736,2295,15031
1,2,9,3,2016,1,12773,2082,14855
1,2,9,3,2016,2,12545,1900,14445
1,2,9,3,2016,3,12301,1787,14088
1,2,9,3,2016,4,12314,1744,14058
1,2,9,3,2016,5,12511,1745,14256
1,2,9,3,2016,6,13265,1849,15114
1,2,9,3,2016,7,13895,2018,15913
1,2,9,3,2016,8,14392,2258,16650
1,2,9,3,2016,9,14478,2512,16990
1,2,9,3,2016,10,14137,2832,16969
1,2,9,3,2016,11,14040,3089,17129
1,2,9,3,2016,12,13583,3103,16686
1,2,9,3,2016,13,13608,3000,16608
1,2,9,3,2016,14,13359,2876,16235
1,2,9,3,2016,15,13439,2893,16332
1,2,9,3,2016,16,13609,2902,16511
1,2,9,3,2016,17,12894,2874,15768
1,2,9,3,2016,18,11837,2841,14678
1,2,9,3,2016,19,12652,2750,15402
1,2,9,3,2016,20,13685,2785,16470
1,2,9,3,2016,21,13568,2598,16166
1,2,9,3,2016,22,13145,2521,15666
1,2,9,3,2016,23,12718,2365,15083
1,2,9,3,2016,24,12719,2250,14969
2,3,9,3,2016,1,12733,2049,14782
2,3,9,3,2016,2,12386,1903,14289
2,3,9,3,2016,3,12213,1773,13986
2,3,9,3,2016,4,11976,1721,13697
2,3,9,3,2016,5,12431,1724,14155
2,3,9,3,2016,6,12936,1804,14740
2,3,9,3,2016,7,13936,1899,15835
2,3,9,3,2016,8,14506,2082,16588
2,3,9,3,2016,9,14466,2284,16750
2,3,9,3,2016,10,14714,2569,17283
2,3,9,3,2016,11,14714,2786,17500
2,3,9,3,2016,12,14569,2787,17356
2,3,9,3,2016,13,14281,2775,17056
2,3,9,3,2016,14,14173,2680,16853
2,3,9,3,2016,15,14243,2663,16906
2,3,9,3,2016,16,14421,2701,17122
2,3,9,3,2016,17,13793,2658,16451
2,3,9,3,2016,18,12869,2660,15529
2,3,9,3,2016,19,13159,2636,15795
2,3,9,3,2016,20,14272,2580,16852
2,3,9,3,2016,21,13920,2527,16447
2,3,9,3,2016,22,13450,2428,15878
2,3,9,3,2016,23,13114,2337,15451
2,3,9,3,2016,24,13011,2247,15258
2,4,9,3,2016,1,12893,2032,14925
2,4,9,3,2016,2,12512,1882,14394
2,4,9,3,2016,3,12517,1774,14291
2,4,9,3,2016,4,12328,1714,14042
2,4,9,3,2016,5,12723,1700,14423
2,4,9,3,2016,6,13416,1762,15178
2,4,9,3,2016,7,13804,1788,15592
2,4,9,3,2016,8,14635,1839,16474
2,4,9,3,2016,9,14934,1998,16932
2,4,9,3,2016,10,14825,2122,16947
2,4,9,3,2016,11,14927,2223,17150
2,4,9,3,2016,12,14893,2247,17140
2,4,9,3,2016,13,14521,2286,16807
2,4,9,3,2016,14,14362,2180,16542
2,4,9,3,2016,15,14455,2150,16605
2,4,9,3,2016,16,14370,2114,16484
2,4,9,3,2016,17,13842,2092,15934
2,4,9,3,2016,18,12948,2075,15023
2,4,9,3,2016,19,13062,2135,15197
2,4,9,3,2016,20,13792,2289,16081
2,4,9,3,2016,21,13642,2306,15948
2,4,9,3,2016,22,13328,2288,15616
2,4,9,3,2016,23,12860,2276,15136
2,4,9,3,2016,24,12937,2183,15120
3,5,9,3,2016,1,12779,2039,14818
3,5,9,3,2016,2,12598,1893,14491
3,5,9,3,2016,3,12554,1792,14346
3,5,9,3,2016,4,12497,1734,14231
3,5,9,3,2016,5,12676,1729,14405
3,5,9,3,2016,6,13199,1802,15001
3,5,9,3,2016,7,14151,1854,16005
3,5,9,3,2016,8,14722,1913,16635
3,5,9,3,2016,9,14734,2043,16777
3,5,9,3,2016,10,14388,2158,16546
3,5,9,3,2016,11,13933,2235,16168
3,5,9,3,2016,12,14188,2242,16430
3,5,9,3,2016,13,13690,2254,15944
3,5,9,3,2016,14,13658,2156,15814
3,5,9,3,2016,15,13815,2163,15978
3,5,9,3,2016,16,13769,2157,15926
3,5,9,3,2016,17,13441,2135,15576
3,5,9,3,2016,18,12203,2157,14360
3,5,9,3,2016,19,12237,2096,14333
3,5,9,3,2016,20,13481,2304,15785
3,5,9,3,2016,21,13049,2354,15403
3,5,9,3,2016,22,12557,2327,14884
3,5,9,3,2016,23,12443,2309,14752
3,5,9,3,2016,24,12570,2223,14793
1,6,9,3,2016,1,12506,2043,14549
1,6,9,3,2016,2,12824,1885,14709
1,6,9,3,2016,3,12706,1782,14488
1,6,9,3,2016,4,12637,1733,14370
1,6,9,3,2016,5,12900,1713,14613
1,6,9,3,2016,6,13798,1806,15604
1,6,9,3,2016,7,15277,1897,17174
1,6,9,3,2016,8,15928,2070,17998
1,6,9,3,2016,9,15794,2523,18317
1,6,9,3,2016,10,16109,2772,18881
1,6,9,3,2016,11,16184,3019,19203
1,6,9,3,2016,12,16305,3029,19334
1,6,9,3,2016,13,15970,2997,18967
1,6,9,3,2016,14,15891,2888,18779
1,6,9,3,2016,15,15868,2900,18768
1,6,9,3,2016,16,16224,2892,19116
1,6,9,3,2016,17,15290,2879,18169
1,6,9,3,2016,18,14045,2776,16821
1,6,9,3,2016,19,13714,2706,16420
1,6,9,3,2016,20,15015,2740,17755
1,6,9,3,2016,21,14801,2671,17472
1,6,9,3,2016,22,14180,2500,16680
1,6,9,3,2016,23,13979,2425,16404
1,6,9,3,2016,24,13942,2331,16272
1,7,9,3,2016,1,14163,2119,16282
1,7,9,3,2016,2,13809,1961,15770
1,7,9,3,2016,3,13785,1882,15667
1,7,9,3,2016,4,13798,1793,15591
1,7,9,3,2016,5,13839,1795,15634
1,7,9,3,2016,6,14710,1872,16582
1,7,9,3,2016,7,15829,1956,17785
1,7,9,3,2016,8,16477,2131,18608
1,7,9,3,2016,9,16865,2434,19299
1,7,9,3,2016,10,16674,2804,19478
1,7,9,3,2016,11,16834,2974,19808
1,7,9,3,2016,12,16656,3048,19704
1,7,9,3,2016,13,16478,3039,19517
1,7,9,3,2016,14,16340,2860,19200
1,7,9,3,2016,15,16289,2904,19193
1,7,9,3,2016,16,16403,2907,19310
1,7,9,3,2016,17,15640,2875,18515
1,7,9,3,2016,18,14457,2829,17286
1,7,9,3,2016,19,14658,2769,17427
1,7,9,3,2016,20,15338,2799,18137
1,7,9,3,2016,21,14651,2767,17418
1,7,9,3,2016,22,14317,2638,16955
1,7,9,3,2016,23,14182,2474,16656
1,7,9,3,2016,24,14046,2330,16376
1,8,9,3,2016,1,14305,2125,16430
1,8,9,3,2016,2,14126,1958,16084
1,8,9,3,2016,3,13770,1854,15624
1,8,9,3,2016,4,14158,1787,15945
1,8,9,3,2016,5,14051,1783,15834
1,8,9,3,2016,6,15332,1870,17202
1,8,9,3,2016,7,16304,1959,18263
1,8,9,3,2016,8,16922,2101,19023
1,8,9,3,2016,9,17025,2500,19525
1,8,9,3,2016,10,17089,2783,19872
1,8,9,3,2016,11,16517,3006,19523
1,8,9,3,2016,12,16395,3010,19405
1,8,9,3,2016,13,16537,2995,19532
1,8,9,3,2016,14,16417,2841,19258
1,8,9,3,2016,15,16538,2888,19426
1,8,9,3,2016,16,16635,2899,19534
1,8,9,3,2016,17,16457,2882,19339
1,8,9,3,2016,18,16263,2843,19106
1,8,9,3,2016,19,16818,2774,19592
1,8,9,3,2016,20,17319,2810,20129
1,8,9,3,2016,21,16712,2704,19416
1,8,9,3,2016,22,15796,2481,18277
1,8,9,3,2016,23,15658,2364,18022
1,8,9,3,2016,24,14927,2259,17186
1,9,9,3,2016,1,14378,2113,16491
1,9,9,3,2016,2,14492,1936,16428
1,9,9,3,2016,3,14390,1835,16226
1,9,9,3,2016,4,14402,1769,16171
1,9,9,3,2016,5,14246,1767,16014
1,9,9,3,2016,6,15111,1835,16946
1,9,9,3,2016,7,16124,1941,18065
1,9,9,3,2016,8,16906,2117,19023
1,9,9,3,2016,9,17368,2415,19783
1,9,9,3,2016,10,17095,2814,19909
1,9,9,3,2016,11,16835,3022,19857
1,9,9,3,2016,12,16378,3056,19434
1,9,9,3,2016,13,16628,3053,19681
1,9,9,3,2016,14,16426,2860,19286
1,9,9,3,2016,15,16625,2881,19506
1,9,9,3,2016,16,16791,2862,19653
1,9,9,3,2016,17,16427,2842,19269
1,9,9,3,2016,18,16389,2771,19160
1,9,9,3,2016,19,17004,2765,19769
1,9,9,3,2016,20,17279,2726,20005
1,9,9,3,2016,21,16831,2620,19451
1,9,9,3,2016,22,16014,2499,18513
1,9,9,3,2016,23,15609,2365,17974
1,9,9,3,2016,24,14952,2221,17173
2,10,9,3,2016,1,14763,2066,16829
2,10,9,3,2016,2,14414,1905,16319
2,10,9,3,2016,3,14331,1803,16134
2,10,9,3,2016,4,14417,1741,16158
2,10,9,3,2016,5,14689,1732,16421
2,10,9,3,2016,6,15341,1800,17141
2,10,9,3,2016,7,16024,1848,17872
2,10,9,3,2016,8,16971,1910,18881
2,10,9,3,2016,9,17346,2169,19515
2,10,9,3,2016,10,17618,2391,20009
2,10,9,3,2016,11,17161,2708,19869
2,10,9,3,2016,12,16991,2732,19723
2,10,9,3,2016,13,16890,2708,19598
2,10,9,3,2016,14,16920,2587,19507
2,10,9,3,2016,15,16888,2562,19450
2,10,9,3,2016,16,16889,2563,19452
2,10,9,3,2016,17,16806,2522,19328
2,10,9,3,2016,18,16789,2499,19288
2,10,9,3,2016,19,17426,2537,19963
2,10,9,3,2016,20,17778,2639,20417
2,10,9,3,2016,21,17096,2557,19653
2,10,9,3,2016,22,16206,2458,18664
2,10,9,3,2016,23,15417,2328,17745
2,10,9,3,2016,24,14959,2248,17207
2,11,9,3,2016,1,14310,2111,16421
2,11,9,3,2016,2,14336,1910,16246
2,11,9,3,2016,3,13998,1839,15837
2,11,9,3,2016,4,14127,1769,15896
2,11,9,3,2016,5,14186,1756,15942
2,11,9,3,2016,6,14955,1807,16762
2,11,9,3,2016,7,15900,1804,17704
2,11,9,3,2016,8,16191,1852,18043
2,11,9,3,2016,9,17068,1955,19023
2,11,9,3,2016,10,17101,2118,19219
2,11,9,3,2016,11,16877,2237,19114
2,11,9,3,2016,12,16394,2285,18679
2,11,9,3,2016,13,16466,2221,18687
2,11,9,3,2016,14,16441,2159,18600
2,11,9,3,2016,15,16568,2106,18674
2,11,9,3,2016,16,16314,2088,18402
2,11,9,3,2016,17,16409,2062,18471
2,11,9,3,2016,18,16532,2043,18575
2,11,9,3,2016,19,16858,2155,19013
2,11,9,3,2016,20,17437,2329,19766
2,11,9,3,2016,21,16897,2349,19246
2,11,9,3,2016,22,15809,2329,18138
2,11,9,3,2016,23,15641,2324,17965
2,11,9,3,2016,24,15096,2259,17355
1,12,9,3,2016,1,14502,2094,16596
1,12,9,3,2016,2,14320,1893,16213
1,12,9,3,2016,3,14283,1805,16088
1,12,9,3,2016,4,14088,1741,15829
1,12,9,3,2016,5,14644,1734,16378
1,12,9,3,2016,6,14516,1825,16341
1,12,9,3,2016,7,15806,1947,17753
1,12,9,3,2016,8,17074,2099,19173
1,12,9,3,2016,9,16971,2521,19492
1,12,9,3,2016,10,17553,2781,20334
1,12,9,3,2016,11,17133,3019,20152
1,12,9,3,2016,12,17258,3025,20283
1,12,9,3,2016,13,17084,2982,20066
1,12,9,3,2016,14,17106,2885,19991
1,12,9,3,2016,15,17287,2923,20210
1,12,9,3,2016,16,16938,2927,19865
1,12,9,3,2016,17,17381,2906,20287
1,12,9,3,2016,18,17201,2850,20051
1,12,9,3,2016,19,17735,2819,20554
1,12,9,3,2016,20,17881,2833,20714
1,12,9,3,2016,21,17176,2678,19854
1,12,9,3,2016,22,16591,2534,19125
1,12,9,3,2016,23,15761,2453,18214
1,12,9,3,2016,24,14820,2334,17154
3,13,9,3,2016,1,14336,2192,16528
3,13,9,3,2016,2,14135,1996,16131
3,13,9,3,2016,3,13941,1891,15832
3,13,9,3,2016,4,14060,1822,15882
3,13,9,3,2016,5,13937,1810,15747
3,13,9,3,2016,6,14987,1879,16866
3,13,9,3,2016,7,15910,2002,17912
3,13,9,3,2016,8,16880,2113,18993
3,13,9,3,2016,9,17023,2408,19431
3,13,9,3,2016,10,17305,2630,19935
3,13,9,3,2016,11,16824,2829,19653
3,13,9,3,2016,12,16505,2837,19342
3,13,9,3,2016,13,16388,2755,19143
3,13,9,3,2016,14,16494,2683,19177
3,13,9,3,2016,15,16155,2685,18840
3,13,9,3,2016,16,16391,2702,19093
3,13,9,3,2016,17,16219,2706,18925
3,13,9,3,2016,18,16266,2647,18913
3,13,9,3,2016,19,16615,2630,19245
3,13,9,3,2016,20,17232,2721,19953
3,13,9,3,2016,21,16372,2632,19004
3,13,9,3,2016,22,15601,2502,18103
3,13,9,3,2016,23,15193,2431,17624
3,13,9,3,2016,24,14274,2313,16587
1,14,9,3,2016,1,13592,2188,15780
1,14,9,3,2016,2,13428,1971,15399
1,14,9,3,2016,3,13262,1900,15162
1,14,9,3,2016,4,12973,1838,14811
1,14,9,3,2016,5,12975,1827,14802
1,14,9,3,2016,6,13740,1894,15634
1,14,9,3,2016,7,14498,2056,16554
1,14,9,3,2016,8,15442,2148,17590
1,14,9,3,2016,9,15383,2524,17907
1,14,9,3,2016,10,15687,2827,18514
1,14,9,3,2016,11,15479,3057,18536
1,14,9,3,2016,12,15032,3081,18113
1,14,9,3,2016,13,15127,3055,18182
1,14,9,3,2016,14,14930,2946,17876
1,14,9,3,2016,15,14304,2942,17246
1,14,9,3,2016,16,14787,2923,17710
1,14,9,3,2016,17,14244,2923,17167
1,14,9,3,2016,18,14211,2891,17102
1,14,9,3,2016,19,15207,2834,18041
1,14,9,3,2016,20,15454,2871,18325
1,14,9,3,2016,21,14534,2720,17254
1,14,9,3,2016,22,13973,2620,16593
1,14,9,3,2016,23,12997,2500,15497
1,14,9,3,2016,24,12511,2454,14965
1,15,9,3,2016,1,12266,2230,14496
1,15,9,3,2016,2,12029,2092,14121
1,15,9,3,2016,3,11896,1974,13870
1,15,9,3,2016,4,11943,1903,13846
1,15,9,3,2016,5,11695,1882,13577
1,15,9,3,2016,6,12289,1946,14235
1,15,9,3,2016,7,13157,1999,15156
1,15,9,3,2016,8,13491,2181,15672
1,15,9,3,2016,9,13605,2397,16002
1,15,9,3,2016,10,13616,2746,16362
1,15,9,3,2016,11,13514,2804,16318
1,15,9,3,2016,12,13160,2810,15970
1,15,9,3,2016,13,12880,2772,15652
1,15,9,3,2016,14,12604,2629,15233
1,15,9,3,2016,15,12548,2523,15071
1,15,9,3,2016,16,12435,2407,14842
1,15,9,3,2016,17,12078,2296,14374
1,15,9,3,2016,18,12051,2218,14269
1,15,9,3,2016,19,12597,2257,14854
1,15,9,3,2016,20,12922,2299,15221
1,15,9,3,2016,21,12579,2273,14852
1,15,9,3,2016,22,12094,2243,14337
1,15,9,3,2016,23,11613,2179,13792
1,15,9,3,2016,24,11461,2127,13588
1,16,9,3,2016,1,10659,1969,12628
1,16,9,3,2016,2,10580,1854,12434
1,16,9,3,2016,3,10405,1742,12147
1,16,9,3,2016,4,10532,1698,12230
1,16,9,3,2016,5,10758,1696,12454
1,16,9,3,2016,6,11119,1811,12930
1,16,9,3,2016,7,12100,1950,14050
1,16,9,3,2016,8,12240,2159,14399
1,16,9,3,2016,9,12404,2411,14815
1,16,9,3,2016,10,13055,2717,15772
1,16,9,3,2016,11,12661,2950,15611
1,16,9,3,2016,12,12656,2991,15647
1,16,9,3,2016,13,11939,2963,14902
1,16,9,3,2016,14,12085,2841,14926
1,16,9,3,2016,15,11978,2825,14803
1,16,9,3,2016,16,11954,2825,14779
1,16,9,3,2016,17,11738,2823,14561
1,16,9,3,2016,18,12283,2812,15095
1,16,9,3,2016,19,13179,2816,15995
1,16,9,3,2016,20,14044,2789,16833
1,16,9,3,2016,21,13708,2627,16335
1,16,9,3,2016,22,13194,2483,15677
1,16,9,3,2016,23,12400,2395,14795
1,16,9,3,2016,24,11714,2278,13992
2,17,9,3,2016,1,11284,2060,13344
2,17,9,3,2016,2,10775,1864,12639
2,17,9,3,2016,3,10487,1740,12227
2,17,9,3,2016,4,10379,1690,12069
2,17,9,3,2016,5,10484,1688,12172
2,17,9,3,2016,6,11242,1762,13004
2,17,9,3,2016,7,11301,1889,13190
2,17,9,3,2016,8,12077,2001,14078
2,17,9,3,2016,9,11644,2287,13931
2,17,9,3,2016,10,12123,2489,14612
2,17,9,3,2016,11,11714,2765,14479
2,17,9,3,2016,12,11771,2805,14576
2,17,9,3,2016,13,11556,2796,14352
2,17,9,3,2016,14,11353,2679,14032
2,17,9,3,2016,15,11318,2657,13975
2,17,9,3,2016,16,11349,2599,13948
2,17,9,3,2016,17,11597,2563,14160
2,17,9,3,2016,18,12083,2548,14631
2,17,9,3,2016,19,13150,2612,15762
2,17,9,3,2016,20,13623,2662,16285
2,17,9,3,2016,21,13407,2522,15929
2,17,9,3,2016,22,12872,2400,15272
2,17,9,3,2016,23,11967,2226,14193
2,17,9,3,2016,24,11543,2134,13677
2,18,9,3,2016,1,10947,1981,12928
2,18,9,3,2016,2,11030,1807,12837
2,18,9,3,2016,3,10800,1729,12529
2,18,9,3,2016,4,10728,1673,12401
2,18,9,3,2016,5,10830,1661,12491
2,18,9,3,2016,6,11315,1726,13041
2,18,9,3,2016,7,11573,1765,13338
2,18,9,3,2016,8,12162,1833,13995
2,18,9,3,2016,9,12557,1995,14552
2,18,9,3,2016,10,12661,2098,14759
2,18,9,3,2016,11,12070,2272,14342
2,18,9,3,2016,12,11950,2323,14273
2,18,9,3,2016,13,11772,2267,14039
2,18,9,3,2016,14,11161,2197,13358
2,18,9,3,2016,15,11274,2108,13382
2,18,9,3,2016,16,10953,2052,13005
2,18,9,3,2016,17,11291,2021,13312
2,18,9,3,2016,18,11639,2065,13704
2,18,9,3,2016,19,12771,2154,14925
2,18,9,3,2016,20,13730,2231,15961
2,18,9,3,2016,21,13079,2199,15278
2,18,9,3,2016,22,12442,2166,14608
2,18,9,3,2016,23,11973,2091,14064
2,18,9,3,2016,24,11374,2038,13412
1,19,9,3,2016,1,11144,1847,12991
1,19,9,3,2016,2,10930,1709,12639
1,19,9,3,2016,3,10912,1634,12546
1,19,9,3,2016,4,10816,1592,12408
1,19,9,3,2016,5,11106,1613,12719
1,19,9,3,2016,6,11891,1741,13632
1,19,9,3,2016,7,12663,1908,14571
1,19,9,3,2016,8,12895,2129,15024
1,19,9,3,2016,9,13008,2409,15417
1,19,9,3,2016,10,13115,2753,15868
1,19,9,3,2016,11,12662,2981,15643
1,19,9,3,2016,12,12127,2982,15109
1,19,9,3,2016,13,11732,2897,14629
1,19,9,3,2016,14,11648,2803,14451
1,19,9,3,2016,15,11791,2825,14616
1,19,9,3,2016,16,11741,2806,14547
1,19,9,3,2016,17,11796,2765,14561
1,19,9,3,2016,18,12365,2737,15102
1,19,9,3,2016,19,13468,2732,16200
1,19,9,3,2016,20,14059,2739,16798
1,19,9,3,2016,21,13557,2585,16142
1,19,9,3,2016,22,13224,2427,15651
1,19,9,3,2016,23,12514,2276,14790
1,19,9,3,2016,24,11821,2077,13898
1,20,9,3,2016,1,11605,1894,13499
1,20,9,3,2016,2,11434,1713,13147
1,20,9,3,2016,3,11487,1650,13137
1,20,9,3,2016,4,11385,1603,12988
1,20,9,3,2016,5,11367,1625,12992
1,20,9,3,2016,6,12304,1749,14053
1,20,9,3,2016,7,12774,1940,14714
1,20,9,3,2016,8,13276,2124,15400
1,20,9,3,2016,9,13578,2449,16027
1,20,9,3,2016,10,13490,2730,16220
1,20,9,3,2016,11,12914,2913,15827
1,20,9,3,2016,12,12590,2912,15502
1,20,9,3,2016,13,11957,2838,14795
1,20,9,3,2016,14,11848,2679,14527
1,20,9,3,2016,15,11966,2651,14617
1,20,9,3,2016,16,11881,2628,14509
1,20,9,3,2016,17,12220,2615,14835
1,20,9,3,2016,18,12262,2609,14871
1,20,9,3,2016,19,13637,2621,16258
1,20,9,3,2016,20,14095,2595,16690
1,20,9,3,2016,21,13547,2475,16022
1,20,9,3,2016,22,12959,2346,15305
1,20,9,3,2016,23,12237,2139,14376
1,20,9,3,2016,24,11775,2012,13787
1,21,9,3,2016,1,11078,1824,12902
1,21,9,3,2016,2,10971,1658,12629
1,21,9,3,2016,3,10863,1590,12453
1,21,9,3,2016,4,10936,1560,12496
1,21,9,3,2016,5,11239,1568,12807
1,21,9,3,2016,6,11924,1686,13610
1,21,9,3,2016,7,12988,1862,14850
1,21,9,3,2016,8,13233,2066,15299
1,21,9,3,2016,9,13559,2302,15861
1,21,9,3,2016,10,13559,2690,16249
1,21,9,3,2016,11,13030,2819,15849
1,21,9,3,2016,12,12695,2835,15530
1,21,9,3,2016,13,12355,2801,15156
1,21,9,3,2016,14,12249,2674,14923
1,21,9,3,2016,15,12267,2667,14934
1,21,9,3,2016,16,12547,2640,15187
1,21,9,3,2016,17,12218,2617,14835
1,21,9,3,2016,18,12943,2613,15556
1,21,9,3,2016,19,13883,2677,16560
1,21,9,3,2016,20,14273,2665,16938
1,21,9,3,2016,21,13719,2569,16288
1,21,9,3,2016,22,12967,2373,15340
1,21,9,3,2016,23,12519,2239,14758
1,21,9,3,2016,24,11750,2022,13772
1,22,9,3,2016,1,11225,1832,13057
1,22,9,3,2016,2,11040,1654,12694
1,22,9,3,2016,3,10948,1593,12541
1,22,9,3,2016,4,10991,1553,12544
1,22,9,3,2016,5,11171,1562,12733
1,22,9,3,2016,6,11809,1698,13507
1,22,9,3,2016,7,12434,1816,14250
1,22,9,3,2016,8,12682,2080,14762
1,22,9,3,2016,9,13014,2304,15318
1,22,9,3,2016,10,13019,2710,15729
1,22,9,3,2016,11,12797,2868,15665
1,22,9,3,2016,12,12353,2957,15310
1,22,9,3,2016,13,11971,2930,14901
1,22,9,3,2016,14,11802,2775,14577
1,22,9,3,2016,15,11980,2779,14759
1,22,9,3,2016,16,11637,2766,14403
1,22,9,3,2016,17,11979,2742,14721
1,22,9,3,2016,18,12270,2730,15000
1,22,9,3,2016,19,13517,2728,16245
1,22,9,3,2016,20,14077,2743,16820
1,22,9,3,2016,21,13597,2605,16202
1,22,9,3,2016,22,13398,2435,15833
1,22,9,3,2016,23,12517,2245,14762
1,22,9,3,2016,24,11982,2087,14069
1,23,9,3,2016,1,11683,1842,13525
1,23,9,3,2016,2,11047,1729,12776
1,23,9,3,2016,3,11085,1644,12729
1,23,9,3,2016,4,10937,1605,12542
1,23,9,3,2016,5,11309,1615,12924
1,23,9,3,2016,6,11778,1718,13496
1,23,9,3,2016,7,12507,1907,14414
1,23,9,3,2016,8,12613,2188,14801
1,23,9,3,2016,9,13031,2444,15475
1,23,9,3,2016,10,13302,2710,16012
1,23,9,3,2016,11,12867,2977,15844
1,23,9,3,2016,12,11946,3005,14951
1,23,9,3,2016,13,11627,2950,14577
1,23,9,3,2016,14,11299,2799,14098
1,23,9,3,2016,15,11312,2828,14140
1,23,9,3,2016,16,11502,2816,14318
1,23,9,3,2016,17,11450,2795,14245
1,23,9,3,2016,18,11788,2772,14560
1,23,9,3,2016,19,13378,2755,16133
1,23,9,3,2016,20,13493,2746,16239
1,23,9,3,2016,21,12802,2625,15427
1,23,9,3,2016,22,12445,2438,14883
1,23,9,3,2016,23,11701,2266,13967
1,23,9,3,2016,24,11355,2120,13475
2,24,9,3,2016,1,10746,1911,12657
2,24,9,3,2016,2,10515,1725,12240
2,24,9,3,2016,3,10463,1653,12116
2,24,9,3,2016,4,10250,1607,11857
2,24,9,3,2016,5,10527,1595,12122
2,24,9,3,2016,6,10852,1680,12532
2,24,9,3,2016,7,11825,1796,13621
2,24,9,3,2016,8,12013,1965,13978
2,24,9,3,2016,9,12455,2149,14604
2,24,9,3,2016,10,12677,2373,15050
2,24,9,3,2016,11,12516,2666,15182
2,24,9,3,2016,12,12293,2720,15013
2,24,9,3,2016,13,11812,2709,14521
2,24,9,3,2016,14,11495,2571,14066
2,24,9,3,2016,15,11762,2566,14328
2,24,9,3,2016,16,11705,2551,14256
2,24,9,3,2016,17,12021,2536,14557
2,24,9,3,2016,18,12157,2531,14688
2,24,9,3,2016,19,13491,2580,16071
2,24,9,3,2016,20,13629,2687,16316
2,24,9,3,2016,21,13579,2562,16141
2,24,9,3,2016,22,12834,2373,15207
2,24,9,3,2016,23,11975,2254,14229
2,24,9,3,2016,24,11310,2133,13443
2,25,9,3,2016,1,11260,1933,13193
2,25,9,3,2016,2,10869,1796,12665
2,25,9,3,2016,3,10834,1708,12542
2,25,9,3,2016,4,10921,1658,12579
2,25,9,3,2016,5,10956,1637,12593
2,25,9,3,2016,6,11443,1692,13135
2,25,9,3,2016,7,11721,1741,13462
2,25,9,3,2016,8,12114,1814,13928
2,25,9,3,2016,9,12372,1922,14294
2,25,9,3,2016,10,12603,2119,14722
2,25,9,3,2016,11,12163,2195,14358
2,25,9,3,2016,12,12002,2195,14197
2,25,9,3,2016,13,11587,2196,13783
2,25,9,3,2016,14,11389,2131,13520
2,25,9,3,2016,15,11372,2081,13453
2,25,9,3,2016,16,11394,2043,13437
2,25,9,3,2016,17,11400,2024,13424
2,25,9,3,2016,18,11828,2031,13859
2,25,9,3,2016,19,13112,2203,15315
2,25,9,3,2016,20,13515,2287,15802
2,25,9,3,2016,21,13040,2269,15309
2,25,9,3,2016,22,12553,2238,14791
2,25,9,3,2016,23,11831,2199,14030
2,25,9,3,2016,24,11174,2075,13249
1,26,9,3,2016,1,10876,1885,12761
1,26,9,3,2016,2,10639,1752,12391
1,26,9,3,2016,3,10775,1630,12405
1,26,9,3,2016,4,10719,1590,12309
1,26,9,3,2016,5,11039,1591,12630
1,26,9,3,2016,6,11668,1767,13435
1,26,9,3,2016,7,12219,1996,14215
1,26,9,3,2016,8,12839,2148,14987
1,26,9,3,2016,9,13170,2433,15603
1,26,9,3,2016,10,12896,2833,15729
1,26,9,3,2016,11,12952,2993,15945
1,26,9,3,2016,12,12416,3030,15446
1,26,9,3,2016,13,11931,2962,14893
1,26,9,3,2016,14,11986,2845,14831
1,26,9,3,2016,15,12067,2862,14929
1,26,9,3,2016,16,12170,2874,15044
1,26,9,3,2016,17,12299,2850,15149
1,26,9,3,2016,18,12517,2793,15310
1,26,9,3,2016,19,13491,2744,16235
1,26,9,3,2016,20,14281,2767,17048
1,26,9,3,2016,21,13675,2673,16348
1,26,9,3,2016,22,13281,2493,15774
1,26,9,3,2016,23,12549,2374,14923
1,26,9,3,2016,24,11711,2220,13931
1,27,9,3,2016,1,11109,2032,13141
1,27,9,3,2016,2,10966,1865,12831
1,27,9,3,2016,3,10829,1763,12592
1,27,9,3,2016,4,10977,1716,12693
1,27,9,3,2016,5,11260,1712,12972
1,27,9,3,2016,6,11868,1804,13672
1,27,9,3,2016,7,12640,2017,14657
1,27,9,3,2016,8,13152,2167,15319
1,27,9,3,2016,9,13200,2578,15778
1,27,9,3,2016,10,13405,2816,16221
1,27,9,3,2016,11,13001,3087,16088
1,27,9,3,2016,12,12772,3101,15873
1,27,9,3,2016,13,12301,3022,15323
1,27,9,3,2016,14,12222,2882,15104
1,27,9,3,2016,15,12345,2868,15213
1,27,9,3,2016,16,12296,2879,15175
1,27,9,3,2016,17,12579,2864,15443
1,27,9,3,2016,18,12819,2852,15671
1,27,9,3,2016,19,13872,2844,16716
1,27,9,3,2016,20,14525,2841,17366
1,27,9,3,2016,21,14020,2664,16684
1,27,9,3,2016,22,13449,2534,15983
1,27,9,3,2016,23,12622,2380,15002
1,27,9,3,2016,24,12171,2267,14438
1,28,9,3,2016,1,11616,2070,13686
1,28,9,3,2016,2,11398,1847,13245
1,28,9,3,2016,3,11436,1759,13195
1,28,9,3,2016,4,11216,1715,12931
1,28,9,3,2016,5,11439,1711,13150
1,28,9,3,2016,6,12289,1780,14069
1,28,9,3,2016,7,13006,2013,15019
1,28,9,3,2016,8,13458,2142,15600
1,28,9,3,2016,9,13535,2531,16066
1,28,9,3,2016,10,13644,2825,16469
1,28,9,3,2016,11,13130,3084,16214
1,28,9,3,2016,12,12763,3100,15863
1,28,9,3,2016,13,12487,3065,15552
1,28,9,3,2016,14,12542,2933,15475
1,28,9,3,2016,15,12695,2939,15634
1,28,9,3,2016,16,12787,2930,15717
1,28,9,3,2016,17,12735,2919,15654
1,28,9,3,2016,18,13071,2846,15917
1,28,9,3,2016,19,14236,2852,17088
1,28,9,3,2016,20,14630,2838,17468
1,28,9,3,2016,21,14184,2724,16908
1,28,9,3,2016,22,13559,2526,16085
1,28,9,3,2016,23,12952,2424,15376
1,28,9,3,2016,24,12161,2249,14410
1,29,9,3,2016,1,11623,2054,13677
1,29,9,3,2016,2,11477,1880,13357
1,29,9,3,2016,3,11345,1779,13124
1,29,9,3,2016,4,11549,1721,13270
1,29,9,3,2016,5,11894,1734,13628
1,29,9,3,2016,6,12437,1828,14265
1,29,9,3,2016,7,12918,2005,14923
1,29,9,3,2016,8,13423,2241,15664
1,29,9,3,2016,9,13599,2482,16081
1,29,9,3,2016,10,13680,2883,16563
1,29,9,3,2016,11,13263,3004,16267
1,29,9,3,2016,12,13084,3067,16151
1,29,9,3,2016,13,12505,3031,15536
1,29,9,3,2016,14,12618,2898,15516
1,29,9,3,2016,15,12542,2935,15477
1,29,9,3,2016,16,12688,2936,15624
1,29,9,3,2016,17,12809,2899,15708
1,29,9,3,2016,18,13148,2841,15989
1,29,9,3,2016,19,14173,2837,17010
1,29,9,3,2016,20,14741,2839,17580
1,29,9,3,2016,21,14366,2708,17074
1,29,9,3,2016,22,13836,2522,16358
1,29,9,3,2016,23,13151,2407,15558
1,29,9,3,2016,24,12316,2245,14561
1,30,9,3,2016,1,11866,2066,13932
1,30,9,3,2016,2,11514,1860,13374
1,30,9,3,2016,3,11490,1793,13283
1,30,9,3,2016,4,11397,1737,13134
1,30,9,3,2016,5,11991,1722,13713
1,30,9,3,2016,6,12292,1833,14125
1,30,9,3,2016,7,13117,2014,15131
1,30,9,3,2016,8,13545,2133,15678
1,30,9,3,2016,9,13579,2471,16050
1,30,9,3,2016,10,13722,2772,16494
1,30,9,3,2016,11,13182,3039,16221
1,30,9,3,2016,12,12722,3079,15801
1,30,9,3,2016,13,12397,3058,15455
1,30,9,3,2016,14,12380,2875,15255
1,30,9,3,2016,15,12469,2906,15375
1,30,9,3,2016,16,12385,2926,15311
1,30,9,3,2016,17,12557,2906,15463
1,30,9,3,2016,18,12913,2808,15721
1,30,9,3,2016,19,13848,2805,16653
1,30,9,3,2016,20,14141,2874,17015
1,30,9,3,2016,21,13791,2709,16500
1,30,9,3,2016,22,13060,2577,15637
1,30,9,3,2016,23,12637,2392,15029
1,30,9,3,2016,24,11759,2297,14056
2,1,10,1,2016,1,11097,2086,13183
2,1,10,1,2016,2,10899,1925,12824
2,1,10,1,2016,3,10715,1826,12541
2,1,10,1,2016,4,10612,1752,12364
2,1,10,1,2016,5,11048,1753,12801
2,1,10,1,2016,6,11554,1844,13398
2,1,10,1,2016,7,12375,1957,14332
2,1,10,1,2016,8,12899,2085,14984
2,1,10,1,2016,9,12945,2318,15263
2,1,10,1,2016,10,13262,2657,15919
2,1,10,1,2016,11,13304,2876,16180
2,1,10,1,2016,12,12548,2906,15454
2,1,10,1,2016,13,12171,2887,15058
2,1,10,1,2016,14,11831,2678,14509
2,1,10,1,2016,15,11750,2658,14408
2,1,10,1,2016,16,11929,2582,14511
2,1,10,1,2016,17,12286,2554,14840
2,1,10,1,2016,18,12485,2559,15044
2,1,10,1,2016,19,13852,2629,16481
2,1,10,1,2016,20,14135,2689,16824
2,1,10,1,2016,21,13214,2580,15794
2,1,10,1,2016,22,12891,2360,15251
2,1,10,1,2016,23,12168,2251,14419
2,1,10,1,2016,24,11222,2127,13349
3,2,10,1,2016,1,10977,1972,12949
3,2,10,1,2016,2,10290,1780,12070
3,2,10,1,2016,3,10592,1722,12314
3,2,10,1,2016,4,10479,1674,12153
3,2,10,1,2016,5,10815,1658,12473
3,2,10,1,2016,6,11107,1711,12818
3,2,10,1,2016,7,11576,1745,13321
3,2,10,1,2016,8,12303,1784,14087
3,2,10,1,2016,9,12466,1929,14395
3,2,10,1,2016,10,12851,2030,14881
3,2,10,1,2016,11,12364,2188,14552
3,2,10,1,2016,12,11917,2208,14125
3,2,10,1,2016,13,11538,2224,13762
3,2,10,1,2016,14,11235,2122,13357
3,2,10,1,2016,15,11172,2062,13234
3,2,10,1,2016,16,11157,2002,13159
3,2,10,1,2016,17,11498,1983,13481
3,2,10,1,2016,18,11608,2072,13680
3,2,10,1,2016,19,13227,2217,15444
3,2,10,1,2016,20,13287,2248,15535
3,2,10,1,2016,21,12644,2204,14848
3,2,10,1,2016,22,12203,2149,14352
3,2,10,1,2016,23,11836,2085,13921
3,2,10,1,2016,24,11112,2025,13137
1,3,10,1,2016,1,10918,1811,12729
1,3,10,1,2016,2,10705,1658,12363
1,3,10,1,2016,3,10739,1595,12334
1,3,10,1,2016,4,10673,1546,12219
1,3,10,1,2016,5,10955,1550,12505
1,3,10,1,2016,6,11535,1677,13212
1,3,10,1,2016,7,12401,1892,14293
1,3,10,1,2016,8,13148,2048,15196
1,3,10,1,2016,9,12858,2442,15300
1,3,10,1,2016,10,12867,2661,15528
1,3,10,1,2016,11,12437,2897,15334
1,3,10,1,2016,12,12119,2904,15023
1,3,10,1,2016,13,11668,2816,14484
1,3,10,1,2016,14,11354,2696,14050
1,3,10,1,2016,15,11553,2713,14266
1,3,10,1,2016,16,11550,2708,14258
1,3,10,1,2016,17,11521,2702,14223
1,3,10,1,2016,18,12410,2680,15090
1,3,10,1,2016,19,13722,2756,16478
1,3,10,1,2016,20,14418,2780,17198
1,3,10,1,2016,21,13675,2642,16317
1,3,10,1,2016,22,13092,2428,15520
1,3,10,1,2016,23,12223,2309,14532
1,3,10,1,2016,24,11625,2128,13753
1,4,10,1,2016,1,11117,1954,13071
1,4,10,1,2016,2,10940,1746,12686
1,4,10,1,2016,3,10934,1663,12597
1,4,10,1,2016,4,11008,1619,12627
1,4,10,1,2016,5,11286,1612,12898
1,4,10,1,2016,6,12062,1747,13809
1,4,10,1,2016,7,12734,1887,14621
1,4,10,1,2016,8,13404,2116,15520
1,4,10,1,2016,9,13169,2326,15495
1,4,10,1,2016,10,12956,2711,15667
1,4,10,1,2016,11,12721,2851,15572
1,4,10,1,2016,12,12191,2886,15077
1,4,10,1,2016,13,11957,2868,14825
1,4,10,1,2016,14,11533,2695,14228
1,4,10,1,2016,15,11776,2686,14462
1,4,10,1,2016,16,11904,2658,14562
1,4,10,1,2016,17,11927,2658,14585
1,4,10,1,2016,18,12525,2668,15193
1,4,10,1,2016,19,13846,2779,16625
1,4,10,1,2016,20,14390,2769,17159
1,4,10,1,2016,21,13693,2596,16289
1,4,10,1,2016,22,13175,2464,15639
1,4,10,1,2016,23,12472,2239,14711
1,4,10,1,2016,24,11619,2065,13684
1,5,10,1,2016,1,11161,1858,13019
1,5,10,1,2016,2,11009,1731,12740
1,5,10,1,2016,3,11085,1624,12709
1,5,10,1,2016,4,11089,1580,12669
1,5,10,1,2016,5,11417,1577,12994
1,5,10,1,2016,6,12219,1657,13876
1,5,10,1,2016,7,12878,1883,14761
1,5,10,1,2016,8,13384,1998,15382
1,5,10,1,2016,9,12983,2356,15339
1,5,10,1,2016,10,13006,2654,15660
1,5,10,1,2016,11,12620,2844,15464
1,5,10,1,2016,12,12335,2855,15190
1,5,10,1,2016,13,11784,2837,14621
1,5,10,1,2016,14,11618,2712,14330
1,5,10,1,2016,15,11763,2727,14490
1,5,10,1,2016,16,12097,2744,14841
1,5,10,1,2016,17,12060,2743,14803
1,5,10,1,2016,18,12330,2745,15075
1,5,10,1,2016,19,14015,2770,16785
1,5,10,1,2016,20,14627,2840,17467
1,5,10,1,2016,21,13831,2715,16546
1,5,10,1,2016,22,13140,2476,15616
1,5,10,1,2016,23,12621,2300,14921
1,5,10,1,2016,24,11854,2200,14054
1,6,10,1,2016,1,11088,1977,13065
1,6,10,1,2016,2,11181,1780,12961
1,6,10,1,2016,3,11062,1687,12749
1,6,10,1,2016,4,11176,1641,12817
1,6,10,1,2016,5,11662,1636,13298
1,6,10,1,2016,6,12287,1754,14041
1,6,10,1,2016,7,12964,1894,14858
1,6,10,1,2016,8,13185,2137,15322
1,6,10,1,2016,9,13531,2354,15885
1,6,10,1,2016,10,13092,2761,15853
1,6,10,1,2016,11,12627,2958,15585
1,6,10,1,2016,12,12427,2979,15406
1,6,10,1,2016,13,11865,2937,14802
1,6,10,1,2016,14,11858,2783,14641
1,6,10,1,2016,15,11992,2815,14807
1,6,10,1,2016,16,11915,2815,14730
1,6,10,1,2016,17,12237,2785,15022
1,6,10,1,2016,18,12680,2768,15448
1,6,10,1,2016,19,14175,2909,17084
1,6,10,1,2016,20,14470,2886,17356
1,6,10,1,2016,21,14092,2659,16751
1,6,10,1,2016,22,13026,2586,15612
1,6,10,1,2016,23,12741,2367,15108
1,6,10,1,2016,24,11904,2140,14044
1,7,10,1,2016,1,11414,1969,13383
1,7,10,1,2016,2,11255,1830,13085
1,7,10,1,2016,3,11356,1701,13057
1,7,10,1,2016,4,11396,1653,13049
1,7,10,1,2016,5,11608,1668,13276
1,7,10,1,2016,6,12553,1809,14362
1,7,10,1,2016,7,13292,1943,15236
1,7,10,1,2016,8,13388,2210,15598
1,7,10,1,2016,9,13680,2379,16059
1,7,10,1,2016,10,13397,2816,16213
1,7,10,1,2016,11,12839,3040,15879
1,7,10,1,2016,12,12652,3064,15716
1,7,10,1,2016,13,11976,2975,14951
1,7,10,1,2016,14,12185,2868,15053
1,7,10,1,2016,15,11814,2883,14697
1,7,10,1,2016,16,12254,2904,15158
1,7,10,1,2016,17,12349,2876,15225
1,7,10,1,2016,18,12719,2837,15556
1,7,10,1,2016,19,14165,2911,17076
1,7,10,1,2016,20,14783,2934,17717
1,7,10,1,2016,21,14031,2739,16770
1,7,10,1,2016,22,13391,2604,15995
1,7,10,1,2016,23,12781,2384,15165
1,7,10,1,2016,24,11931,2249,14180
2,8,10,1,2016,1,11509,2026,13535
2,8,10,1,2016,2,11374,1881,13255
2,8,10,1,2016,3,11309,1772,13081
2,8,10,1,2016,4,11612,1706,13318
2,8,10,1,2016,5,11559,1705,13264
2,8,10,1,2016,6,12452,1819,14271
2,8,10,1,2016,7,13573,1880,15453
2,8,10,1,2016,8,13408,2041,15449
2,8,10,1,2016,9,13960,2193,16152
2,8,10,1,2016,10,13651,2569,16220
2,8,10,1,2016,11,13380,2724,16104
2,8,10,1,2016,12,13181,2797,15978
2,8,10,1,2016,13,13032,2636,15668
2,8,10,1,2016,14,12427,2645,15072
2,8,10,1,2016,15,12568,2659,15227
2,8,10,1,2016,16,12793,2625,15418
2,8,10,1,2016,17,12875,2611,15486
2,8,10,1,2016,18,12927,2740,15667
2,8,10,1,2016,19,14218,2796,17014
2,8,10,1,2016,20,14632,2753,17385
2,8,10,1,2016,21,13699,2729,16428
2,8,10,1,2016,22,12953,2517,15470
2,8,10,1,2016,23,12735,2377,15112
2,8,10,1,2016,24,12078,2265,14343
2,9,10,1,2016,1,11356,2113,13469
2,9,10,1,2016,2,11101,1918,13019
2,9,10,1,2016,3,11281,1805,13086
2,9,10,1,2016,4,11210,1744,12954
2,9,10,1,2016,5,11563,1737,13300
2,9,10,1,2016,6,12258,1785,14043
2,9,10,1,2016,7,12740,1820,14560
2,9,10,1,2016,8,13015,1875,14890
2,9,10,1,2016,9,13403,2052,15455
2,9,10,1,2016,10,13586,2172,15758
2,9,10,1,2016,11,12906,2327,15233
2,9,10,1,2016,12,12894,2330,15224
2,9,10,1,2016,13,12632,2249,14881
2,9,10,1,2016,14,12450,2227,14677
2,9,10,1,2016,15,12470,2223,14693
2,9,10,1,2016,16,12462,2179,14641
2,9,10,1,2016,17,12481,2169,14650
2,9,10,1,2016,18,12214,2336,14550
2,9,10,1,2016,19,13459,2469,15928
2,9,10,1,2016,20,14294,2474,16768
2,9,10,1,2016,21,13696,2469,16165
2,9,10,1,2016,22,13092,2397,15489
2,9,10,1,2016,23,12555,2348,14903
2,9,10,1,2016,24,11839,2271,14110
1,10,10,1,2016,1,11935,2156,14091
1,10,10,1,2016,2,11869,1970,13839
1,10,10,1,2016,3,11735,1852,13587
1,10,10,1,2016,4,11601,1783,13384
1,10,10,1,2016,5,12007,1779,13786
1,10,10,1,2016,6,12635,1876,14511
1,10,10,1,2016,7,13543,2017,15560
1,10,10,1,2016,8,13963,2241,16204
1,10,10,1,2016,9,13824,2455,16279
1,10,10,1,2016,10,14136,2892,17028
1,10,10,1,2016,11,13844,3088,16932
1,10,10,1,2016,12,13357,3119,16476
1,10,10,1,2016,13,13096,3054,16150
1,10,10,1,2016,14,13021,2951,15972
1,10,10,1,2016,15,12735,2985,15720
1,10,10,1,2016,16,12729,2979,15708
1,10,10,1,2016,17,12794,2926,15720
1,10,10,1,2016,18,12917,2864,15781
1,10,10,1,2016,19,14355,2931,17286
1,10,10,1,2016,20,14828,2915,17743
1,10,10,1,2016,21,14334,2743,17077
1,10,10,1,2016,22,13785,2620,16405
1,10,10,1,2016,23,13162,2436,15598
1,10,10,1,2016,24,12197,2374,14571
3,11,10,1,2016,1,11634,2237,13871
3,11,10,1,2016,2,11552,2075,13627
3,11,10,1,2016,3,11004,1944,12948
3,11,10,1,2016,4,11766,1864,13630
3,11,10,1,2016,5,11734,1839,13573
3,11,10,1,2016,6,12681,1902,14583
3,11,10,1,2016,7,12750,1934,14684
3,11,10,1,2016,8,12823,1976,14799
3,11,10,1,2016,9,12603,2073,14676
3,11,10,1,2016,10,12512,2252,14764
3,11,10,1,2016,11,11809,2362,14171
3,11,10,1,2016,12,11534,2426,13960
3,11,10,1,2016,13,11379,2368,13747
3,11,10,1,2016,14,11240,2295,13535
3,11,10,1,2016,15,11147,2262,13409
3,11,10,1,2016,16,11173,2241,13414
3,11,10,1,2016,17,11084,2219,13303
3,11,10,1,2016,18,11372,2201,13573
3,11,10,1,2016,19,12489,2328,14817
3,11,10,1,2016,20,12669,2440,15109
3,11,10,1,2016,21,12419,2418,14837
3,11,10,1,2016,22,12187,2411,14598
3,11,10,1,2016,23,11478,2383,13861
3,11,10,1,2016,24,10899,2310,13209
3,12,10,1,2016,1,10305,2108,12413
3,12,10,1,2016,2,10065,1960,12025
3,12,10,1,2016,3,9973,1847,11820
3,12,10,1,2016,4,10180,1784,11964
3,12,10,1,2016,5,10459,1771,12230
3,12,10,1,2016,6,11000,1845,12845
3,12,10,1,2016,7,11972,1933,13905
3,12,10,1,2016,8,12674,2063,14737
3,12,10,1,2016,9,13495,2395,15890
3,12,10,1,2016,10,13975,2672,16647
3,12,10,1,2016,11,13610,2924,16534
3,12,10,1,2016,12,13543,2950,16493
3,12,10,1,2016,13,13315,2903,16218
3,12,10,1,2016,14,13174,2810,15984
3,12,10,1,2016,15,13390,2838,16228
3,12,10,1,2016,16,13390,2816,16206
3,12,10,1,2016,17,13487,2787,16274
3,12,10,1,2016,18,13597,2746,16343
3,12,10,1,2016,19,14737,2816,17553
3,12,10,1,2016,20,15320,2795,18115
3,12,10,1,2016,21,14387,2661,17048
3,12,10,1,2016,22,13974,2529,16503
3,12,10,1,2016,23,13238,2409,15647
3,12,10,1,2016,24,12547,2318,14865
1,13,10,1,2016,1,12011,2154,14165
1,13,10,1,2016,2,11787,1925,13712
1,13,10,1,2016,3,11797,1827,13624
1,13,10,1,2016,4,11815,1768,13583
1,13,10,1,2016,5,12099,1761,13860
1,13,10,1,2016,6,12816,1830,14646
1,13,10,1,2016,7,13599,2023,15622
1,13,10,1,2016,8,13847,2165,16012
1,13,10,1,2016,9,14228,2565,16793
1,13,10,1,2016,10,14267,2807,17074
1,13,10,1,2016,11,13765,3088,16853
1,13,10,1,2016,12,13618,3109,16727
1,13,10,1,2016,13,13136,3070,16206
1,13,10,1,2016,14,13404,2970,16374
1,13,10,1,2016,15,13592,3019,16611
1,13,10,1,2016,16,13601,3039,16640
1,13,10,1,2016,17,13853,2994,16847
1,13,10,1,2016,18,14027,2944,16971
1,13,10,1,2016,19,15131,2928,18059
1,13,10,1,2016,20,15251,2864,18115
1,13,10,1,2016,21,14660,2762,17422
1,13,10,1,2016,22,14064,2561,16625
1,13,10,1,2016,23,13264,2471,15735
1,13,10,1,2016,24,12704,2283,14987
1,14,10,1,2016,1,12362,2081,14443
1,14,10,1,2016,2,12025,1892,13917
1,14,10,1,2016,3,11871,1813,13684
1,14,10,1,2016,4,12074,1751,13825
1,14,10,1,2016,5,12051,1758,13809
1,14,10,1,2016,6,12890,1842,14732
1,14,10,1,2016,7,13548,2010,15558
1,14,10,1,2016,8,14522,2179,16701
1,14,10,1,2016,9,14135,2538,16673
1,14,10,1,2016,10,14346,2808,17154
1,14,10,1,2016,11,13832,3095,16927
1,14,10,1,2016,12,13616,3126,16742
1,14,10,1,2016,13,13442,3103,16545
1,14,10,1,2016,14,13376,2990,16366
1,14,10,1,2016,15,13488,2984,16472
1,14,10,1,2016,16,13567,3061,16628
1,14,10,1,2016,17,13594,3029,16623
1,14,10,1,2016,18,13925,2944,16869
1,14,10,1,2016,19,15286,2951,18237
1,14,10,1,2016,20,15599,2914,18513
1,14,10,1,2016,21,14619,2795,17414
1,14,10,1,2016,22,13767,2599,16366
1,14,10,1,2016,23,13286,2472,15758
1,14,10,1,2016,24,12757,2350,15107
2,15,10,1,2016,1,12413,2189,14602
2,15,10,1,2016,2,12340,1942,14282
2,15,10,1,2016,3,12269,1836,14105
2,15,10,1,2016,4,12242,1767,14009
2,15,10,1,2016,5,12448,1761,14209
2,15,10,1,2016,6,12906,1878,14784
2,15,10,1,2016,7,13696,1939,15635
2,15,10,1,2016,8,14186,2091,16277
2,15,10,1,2016,9,14778,2288,17066
2,15,10,1,2016,10,14985,2697,17682
2,15,10,1,2016,11,14480,2828,17308
2,15,10,1,2016,12,14285,2938,17223
2,15,10,1,2016,13,13991,2940,16931
2,15,10,1,2016,14,14034,2848,16882
2,15,10,1,2016,15,14237,2884,17121
2,15,10,1,2016,16,14180,2907,17087
2,15,10,1,2016,17,14358,2886,17244
2,15,10,1,2016,18,14705,2817,17522
2,15,10,1,2016,19,15787,2863,18650
2,15,10,1,2016,20,16078,2872,18950
2,15,10,1,2016,21,15376,2735,18111
2,15,10,1,2016,22,14757,2597,17354
2,15,10,1,2016,23,13947,2392,16339
2,15,10,1,2016,24,13148,2338,15486
2,16,10,1,2016,1,12772,2235,15007
2,16,10,1,2016,2,12436,2091,14527
2,16,10,1,2016,3,12511,1932,14443
2,16,10,1,2016,4,12184,1850,14034
2,16,10,1,2016,5,12550,1853,14403
2,16,10,1,2016,6,12995,1900,14895
2,16,10,1,2016,7,13904,1916,15820
2,16,10,1,2016,8,14606,1969,16575
2,16,10,1,2016,9,15056,2079,17135
2,16,10,1,2016,10,15210,2280,17490
2,16,10,1,2016,11,14803,2393,17196
2,16,10,1,2016,12,14366,2465,16830
2,16,10,1,2016,13,14126,2458,16584
2,16,10,1,2016,14,14372,2398,16770
2,16,10,1,2016,15,14339,2404,16743
2,16,10,1,2016,16,14450,2359,16809
2,16,10,1,2016,17,14403,2307,16710
2,16,10,1,2016,18,14640,2280,16920
2,16,10,1,2016,19,15594,2424,18018
2,16,10,1,2016,20,15793,2467,18260
2,16,10,1,2016,21,15177,2472,17649
2,16,10,1,2016,22,14526,2454,16980
2,16,10,1,2016,23,13668,2414,16082
2,16,10,1,2016,24,13003,2345,15348
1,17,10,1,2016,1,12651,2188,14839
1,17,10,1,2016,2,12533,2008,14541
1,17,10,1,2016,3,12602,1896,14498
1,17,10,1,2016,4,12604,1830,14434
1,17,10,1,2016,5,12939,1823,14762
1,17,10,1,2016,6,13597,1938,15535
1,17,10,1,2016,7,14548,2079,16627
1,17,10,1,2016,8,15121,2206,17327
1,17,10,1,2016,9,15388,2598,17986
1,17,10,1,2016,10,15835,2868,18703
1,17,10,1,2016,11,15311,3154,18465
1,17,10,1,2016,12,15029,3181,18210
1,17,10,1,2016,13,14677,3149,17826
1,17,10,1,2016,14,14893,3059,17952
1,17,10,1,2016,15,15024,3112,18136
1,17,10,1,2016,16,15033,3154,18187
1,17,10,1,2016,17,14940,3133,18073
1,17,10,1,2016,18,15404,3062,18466
1,17,10,1,2016,19,15906,3045,18951
1,17,10,1,2016,20,16345,2978,19323
1,17,10,1,2016,21,15785,2807,18592
1,17,10,1,2016,22,15238,2693,17931
1,17,10,1,2016,23,14344,2589,16933
1,17,10,1,2016,24,13192,2491,15683
1,18,10,1,2016,1,13181,2289,15470
1,18,10,1,2016,2,12962,2105,15067
1,18,10,1,2016,3,13159,1957,15116
1,18,10,1,2016,4,13275,1907,15182
1,18,10,1,2016,5,13292,1895,15187
1,18,10,1,2016,6,14442,1960,16402
1,18,10,1,2016,7,15190,2125,17315
1,18,10,1,2016,8,15567,2271,17838
1,18,10,1,2016,9,16071,2586,18657
1,18,10,1,2016,10,16074,3037,19111
1,18,10,1,2016,11,15844,3167,19011
1,18,10,1,2016,12,14948,3249,18197
1,18,10,1,2016,13,15123,3181,18304
1,18,10,1,2016,14,14909,3092,18001
1,18,10,1,2016,15,15050,3116,18166
1,18,10,1,2016,16,15314,3154,18468
1,18,10,1,2016,17,15402,3150,18552
1,18,10,1,2016,18,15608,3082,18690
1,18,10,1,2016,19,16690,3094,19784
1,18,10,1,2016,20,16868,3019,19887
1,18,10,1,2016,21,15873,2821,18694
1,18,10,1,2016,22,15305,2705,18010
1,18,10,1,2016,23,14097,2560,16657
1,18,10,1,2016,24,13305,2433,15738
1,19,10,1,2016,1,13351,2273,15624
1,19,10,1,2016,2,13114,2067,15181
1,19,10,1,2016,3,13015,1964,14979
1,19,10,1,2016,4,13093,1898,14991
1,19,10,1,2016,5,13352,1883,15235
1,19,10,1,2016,6,14356,2005,16361
1,19,10,1,2016,7,15219,2101,17320
1,19,10,1,2016,8,15880,2316,18196
1,19,10,1,2016,9,16398,2492,18890
1,19,10,1,2016,10,16607,2929,19536
1,19,10,1,2016,11,15830,3158,18988
1,19,10,1,2016,12,15595,3185,18780
1,19,10,1,2016,13,15102,3156,18258
1,19,10,1,2016,14,15481,3066,18547
1,19,10,1,2016,15,15720,3093,18813
1,19,10,1,2016,16,15870,3142,19012
1,19,10,1,2016,17,16162,3145,19307
1,19,10,1,2016,18,16180,3075,19255
1,19,10,1,2016,19,17065,3070,20135
1,19,10,1,2016,20,17341,2998,20339
1,19,10,1,2016,21,16121,2823,18944
1,19,10,1,2016,22,15583,2677,18260
1,19,10,1,2016,23,14615,2578,17193
1,19,10,1,2016,24,13957,2465,16422
1,20,10,1,2016,1,13257,2270,15527
1,20,10,1,2016,2,13176,2074,15250
1,20,10,1,2016,3,13119,1954,15073
1,20,10,1,2016,4,13212,1874,15086
1,20,10,1,2016,5,13563,1862,15425
1,20,10,1,2016,6,14496,1946,16442
1,20,10,1,2016,7,15347,2069,17416
1,20,10,1,2016,8,16106,2246,18352
1,20,10,1,2016,9,16227,2512,18739
1,20,10,1,2016,10,16717,2888,19605
1,20,10,1,2016,11,15806,3108,18914
1,20,10,1,2016,12,15696,3150,18846
1,20,10,1,2016,13,15409,3099,18508
1,20,10,1,2016,14,15604,3017,18621
1,20,10,1,2016,15,15589,3085,18674
1,20,10,1,2016,16,15686,3089,18775
1,20,10,1,2016,17,16072,3070,19142
1,20,10,1,2016,18,16250,3009,19259
1,20,10,1,2016,19,16941,3011,19952
1,20,10,1,2016,20,17312,2934,20246
1,20,10,1,2016,21,16160,2757,18917
1,20,10,1,2016,22,15688,2648,18336
1,20,10,1,2016,23,14510,2515,17025
1,20,10,1,2016,24,13702,2438,16140
1,21,10,1,2016,1,13380,2224,15604
1,21,10,1,2016,2,13018,2075,15093
1,21,10,1,2016,3,13088,1903,14991
1,21,10,1,2016,4,13129,1848,14977
1,21,10,1,2016,5,13567,1847,15414
1,21,10,1,2016,6,14577,1901,16478
1,21,10,1,2016,7,15623,2086,17709
1,21,10,1,2016,8,16099,2163,18262
1,21,10,1,2016,9,16482,2511,18993
1,21,10,1,2016,10,16350,2907,19257
1,21,10,1,2016,11,16289,3065,19354
1,21,10,1,2016,12,15202,3144,18346
1,21,10,1,2016,13,15448,3133,18581
1,21,10,1,2016,14,15383,2980,18363
1,21,10,1,2016,15,15513,3046,18559
1,21,10,1,2016,16,15420,3097,18517
1,21,10,1,2016,17,15793,3063,18856
1,21,10,1,2016,18,15812,3002,18814
1,21,10,1,2016,19,17036,3024,20060
1,21,10,1,2016,20,17154,2929,20083
1,21,10,1,2016,21,16370,2809,19179
1,21,10,1,2016,22,15357,2629,17986
1,21,10,1,2016,23,14804,2528,17332
1,21,10,1,2016,24,13653,2436,16089
2,22,10,1,2016,1,13252,2249,15501
2,22,10,1,2016,2,13330,2062,15392
2,22,10,1,2016,3,13078,1939,15017
2,22,10,1,2016,4,13351,1860,15211
2,22,10,1,2016,5,13756,1852,15608
2,22,10,1,2016,6,14780,1920,16700
2,22,10,1,2016,7,15272,1986,17258
2,22,10,1,2016,8,16594,2136,18730
2,22,10,1,2016,9,16735,2317,19052
2,22,10,1,2016,10,16898,2692,19590
2,22,10,1,2016,11,16541,2811,19352
2,22,10,1,2016,12,16000,2896,18896
2,22,10,1,2016,13,15810,2896,18706
2,22,10,1,2016,14,16151,2787,18938
2,22,10,1,2016,15,16159,2825,18984
2,22,10,1,2016,16,16037,2831,18868
2,22,10,1,2016,17,16514,2784,19298
2,22,10,1,2016,18,16746,2754,19500
2,22,10,1,2016,19,17504,2851,20355
2,22,10,1,2016,20,17621,2821,20442
2,22,10,1,2016,21,16287,2760,19047
2,22,10,1,2016,22,15895,2596,18491
2,22,10,1,2016,23,15160,2505,17665
2,22,10,1,2016,24,14209,2433,16642
2,23,10,1,2016,1,13735,2255,15990
2,23,10,1,2016,2,13347,2080,15427
2,23,10,1,2016,3,13325,1948,15273
2,23,10,1,2016,4,13665,1878,15543
2,23,10,1,2016,5,13885,1847,15732
2,23,10,1,2016,6,14525,1890,16415
2,23,10,1,2016,7,15343,1921,17264
2,23,10,1,2016,8,16160,1960,18120
2,23,10,1,2016,9,16646,2098,18744
2,23,10,1,2016,10,17038,2228,19266
2,23,10,1,2016,11,16757,2348,19105
2,23,10,1,2016,12,16360,2423,18783
2,23,10,1,2016,13,16248,2459,18707
2,23,10,1,2016,14,16175,2349,18524
2,23,10,1,2016,15,16517,2365,18882
2,23,10,1,2016,16,16445,2345,18790
2,23,10,1,2016,17,16324,2298,18622
2,23,10,1,2016,18,16510,2290,18800
2,23,10,1,2016,19,17353,2438,19791
2,23,10,1,2016,20,17405,2474,19879
2,23,10,1,2016,21,16435,2475,18910
2,23,10,1,2016,22,15853,2426,18279
2,23,10,1,2016,23,14622,2365,16987
2,23,10,1,2016,24,13792,2324,16116
1,24,10,1,2016,1,13951,2201,16152
1,24,10,1,2016,2,13794,2029,15823
1,24,10,1,2016,3,13716,1913,15629
1,24,10,1,2016,4,13626,1857,15483
1,24,10,1,2016,5,14210,1830,16040
1,24,10,1,2016,6,14619,1909,16528
1,24,10,1,2016,7,15827,2020,17847
1,24,10,1,2016,8,16621,2210,18831
1,24,10,1,2016,9,17274,2498,19772
1,24,10,1,2016,10,17342,2892,20234
1,24,10,1,2016,11,16980,3102,20082
1,24,10,1,2016,12,16651,3157,19808
1,24,10,1,2016,13,16727,3139,19866
1,24,10,1,2016,14,16414,3060,19474
1,24,10,1,2016,15,16786,3096,19882
1,24,10,1,2016,16,16759,3096,19855
1,24,10,1,2016,17,16824,3074,19898
1,24,10,1,2016,18,16903,2990,19893
1,24,10,1,2016,19,17210,2996,20206
1,24,10,1,2016,20,17577,2923,20500
1,24,10,1,2016,21,16685,2764,19449
1,24,10,1,2016,22,16066,2603,18669
1,24,10,1,2016,23,14892,2440,17332
1,24,10,1,2016,24,14225,2356,16581
1,25,10,1,2016,1,13990,2153,16142
1,25,10,1,2016,2,13692,2018,15710
1,25,10,1,2016,3,13170,1897,15067
1,25,10,1,2016,4,13358,1827,15185
1,25,10,1,2016,5,13660,1821,15481
1,25,10,1,2016,6,14744,1915,16659
1,25,10,1,2016,7,15811,2023,17834
1,25,10,1,2016,8,16834,2169,19003
1,25,10,1,2016,9,17252,2570,19822
1,25,10,1,2016,10,17583,2816,20399
1,25,10,1,2016,11,17306,3094,20400
1,25,10,1,2016,12,16812,3112,19924
1,25,10,1,2016,13,16333,3068,19401
1,25,10,1,2016,14,16665,2965,19630
1,25,10,1,2016,15,16834,2994,19828
1,25,10,1,2016,16,16806,3011,19817
1,25,10,1,2016,17,16927,2971,19898
1,25,10,1,2016,18,16363,2910,19273
1,25,10,1,2016,19,17234,2920,20154
1,25,10,1,2016,20,16947,2816,19763
1,25,10,1,2016,21,16356,2697,19053
1,25,10,1,2016,22,15984,2486,18470
1,25,10,1,2016,23,15169,2383,17552
1,25,10,1,2016,24,14182,2206,16388
1,26,10,1,2016,1,13503,2074,15577
1,26,10,1,2016,2,13568,1875,15443
1,26,10,1,2016,3,13368,1800,15168
1,26,10,1,2016,4,13465,1736,15201
1,26,10,1,2016,5,13980,1730,15710
1,26,10,1,2016,6,14723,1804,16527
1,26,10,1,2016,7,15720,1890,17610
1,26,10,1,2016,8,16649,2089,18738
1,26,10,1,2016,9,17352,2323,19675
1,26,10,1,2016,10,17446,2735,20181
1,26,10,1,2016,11,17240,2884,20124
1,26,10,1,2016,12,16758,2980,19738
1,26,10,1,2016,13,16796,2963,19758
1,26,10,1,2016,14,16846,2870,19716
1,26,10,1,2016,15,16801,2914,19715
1,26,10,1,2016,16,17106,2943,20049
1,26,10,1,2016,17,17140,2924,20064
1,26,10,1,2016,18,17375,2896,20271
1,26,10,1,2016,19,17993,2958,20951
1,26,10,1,2016,20,17798,2896,20694
1,26,10,1,2016,21,17081,2699,19780
1,26,10,1,2016,22,15978,2523,18501
1,26,10,1,2016,23,15336,2387,17723
1,26,10,1,2016,24,14070,2272,16342
1,27,10,1,2016,1,13457,2060,15517
1,27,10,1,2016,2,13533,1916,15449
1,27,10,1,2016,3,13766,1796,15562
1,27,10,1,2016,4,13490,1732,15222
1,27,10,1,2016,5,13765,1731,15496
1,27,10,1,2016,6,14682,1835,16517
1,27,10,1,2016,7,15779,1904,17683
1,27,10,1,2016,8,16626,2138,18764
1,27,10,1,2016,9,17059,2319,19378
1,27,10,1,2016,10,17728,2786,20514
1,27,10,1,2016,11,16868,2966,19834
1,27,10,1,2016,12,16080,3040,19120
1,27,10,1,2016,13,15978,3002,18980
1,27,10,1,2016,14,16011,2907,18918
1,27,10,1,2016,15,16245,2940,19185
1,27,10,1,2016,16,16504,2965,19469
1,27,10,1,2016,17,16441,2930,19371
1,27,10,1,2016,18,16656,2884,19540
1,27,10,1,2016,19,18013,2926,20939
1,27,10,1,2016,20,17860,2862,20722
1,27,10,1,2016,21,16694,2722,19416
1,27,10,1,2016,22,16222,2564,18786
1,27,10,1,2016,23,14811,2458,17269
1,27,10,1,2016,24,13797,2360,16157
1,28,10,1,2016,1,13437,2126,15563
1,28,10,1,2016,2,13315,1962,15277
1,28,10,1,2016,3,13222,1847,15069
1,28,10,1,2016,4,13301,1780,15081
1,28,10,1,2016,5,13800,1748,15548
1,28,10,1,2016,6,14347,1816,16163
1,28,10,1,2016,7,15223,1926,17149
1,28,10,1,2016,8,16406,2056,18462
1,28,10,1,2016,9,16916,2456,19372
1,28,10,1,2016,10,17170,2752,19922
1,28,10,1,2016,11,16878,2954,19832
1,28,10,1,2016,12,15962,3012,18974
1,28,10,1,2016,13,16125,2962,19087
1,28,10,1,2016,14,16194,2830,19024
1,28,10,1,2016,15,16171,2851,19022
1,28,10,1,2016,16,16264,2860,19124
1,28,10,1,2016,17,16283,2865,19148
1,28,10,1,2016,18,16536,2821,19357
1,28,10,1,2016,19,17424,2882,20306
1,28,10,1,2016,20,17359,2814,20173
1,28,10,1,2016,21,16512,2746,19258
1,28,10,1,2016,22,15629,2522,18151
1,28,10,1,2016,23,14513,2401,16914
1,28,10,1,2016,24,13671,2302,15973
2,29,10,1,2016,1,12854,2059,14913
2,29,10,1,2016,2,12879,1942,14821
2,29,10,1,2016,3,12786,1831,14617
2,29,10,1,2016,4,12770,1762,14532
2,29,10,1,2016,5,13426,1751,15177
2,29,10,1,2016,6,14409,1861,16270
2,29,10,1,2016,7,15388,1925,17313
2,29,10,1,2016,8,16061,2006,18067
2,29,10,1,2016,9,16498,2177,18675
2,29,10,1,2016,10,16278,2469,18747
2,29,10,1,2016,11,16118,2567,18685
2,29,10,1,2016,12,15527,2609,18136
2,29,10,1,2016,13,15633,2580,18213
2,29,10,1,2016,14,15791,2526,18317
2,29,10,1,2016,15,15965,2519,18484
2,29,10,1,2016,16,15992,2489,18481
2,29,10,1,2016,17,16037,2458,18495
2,29,10,1,2016,18,16143,2407,18550
2,29,10,1,2016,19,16989,2559,19548
2,29,10,1,2016,20,16728,2577,19305
2,29,10,1,2016,21,16143,2556,18699
2,29,10,1,2016,22,15295,2345,17640
2,29,10,1,2016,23,13979,2296,16275
2,29,10,1,2016,24,12896,2172,15068
3,30,10,1,2016,1,12600,1993,14593
3,30,10,1,2016,2,12699,1848,14547
3,30,10,1,2016,3,12464,1751,14215
3,30,10,1,2016,4,12437,1684,14121
3,30,10,1,2016,5,12673,1677,14350
3,30,10,1,2016,6,13435,1758,15193
3,30,10,1,2016,7,14054,1765,15819
3,30,10,1,2016,8,15048,1810,16858
3,30,10,1,2016,9,15479,1894,17373
3,30,10,1,2016,10,15167,2013,17180
3,30,10,1,2016,11,14544,2069,16613
3,30,10,1,2016,12,14126,2089,16215
3,30,10,1,2016,13,14436,2038,16474
3,30,10,1,2016,14,14553,2011,16564
3,30,10,1,2016,15,14305,1999,16304
3,30,10,1,2016,16,14416,1964,16380
3,30,10,1,2016,17,14456,2020,16476
3,30,10,1,2016,18,14448,2049,16497
3,30,10,1,2016,19,15428,2316,17744
3,30,10,1,2016,20,14942,2360,17302
3,30,10,1,2016,21,14179,2355,16534
3,30,10,1,2016,22,13785,2304,16089
3,30,10,1,2016,23,12705,2228,14933
3,30,10,1,2016,24,11848,2156,14004
3,31,10,1,2016,1,11524,2021,13545
3,31,10,1,2016,2,11353,1833,13186
3,31,10,1,2016,3,11351,1759,13110
3,31,10,1,2016,4,11390,1695,13085
3,31,10,1,2016,5,11624,1686,13310
3,31,10,1,2016,6,12399,1771,14170
3,31,10,1,2016,7,13309,1809,15118
3,31,10,1,2016,8,14048,1844,15892
3,31,10,1,2016,9,14664,1926,16590
3,31,10,1,2016,10,14730,2075,16805
3,31,10,1,2016,11,14003,2174,16177
3,31,10,1,2016,12,13967,2241,16208
3,31,10,1,2016,13,14057,2220,16277
3,31,10,1,2016,14,14257,2176,16433
3,31,10,1,2016,15,14255,2172,16427
3,31,10,1,2016,16,14142,2164,16306
3,31,10,1,2016,17,14291,2137,16428
3,31,10,1,2016,18,14522,2159,16681
3,31,10,1,2016,19,15422,2368,17790
3,31,10,1,2016,20,15554,2429,17983
3,31,10,1,2016,21,14955,2427,17382
3,31,10,1,2016,22,14311,2406,16717
3,31,10,1,2016,23,12670,2349,15019
3,31,10,1,2016,24,11638,2271,13909
1,1,11,1,2016,1,11421,2144,13565
1,1,11,1,2016,2,11376,1924,13300
1,1,11,1,2016,3,11495,1808,13303
1,1,11,1,2016,4,11443,1742,13185
1,1,11,1,2016,5,11868,1743,13611
1,1,11,1,2016,6,12638,1782,14420
1,1,11,1,2016,7,13675,1814,15489
1,1,11,1,2016,8,14754,1884,16638
1,1,11,1,2016,9,15283,2022,17305
1,1,11,1,2016,10,15089,2252,17341
1,1,11,1,2016,11,14631,2355,16986
1,1,11,1,2016,12,14310,2380,16690
1,1,11,1,2016,13,14263,2367,16630
1,1,11,1,2016,14,14393,2312,16705
1,1,11,1,2016,15,14413,2308,16721
1,1,11,1,2016,16,14477,2302,16779
1,1,11,1,2016,17,14449,2283,16732
1,1,11,1,2016,18,14620,2290,16910
1,1,11,1,2016,19,15426,2415,17841
1,1,11,1,2016,20,15387,2461,17848
1,1,11,1,2016,21,14694,2411,17105
1,1,11,1,2016,22,13874,2315,16189
1,1,11,1,2016,23,12847,2226,15073
1,1,11,1,2016,24,12099,2138,14237
1,2,11,1,2016,1,11543,2087,13630
1,2,11,1,2016,2,11544,1895,13439
1,2,11,1,2016,3,11649,1728,13377
1,2,11,1,2016,4,11759,1636,13395
1,2,11,1,2016,5,11852,1657,13509
1,2,11,1,2016,6,12695,1770,14465
1,2,11,1,2016,7,13750,1799,15549
1,2,11,1,2016,8,14702,1964,16666
1,2,11,1,2016,9,15657,2175,17832
1,2,11,1,2016,10,15903,2574,18477
1,2,11,1,2016,11,15682,2755,18437
1,2,11,1,2016,12,15585,2801,18386
1,2,11,1,2016,13,15292,2778,18070
1,2,11,1,2016,14,15594,2707,18301
1,2,11,1,2016,15,15732,2732,18464
1,2,11,1,2016,16,15582,2744,18326
1,2,11,1,2016,17,15450,2722,18172
1,2,11,1,2016,18,16161,2689,18850
1,2,11,1,2016,19,16993,2761,19754
1,2,11,1,2016,20,16393,2705,19098
1,2,11,1,2016,21,15599,2556,18155
1,2,11,1,2016,22,14766,2396,17162
1,2,11,1,2016,23,13589,2286,15875
1,2,11,1,2016,24,12699,2141,14840
1,3,11,1,2016,1,12131,2017,14148
1,3,11,1,2016,2,12159,1864,14023
1,3,11,1,2016,3,12206,1760,13966
1,3,11,1,2016,4,12182,1698,13880
1,3,11,1,2016,5,12709,1684,14393
1,3,11,1,2016,6,13225,1749,14974
1,3,11,1,2016,7,14428,1807,16235
1,3,11,1,2016,8,15628,1984,17612
1,3,11,1,2016,9,16406,2242,18648
1,3,11,1,2016,10,16872,2644,19516
1,3,11,1,2016,11,16194,2796,18990
1,3,11,1,2016,12,16332,2825,19157
1,3,11,1,2016,13,15935,2816,18751
1,3,11,1,2016,14,16225,2697,18922
1,3,11,1,2016,15,15842,2729,18571
1,3,11,1,2016,16,16190,2737,18927
1,3,11,1,2016,17,16336,2732,19068
1,3,11,1,2016,18,16833,2688,19521
1,3,11,1,2016,19,17366,2732,20098
1,3,11,1,2016,20,17083,2677,19760
1,3,11,1,2016,21,16068,2658,18726
1,3,11,1,2016,22,15166,2381,17547
1,3,11,1,2016,23,14349,2234,16583
1,3,11,1,2016,24,13307,2176,15483
1,4,11,1,2016,1,12795,1977,14772
1,4,11,1,2016,2,12810,1781,14591
1,4,11,1,2016,3,12922,1715,14637
1,4,11,1,2016,4,13113,1652,14765
1,4,11,1,2016,5,13205,1640,14845
1,4,11,1,2016,6,14026,1719,15745
1,4,11,1,2016,7,14938,1786,16724
1,4,11,1,2016,8,15982,1995,17977
1,4,11,1,2016,9,16906,2197,19103
1,4,11,1,2016,10,17092,2617,19709
1,4,11,1,2016,11,17007,2770,19777
1,4,11,1,2016,12,16402,2820,19222
1,4,11,1,2016,13,16431,2774,19205
1,4,11,1,2016,14,16661,2692,19353
1,4,11,1,2016,15,16120,2687,18807
1,4,11,1,2016,16,16033,2671,18704
1,4,11,1,2016,17,16212,2657,18869
1,4,11,1,2016,18,16477,2641,19118
1,4,11,1,2016,19,17457,2701,20158
1,4,11,1,2016,20,16982,2678,19660
1,4,11,1,2016,21,16603,2517,19120
1,4,11,1,2016,22,15281,2383,17664
1,4,11,1,2016,23,14339,2228,16567
1,4,11,1,2016,24,13643,2099,15742
2,5,11,1,2016,1,12731,1928,14659
2,5,11,1,2016,2,12642,1803,14445
2,5,11,1,2016,3,12923,1684,14607
2,5,11,1,2016,4,12805,1624,14429
2,5,11,1,2016,5,13279,1619,14898
2,5,11,1,2016,6,13925,1681,15606
2,5,11,1,2016,7,14778,1748,16526
2,5,11,1,2016,8,16090,1884,17974
2,5,11,1,2016,9,17087,2049,19136
2,5,11,1,2016,10,17821,2436,20257
2,5,11,1,2016,11,17323,2591,19914
2,5,11,1,2016,12,17017,2662,19679
2,5,11,1,2016,13,16732,2624,19356
2,5,11,1,2016,14,16816,2537,19353
2,5,11,1,2016,15,16945,2544,19489
2,5,11,1,2016,16,16791,2546,19337
2,5,11,1,2016,17,17026,2525,19551
2,5,11,1,2016,18,17314,2497,19811
2,5,11,1,2016,19,17665,2643,20308
2,5,11,1,2016,20,17526,2588,20114
2,5,11,1,2016,21,16465,2471,18936
2,5,11,1,2016,22,15608,2328,17936
2,5,11,1,2016,23,14288,2154,16442
2,5,11,1,2016,24,13316,2073,15389
2,6,11,1,2016,1,13288,1948,15236
2,6,11,1,2016,2,13564,1760,15324
2,6,11,1,2016,3,13467,1668,15135
2,6,11,1,2016,4,13427,1611,15038
2,6,11,1,2016,5,13804,1593,15397
2,6,11,1,2016,6,14454,1658,16112
2,6,11,1,2016,7,15554,1671,17225
2,6,11,1,2016,8,16087,1714,17801
2,6,11,1,2016,9,17136,1838,18974
2,6,11,1,2016,10,17249,1941,19190
2,6,11,1,2016,11,16589,2068,18657
2,6,11,1,2016,12,16676,2096,18772
2,6,11,1,2016,13,16284,2049,18333
2,6,11,1,2016,14,16455,2025,18480
2,6,11,1,2016,15,16634,1983,18617
2,6,11,1,2016,16,16635,1962,18597
2,6,11,1,2016,17,16568,1938,18506
2,6,11,1,2016,18,16621,1986,18607
2,6,11,1,2016,19,17539,2190,19729
2,6,11,1,2016,20,17479,2251,19730
2,6,11,1,2016,21,15864,2250,18114
2,6,11,1,2016,22,15256,2228,17484
2,6,11,1,2016,23,14099,2155,16254
2,6,11,1,2016,24,13315,2005,15320
1,7,11,1,2016,1,13000,1897,14897
1,7,11,1,2016,2,12909,1748,14657
1,7,11,1,2016,3,13130,1656,14786
1,7,11,1,2016,4,12871,1609,14480
1,7,11,1,2016,5,13368,1594,14962
1,7,11,1,2016,6,14182,1665,15847
1,7,11,1,2016,7,15159,1817,16976
1,7,11,1,2016,8,15983,1929,17912
1,7,11,1,2016,9,17395,2291,19686
1,7,11,1,2016,10,17634,2545,20179
1,7,11,1,2016,11,16768,2823,19591
1,7,11,1,2016,12,16880,2850,19730
1,7,11,1,2016,13,16367,2827,19194
1,7,11,1,2016,14,16685,2738,19423
1,7,11,1,2016,15,16495,2753,19248
1,7,11,1,2016,16,16917,2755,19672
1,7,11,1,2016,17,17124,2745,19869
1,7,11,1,2016,18,17170,2703,19873
1,7,11,1,2016,19,17289,2767,20056
1,7,11,1,2016,20,16152,2641,18793
1,7,11,1,2016,21,15864,2588,18452
1,7,11,1,2016,22,15106,2334,17440
1,7,11,1,2016,23,14187,2219,16406
1,7,11,1,2016,24,13298,2025,15323
1,8,11,1,2016,1,13258,1919,15177
1,8,11,1,2016,2,13098,1719,14817
1,8,11,1,2016,3,13111,1636,14747
1,8,11,1,2016,4,13067,1579,14646
1,8,11,1,2016,5,13434,1585,15019
1,8,11,1,2016,6,14347,1665,16012
1,8,11,1,2016,7,15788,1739,17527
1,8,11,1,2016,8,17055,1956,19011
1,8,11,1,2016,9,17483,2186,19669
1,8,11,1,2016,10,17771,2572,20343
1,8,11,1,2016,11,17355,2810,20165
1,8,11,1,2016,12,16784,2846,19630
1,8,11,1,2016,13,16828,2796,19624
1,8,11,1,2016,14,16796,2678,19474
1,8,11,1,2016,15,17290,2718,20008
1,8,11,1,2016,16,16756,2724,19480
1,8,11,1,2016,17,16967,2723,19690
1,8,11,1,2016,18,17138,2684,19822
1,8,11,1,2016,19,17856,2783,20639
1,8,11,1,2016,20,17658,2684,20342
1,8,11,1,2016,21,16798,2521,19319
1,8,11,1,2016,22,15572,2351,17923
1,8,11,1,2016,23,14377,2199,16576
1,8,11,1,2016,24,13530,2062,15592
1,9,11,1,2016,1,13493,1836,15329
1,9,11,1,2016,2,13151,1730,14881
1,9,11,1,2016,3,13142,1637,14779
1,9,11,1,2016,4,12870,1583,14453
1,9,11,1,2016,5,13388,1581,14969
1,9,11,1,2016,6,14171,1655,15826
1,9,11,1,2016,7,15764,1796,17560
1,9,11,1,2016,8,16532,1946,18478
1,9,11,1,2016,9,17620,2242,19862
1,9,11,1,2016,10,17986,2520,20506
1,9,11,1,2016,11,17426,2756,20182
1,9,11,1,2016,12,16971,2758,19729
1,9,11,1,2016,13,16569,2731,19300
1,9,11,1,2016,14,17072,2643,19714
1,9,11,1,2016,15,16855,2657,19512
1,9,11,1,2016,16,16917,2664,19581
1,9,11,1,2016,17,17323,2650,19973
1,9,11,1,2016,18,17417,2644,20061
1,9,11,1,2016,19,17942,2751,20693
1,9,11,1,2016,20,17500,2657,20157
1,9,11,1,2016,21,16721,2531,19252
1,9,11,1,2016,22,15546,2325,17871
1,9,11,1,2016,23,14321,2125,16446
1,9,11,1,2016,24,13556,2035,15591
1,10,11,1,2016,1,13142,1855,14997
1,10,11,1,2016,2,13140,1673,14813
1,10,11,1,2016,3,13069,1588,14657
1,10,11,1,2016,4,13185,1534,14719
1,10,11,1,2016,5,13807,1532,15339
1,10,11,1,2016,6,14399,1612,16011
1,10,11,1,2016,7,15603,1747,17350
1,10,11,1,2016,8,16685,1963,18648
1,10,11,1,2016,9,17354,2161,19515
1,10,11,1,2016,10,17756,2544,20300
1,10,11,1,2016,11,17344,2704,20048
1,10,11,1,2016,12,16460,2745,19205
1,10,11,1,2016,13,16458,2721,19179
1,10,11,1,2016,14,16721,2636,19357
1,10,11,1,2016,15,16636,2653,19289
1,10,11,1,2016,16,16652,2661,19313
1,10,11,1,2016,17,16793,2676,19469
1,10,11,1,2016,18,16776,2632,19408
1,10,11,1,2016,19,18116,2689,20805
1,10,11,1,2016,20,17368,2645,20013
1,10,11,1,2016,21,16191,2439,18630
1,10,11,1,2016,22,15586,2324,17910
1,10,11,1,2016,23,14222,2133,16355
1,10,11,1,2016,24,13268,2017,15285
1,11,11,1,2016,1,12883,1789,14672
1,11,11,1,2016,2,12942,1651,14593
1,11,11,1,2016,3,12924,1568,14492
1,11,11,1,2016,4,12947,1510,14457
1,11,11,1,2016,5,13316,1517,14833
1,11,11,1,2016,6,14193,1576,15769
1,11,11,1,2016,7,15421,1733,17154
1,11,11,1,2016,8,16190,1893,18083
1,11,11,1,2016,9,16731,2289,19020
1,11,11,1,2016,10,17491,2479,19970
1,11,11,1,2016,11,16598,2701,19299
1,11,11,1,2016,12,16487,2734,19221
1,11,11,1,2016,13,16364,2682,19046
1,11,11,1,2016,14,16511,2582,19093
1,11,11,1,2016,15,16403,2588,18991
1,11,11,1,2016,16,16248,2609,18857
1,11,11,1,2016,17,16406,2616,19022
1,11,11,1,2016,18,16373,2592,18965
1,11,11,1,2016,19,17590,2664,20254
1,11,11,1,2016,20,16843,2594,19437
1,11,11,1,2016,21,15969,2479,18448
1,11,11,1,2016,22,14893,2251,17144
1,11,11,1,2016,23,13641,2112,15753
1,11,11,1,2016,24,12956,1953,14909
2,12,11,1,2016,1,12334,1824,14158
2,12,11,1,2016,2,12704,1640,14344
2,12,11,1,2016,3,12558,1573,14131
2,12,11,1,2016,4,12521,1515,14036
2,12,11,1,2016,5,12958,1521,14479
2,12,11,1,2016,6,13759,1583,15342
2,12,11,1,2016,7,14845,1681,16526
2,12,11,1,2016,8,16026,1779,17805
2,12,11,1,2016,9,17267,2057,19324
2,12,11,1,2016,10,17404,2209,19613
2,12,11,1,2016,11,17218,2473,19690
2,12,11,1,2016,12,16523,2501,19024
2,12,11,1,2016,13,16100,2470,18570
2,12,11,1,2016,14,16323,2407,18730
2,12,11,1,2016,15,16646,2383,19029
2,12,11,1,2016,16,16510,2395,18905
2,12,11,1,2016,17,16738,2379,19117
2,12,11,1,2016,18,16745,2381,19126
2,12,11,1,2016,19,17219,2499,19718
2,12,11,1,2016,20,16895,2492,19387
2,12,11,1,2016,21,15616,2349,17966
2,12,11,1,2016,22,14928,2242,17170
2,12,11,1,2016,23,13586,2030,15616
2,12,11,1,2016,24,12572,1973,14545
2,13,11,1,2016,1,12626,1792,14418
2,13,11,1,2016,2,12440,1678,14118
2,13,11,1,2016,3,12427,1581,14008
2,13,11,1,2016,4,12711,1526,14237
2,13,11,1,2016,5,12862,1504,14366
2,13,11,1,2016,6,13747,1644,15391
2,13,11,1,2016,7,14969,1676,16645
2,13,11,1,2016,8,16110,1597,17707
2,13,11,1,2016,9,17129,1704,18833
2,13,11,1,2016,10,17074,1916,18990
2,13,11,1,2016,11,16723,2025,18748
2,13,11,1,2016,12,16371,2045,18416
2,13,11,1,2016,13,16226,2021,18247
2,13,11,1,2016,14,16426,2003,18429
2,13,11,1,2016,15,16306,1958,18264
2,13,11,1,2016,16,16109,1930,18039
2,13,11,1,2016,17,16215,1920,18135
2,13,11,1,2016,18,16415,1973,18388
2,13,11,1,2016,19,17006,2178,19184
2,13,11,1,2016,20,16495,2167,18662
2,13,11,1,2016,21,15441,2151,17592
2,13,11,1,2016,22,14249,2118,16367
2,13,11,1,2016,23,13439,1966,15405
2,13,11,1,2016,24,12724,1919,14643
3,14,11,1,2016,1,12753,1769,14522
3,14,11,1,2016,2,12658,1664,14322
3,14,11,1,2016,3,12414,1587,14001
3,14,11,1,2016,4,12595,1537,14132
3,14,11,1,2016,5,12872,1545,14417
3,14,11,1,2016,6,13726,1611,15337
3,14,11,1,2016,7,14308,1705,16013
3,14,11,1,2016,8,16585,1840,18425
3,14,11,1,2016,9,17038,2159,19197
3,14,11,1,2016,10,17664,2336,20000
3,14,11,1,2016,11,17338,2596,19934
3,14,11,1,2016,12,16672,2612,19284
3,14,11,1,2016,13,16670,2606,19276
3,14,11,1,2016,14,16676,2481,19157
3,14,11,1,2016,15,16600,2502,19102
3,14,11,1,2016,16,16973,2523,19496
3,14,11,1,2016,17,17046,2509,19555
3,14,11,1,2016,18,16960,2502,19462
3,14,11,1,2016,19,17256,2608,19864
3,14,11,1,2016,20,17067,2549,19616
3,14,11,1,2016,21,16144,2466,18610
3,14,11,1,2016,22,15274,2191,17465
3,14,11,1,2016,23,14129,2224,16353
3,14,11,1,2016,24,13124,2038,15162
1,15,11,1,2016,1,12861,1863,14724
1,15,11,1,2016,2,12982,1680,14662
1,15,11,1,2016,3,12911,1620,14531
1,15,11,1,2016,4,12948,1578,14526
1,15,11,1,2016,5,13204,1578,14782
1,15,11,1,2016,6,14287,1735,16022
1,15,11,1,2016,7,14978,1833,16811
1,15,11,1,2016,8,17065,2056,19121
1,15,11,1,2016,9,17280,2227,19507
1,15,11,1,2016,10,17747,2577,20324
1,15,11,1,2016,11,17226,2827,20053
1,15,11,1,2016,12,17003,2838,19841
1,15,11,1,2016,13,16353,2839,19192
1,15,11,1,2016,14,16635,2755,19390
1,15,11,1,2016,15,16821,2772,19593
1,15,11,1,2016,16,16921,2770,19691
1,15,11,1,2016,17,16865,2766,19631
1,15,11,1,2016,18,17099,2730,19829
1,15,11,1,2016,19,17735,2788,20523
1,15,11,1,2016,20,16983,2733,19716
1,15,11,1,2016,21,15889,2513,18402
1,15,11,1,2016,22,15156,2389,17545
1,15,11,1,2016,23,14053,2248,16301
1,15,11,1,2016,24,13209,2143,15352
1,16,11,1,2016,1,12904,1916,14820
1,16,11,1,2016,2,12905,1758,14663
1,16,11,1,2016,3,12487,1683,14170
1,16,11,1,2016,4,12818,1609,14427
1,16,11,1,2016,5,13264,1617,14881
1,16,11,1,2016,6,14347,1741,16088
1,16,11,1,2016,7,15345,1920,17265
1,16,11,1,2016,8,16355,2064,18419
1,16,11,1,2016,9,16905,2402,19307
1,16,11,1,2016,10,17047,2590,19637
1,16,11,1,2016,11,16445,2870,19315
1,16,11,1,2016,12,16380,2927,19307
1,16,11,1,2016,13,16440,2913,19353
1,16,11,1,2016,14,16469,2866,19335
1,16,11,1,2016,15,16735,2870,19605
1,16,11,1,2016,16,16470,2872,19342
1,16,11,1,2016,17,16599,2856,19455
1,16,11,1,2016,18,16589,2827,19416
1,16,11,1,2016,19,16976,2855,19831
1,16,11,1,2016,20,16046,2774,18820
1,16,11,1,2016,21,15103,2660,17763
1,16,11,1,2016,22,14431,2386,16817
1,16,11,1,2016,23,13233,2383,15616
1,16,11,1,2016,24,12775,2246,15021
1,17,11,1,2016,1,12717,2026,14743
1,17,11,1,2016,2,12752,1895,14647
1,17,11,1,2016,3,12737,1761,14498
1,17,11,1,2016,4,12653,1692,14345
1,17,11,1,2016,5,13156,1694,14850
1,17,11,1,2016,6,14007,1788,15795
1,17,11,1,2016,7,15013,1949,16962
1,17,11,1,2016,8,15995,2072,18067
1,17,11,1,2016,9,16606,2447,19053
1,17,11,1,2016,10,16375,2618,18993
1,17,11,1,2016,11,15963,2882,18845
1,17,11,1,2016,12,16282,2890,19172
1,17,11,1,2016,13,15703,2885,18588
1,17,11,1,2016,14,15908,2778,18686
1,17,11,1,2016,15,16127,2813,18940
1,17,11,1,2016,16,16075,2836,18911
1,17,11,1,2016,17,15730,2800,18530
1,17,11,1,2016,18,14567,2795,17362
1,17,11,1,2016,19,15105,2819,17924
1,17,11,1,2016,20,14549,2716,17265
1,17,11,1,2016,21,13642,2592,16234
1,17,11,1,2016,22,12746,2413,15159
1,17,11,1,2016,23,11954,2296,14250
1,17,11,1,2016,24,11872,2195,14067
1,18,11,1,2016,1,12334,1984,14318
1,18,11,1,2016,2,12163,1807,13970
1,18,11,1,2016,3,12265,1715,13980
1,18,11,1,2016,4,12452,1652,14104
1,18,11,1,2016,5,12671,1650,14321
1,18,11,1,2016,6,13622,1760,15382
1,18,11,1,2016,7,15199,1904,17103
1,18,11,1,2016,8,16179,2025,18204
1,18,11,1,2016,9,16192,2368,18560
1,18,11,1,2016,10,16244,2574,18818
1,18,11,1,2016,11,16075,2771,18846
1,18,11,1,2016,12,16239,2838,19077
1,18,11,1,2016,13,15954,2809,18763
1,18,11,1,2016,14,15897,2720,18617
1,18,11,1,2016,15,15806,2710,18516
1,18,11,1,2016,16,15622,2755,18377
1,18,11,1,2016,17,15127,2705,17832
1,18,11,1,2016,18,13772,2678,16450
1,18,11,1,2016,19,14309,2749,17058
1,18,11,1,2016,20,14069,2669,16738
1,18,11,1,2016,21,13152,2551,15703
1,18,11,1,2016,22,12435,2394,14829
1,18,11,1,2016,23,11631,2267,13898
1,18,11,1,2016,24,11888,2098,13986
2,19,11,1,2016,1,12243,1957,14200
2,19,11,1,2016,2,12306,1754,14060
2,19,11,1,2016,3,12490,1694,14184
2,19,11,1,2016,4,12196,1629,13825
2,19,11,1,2016,5,13030,1608,14638
2,19,11,1,2016,6,13555,1695,15250
2,19,11,1,2016,7,14975,1788,16763
2,19,11,1,2016,8,16003,1914,17917
2,19,11,1,2016,9,16536,2151,18687
2,19,11,1,2016,10,16454,2342,18796
2,19,11,1,2016,11,16601,2588,19189
2,19,11,1,2016,12,16568,2623,19191
2,19,11,1,2016,13,16201,2622,18823
2,19,11,1,2016,14,16026,2530,18556
2,19,11,1,2016,15,16199,2531,18730
2,19,11,1,2016,16,16344,2534,18878
2,19,11,1,2016,17,15802,2523,18325
2,19,11,1,2016,18,14507,2491,16998
2,19,11,1,2016,19,14351,2579,16930
2,19,11,1,2016,20,14235,2564,16799
2,19,11,1,2016,21,13071,2421,15492
2,19,11,1,2016,22,12185,2303,14488
2,19,11,1,2016,23,11790,2133,13923
2,19,11,1,2016,24,11786,2053,13839
2,20,11,1,2016,1,12072,1870,13942
2,20,11,1,2016,2,12156,1743,13899
2,20,11,1,2016,3,12330,1620,13950
2,20,11,1,2016,4,12563,1570,14133
2,20,11,1,2016,5,12846,1553,14399
2,20,11,1,2016,6,13524,1609,15133
2,20,11,1,2016,7,14729,1644,16373
2,20,11,1,2016,8,15468,1665,17133
2,20,11,1,2016,9,16637,1793,18430
2,20,11,1,2016,10,16508,1898,18406
2,20,11,1,2016,11,16475,2040,18515
2,20,11,1,2016,12,16825,2076,18901
2,20,11,1,2016,13,16313,2072,18385
2,20,11,1,2016,14,16358,1997,18355
2,20,11,1,2016,15,16144,1967,18111
2,20,11,1,2016,16,16170,1942,18112
2,20,11,1,2016,17,15439,1929,17368
2,20,11,1,2016,18,14267,1998,16265
2,20,11,1,2016,19,14040,2145,16185
2,20,11,1,2016,20,13765,2163,15928
2,20,11,1,2016,21,12605,2153,14758
2,20,11,1,2016,22,12270,2117,14387
2,20,11,1,2016,23,11385,2036,13421
2,20,11,1,2016,24,11538,1991,13529
1,21,11,1,2016,1,11868,1803,13671
1,21,11,1,2016,2,11857,1662,13519
1,21,11,1,2016,3,11963,1583,13546
1,21,11,1,2016,4,11990,1537,13527
1,21,11,1,2016,5,12516,1542,14058
1,21,11,1,2016,6,13414,1688,15102
1,21,11,1,2016,7,15083,1808,16891
1,21,11,1,2016,8,16346,1921,18267
1,21,11,1,2016,9,16571,2249,18820
1,21,11,1,2016,10,16628,2482,19110
1,21,11,1,2016,11,16850,2719,19569
1,21,11,1,2016,12,16864,2757,19621
1,21,11,1,2016,13,16702,2744,19446
1,21,11,1,2016,14,16748,2663,19411
1,21,11,1,2016,15,16500,2665,19165
1,21,11,1,2016,16,16562,2671,19233
1,21,11,1,2016,17,16059,2679,18738
1,21,11,1,2016,18,14577,2668,17245
1,21,11,1,2016,19,14679,2734,17413
1,21,11,1,2016,20,14140,2642,16782
1,21,11,1,2016,21,13502,2447,15949
1,21,11,1,2016,22,13224,2340,15564
1,21,11,1,2016,23,12424,2159,14583
1,21,11,1,2016,24,11956,2027,13983
1,22,11,1,2016,1,12397,1821,14218
1,22,11,1,2016,2,12280,1672,13952
1,22,11,1,2016,3,12239,1580,13819
1,22,11,1,2016,4,12463,1532,13995
1,22,11,1,2016,5,12887,1526,14413
1,22,11,1,2016,6,14047,1628,15675
1,22,11,1,2016,7,15578,1833,17411
1,22,11,1,2016,8,16982,1963,18945
1,22,11,1,2016,9,16640,2282,18922
1,22,11,1,2016,10,16860,2495,19355
1,22,11,1,2016,11,16973,2723,19696
1,22,11,1,2016,12,16979,2746,19725
1,22,11,1,2016,13,16745,2735,19480
1,22,11,1,2016,14,16743,2658,19401
1,22,11,1,2016,15,16815,2688,19503
1,22,11,1,2016,16,16325,2700,19025
1,22,11,1,2016,17,16856,2692,19548
1,22,11,1,2016,18,17056,2679,19735
1,22,11,1,2016,19,16528,2702,19230
1,22,11,1,2016,20,15347,2629,17976
1,22,11,1,2016,21,14907,2479,17386
1,22,11,1,2016,22,14337,2300,16637
1,22,11,1,2016,23,13451,2195,15646
1,22,11,1,2016,24,12574,1978,14552
1,23,11,1,2016,1,12326,1844,14170
1,23,11,1,2016,2,12547,1658,14205
1,23,11,1,2016,3,12436,1584,14020
1,23,11,1,2016,4,12526,1528,14054
1,23,11,1,2016,5,13108,1529,14637
1,23,11,1,2016,6,14174,1623,15797
1,23,11,1,2016,7,15550,1805,17355
1,23,11,1,2016,8,17078,1989,19067
1,23,11,1,2016,9,16954,2189,19143
1,23,11,1,2016,10,17180,2551,19731
1,23,11,1,2016,11,16930,2725,19655
1,23,11,1,2016,12,16622,2763,19385
1,23,11,1,2016,13,16179,2730,18909
1,23,11,1,2016,14,16335,2658,18993
1,23,11,1,2016,15,16479,2686,19165
1,23,11,1,2016,16,16484,2704,19188
1,23,11,1,2016,17,16451,2704,19155
1,23,11,1,2016,18,16572,2670,19242
1,23,11,1,2016,19,16428,2732,19160
1,23,11,1,2016,20,15524,2657,18181
1,23,11,1,2016,21,14975,2493,17468
1,23,11,1,2016,22,14528,2316,16844
1,23,11,1,2016,23,13969,2166,16135
1,23,11,1,2016,24,13415,2031,15446
1,24,11,1,2016,1,12797,1823,14620
1,24,11,1,2016,2,12495,1693,14188
1,24,11,1,2016,3,12543,1603,14146
1,24,11,1,2016,4,12704,1544,14248
1,24,11,1,2016,5,12906,1549,14455
1,24,11,1,2016,6,13889,1652,15541
1,24,11,1,2016,7,15723,1806,17529
1,24,11,1,2016,8,16754,2011,18765
1,24,11,1,2016,9,16814,2212,19026
1,24,11,1,2016,10,17226,2529,19755
1,24,11,1,2016,11,16983,2757,19740
1,24,11,1,2016,12,16405,2761,19166
1,24,11,1,2016,13,16199,2710,18909
1,24,11,1,2016,14,15809,2628,18437
1,24,11,1,2016,15,16173,2648,18821
1,24,11,1,2016,16,16200,2664,18864
1,24,11,1,2016,17,16318,2669,18987
1,24,11,1,2016,18,16653,2673,19326
1,24,11,1,2016,19,16309,2748,19057
1,24,11,1,2016,20,15341,2622,17963
1,24,11,1,2016,21,14836,2485,17321
1,24,11,1,2016,22,14784,2283,17067
1,24,11,1,2016,23,13634,2121,15755
1,24,11,1,2016,24,12837,2024,14861
1,25,11,1,2016,1,12806,1805,14611
1,25,11,1,2016,2,12749,1690,14439
1,25,11,1,2016,3,12543,1603,14146
1,25,11,1,2016,4,12609,1553,14162
1,25,11,1,2016,5,12922,1546,14468
1,25,11,1,2016,6,13819,1652,15471
1,25,11,1,2016,7,15560,1838,17398
1,25,11,1,2016,8,16781,1918,18699
1,25,11,1,2016,9,16995,2252,19247
1,25,11,1,2016,10,17274,2538,19812
1,25,11,1,2016,11,17015,2676,19691
1,25,11,1,2016,12,16595,2766,19361
1,25,11,1,2016,13,16423,2715,19138
1,25,11,1,2016,14,16384,2614,18998
1,25,11,1,2016,15,16243,2643,18886
1,25,11,1,2016,16,16144,2667,18811
1,25,11,1,2016,17,16155,2659,18814
1,25,11,1,2016,18,16873,2666,19539
1,25,11,1,2016,19,16524,2730,19254
1,25,11,1,2016,20,15446,2578,18024
1,25,11,1,2016,21,14958,2455,17413
1,25,11,1,2016,22,15021,2278,17299
1,25,11,1,2016,23,14108,2131,16239
1,25,11,1,2016,24,13085,2017,15102
2,26,11,1,2016,1,12594,1842,14436
2,26,11,1,2016,2,12649,1680,14329
2,26,11,1,2016,3,12649,1593,14242
2,26,11,1,2016,4,12609,1535,14144
2,26,11,1,2016,5,13031,1526,14557
2,26,11,1,2016,6,13874,1593,15467
2,26,11,1,2016,7,15573,1699,17272
2,26,11,1,2016,8,16873,1755,18628
2,26,11,1,2016,9,17022,1989,19011
2,26,11,1,2016,10,17113,2218,19331
2,26,11,1,2016,11,17050,2439,19489
2,26,11,1,2016,12,16591,2528,19119
2,26,11,1,2016,13,16555,2501,19056
2,26,11,1,2016,14,16467,2363,18830
2,26,11,1,2016,15,16580,2372,18952
2,26,11,1,2016,16,16498,2394,18892
2,26,11,1,2016,17,16452,2382,18834
2,26,11,1,2016,18,16986,2362,19348
2,26,11,1,2016,19,16741,2474,19215
2,26,11,1,2016,20,15623,2467,18090
2,26,11,1,2016,21,14970,2311,17281
2,26,11,1,2016,22,14918,2199,17117
2,26,11,1,2016,23,14023,2029,16052
2,26,11,1,2016,24,13163,1936,15099
2,27,11,1,2016,1,12683,1784,14467
2,27,11,1,2016,2,12811,1653,14464
2,27,11,1,2016,3,12687,1576,14263
2,27,11,1,2016,4,12876,1500,14376
2,27,11,1,2016,5,13228,1508,14736
2,27,11,1,2016,6,13782,1557,15339
2,27,11,1,2016,7,15364,1603,16967
2,27,11,1,2016,8,16356,1664,18020
2,27,11,1,2016,9,16605,1764,18369
2,27,11,1,2016,10,16964,1887,18851
2,27,11,1,2016,11,16990,2025,19015
2,27,11,1,2016,12,16739,2063,18802
2,27,11,1,2016,13,16504,2039,18543
2,27,11,1,2016,14,16371,1994,18365
2,27,11,1,2016,15,16296,1941,18237
2,27,11,1,2016,16,16331,1923,18254
2,27,11,1,2016,17,16191,1906,18097
2,27,11,1,2016,18,16669,1958,18627
2,27,11,1,2016,19,16208,2134,18342
2,27,11,1,2016,20,15054,2155,17209
2,27,11,1,2016,21,14646,2133,16779
2,27,11,1,2016,22,14346,2070,16416
2,27,11,1,2016,23,13496,1991,15487
2,27,11,1,2016,24,12875,1920,14795
1,28,11,1,2016,1,12764,1772,14536
1,28,11,1,2016,2,12603,1604,14207
1,28,11,1,2016,3,12422,1538,13960
1,28,11,1,2016,4,12447,1483,13930
1,28,11,1,2016,5,12876,1490,14366
1,28,11,1,2016,6,13690,1611,15301
1,28,11,1,2016,7,15129,1767,16896
1,28,11,1,2016,8,16823,1943,18766
1,28,11,1,2016,9,17248,2289,19537
1,28,11,1,2016,10,17391,2590,19981
1,28,11,1,2016,11,17472,2719,20191
1,28,11,1,2016,12,17173,2790,19963
1,28,11,1,2016,13,17010,2764,19774
1,28,11,1,2016,14,17035,2679,19714
1,28,11,1,2016,15,17023,2738,19761
1,28,11,1,2016,16,17207,2723,19930
1,28,11,1,2016,17,17075,2704,19779
1,28,11,1,2016,18,16747,2665,19412
1,28,11,1,2016,19,16552,2706,19258
1,28,11,1,2016,20,15918,2546,18464
1,28,11,1,2016,21,15337,2370,17707
1,28,11,1,2016,22,14986,2281,17267
1,28,11,1,2016,23,13959,2169,16128
1,28,11,1,2016,24,13149,2034,15183
1,29,11,1,2016,1,12846,1862,14708
1,29,11,1,2016,2,12394,1669,14063
1,29,11,1,2016,3,12542,1616,14158
1,29,11,1,2016,4,12736,1578,14314
1,29,11,1,2016,5,13115,1574,14689
1,29,11,1,2016,6,14064,1677,15741
1,29,11,1,2016,7,15482,1832,17314
1,29,11,1,2016,8,17345,2027,19372
1,29,11,1,2016,9,17486,2204,19690
1,29,11,1,2016,10,17457,2584,20041
1,29,11,1,2016,11,17397,2761,20158
1,29,11,1,2016,12,17132,2851,19983
1,29,11,1,2016,13,16949,2793,19742
1,29,11,1,2016,14,16918,2714,19632
1,29,11,1,2016,15,16880,2782,19662
1,29,11,1,2016,16,17125,2770,19895
1,29,11,1,2016,17,17047,2750,19797
1,29,11,1,2016,18,17241,2707,19948
1,29,11,1,2016,19,17370,2739,20109
1,29,11,1,2016,20,15924,2665,18589
1,29,11,1,2016,21,15227,2455,17682
1,29,11,1,2016,22,15323,2327,17650
1,29,11,1,2016,23,14227,2133,16360
1,29,11,1,2016,24,13295,2038,15333
1,30,11,1,2016,1,13114,1812,14926
1,30,11,1,2016,2,12935,1672,14607
1,30,11,1,2016,3,12902,1613,14515
1,30,11,1,2016,4,12778,1538,14316
1,30,11,1,2016,5,13491,1551,15042
1,30,11,1,2016,6,14183,1626,15809
1,30,11,1,2016,7,15657,1843,17500
1,30,11,1,2016,8,17184,1950,19134
1,30,11,1,2016,9,16907,2290,19197
1,30,11,1,2016,10,17550,2546,20096
1,30,11,1,2016,11,17340,2789,20129
1,30,11,1,2016,12,17070,2853,19923
1,30,11,1,2016,13,16600,2814,19414
1,30,11,1,2016,14,16737,2694,19431
1,30,11,1,2016,15,16646,2722,19368
1,30,11,1,2016,16,16811,2733,19544
1,30,11,1,2016,17,16838,2714,19552
1,30,11,1,2016,18,16922,2679,19601
1,30,11,1,2016,19,16974,2742,19716
1,30,11,1,2016,20,15805,2608,18413
1,30,11,1,2016,21,15330,2368,17698
1,30,11,1,2016,22,15055,2258,17313
1,30,11,1,2016,23,14293,2181,16474
1,30,11,1,2016,24,13452,2059,15511
1,1,12,1,2016,1,13018,1791,14809
1,1,12,1,2016,2,12810,1655,14465
1,1,12,1,2016,3,12698,1578,14276
1,1,12,1,2016,4,12779,1521,14300
1,1,12,1,2016,5,13343,1524,14867
1,1,12,1,2016,6,14190,1632,15822
1,1,12,1,2016,7,15532,1792,17324
1,1,12,1,2016,8,16882,1978,18860
1,1,12,1,2016,9,17181,2206,19387
1,1,12,1,2016,10,17396,2573,19969
1,1,12,1,2016,11,17119,2710,19829
1,1,12,1,2016,12,16551,2802,19353
1,1,12,1,2016,13,16545,2776,19321
1,1,12,1,2016,14,16528,2644,19172
1,1,12,1,2016,15,16356,2665,19021
1,1,12,1,2016,16,16558,2675,19233
1,1,12,1,2016,17,16643,2654,19297
1,1,12,1,2016,18,17090,2634,19724
1,1,12,1,2016,19,16975,2694,19669
1,1,12,1,2016,20,15300,2614,17914
1,1,12,1,2016,21,15101,2409,17510
1,1,12,1,2016,22,14439,2286,16725
1,1,12,1,2016,23,13558,2106,15664
1,1,12,1,2016,24,13027,1985,15012
1,2,12,1,2016,1,12757,1737,14494
1,2,12,1,2016,2,12503,1636,14139
1,2,12,1,2016,3,12517,1556,14073
1,2,12,1,2016,4,12643,1501,14144
1,2,12,1,2016,5,12948,1513,14461
1,2,12,1,2016,6,13711,1613,15324
1,2,12,1,2016,7,15297,1837,17134
1,2,12,1,2016,8,16591,1964,18555
1,2,12,1,2016,9,16837,2314,19151
1,2,12,1,2016,10,17094,2483,19577
1,2,12,1,2016,11,16731,2764,19495
1,2,12,1,2016,12,16496,2802,19298
1,2,12,1,2016,13,15979,2766,18745
1,2,12,1,2016,14,16347,2646,18993
1,2,12,1,2016,15,16257,2679,18936
1,2,12,1,2016,16,16181,2691,18872
1,2,12,1,2016,17,16395,2688,19083
1,2,12,1,2016,18,16755,2657,19412
1,2,12,1,2016,19,16454,2708,19162
1,2,12,1,2016,20,15455,2595,18050
1,2,12,1,2016,21,14814,2403,17217
1,2,12,1,2016,22,14388,2280,16668
1,2,12,1,2016,23,13555,2109,15664
1,2,12,1,2016,24,12966,2027,14993
2,3,12,1,2016,1,12329,1791,14120
2,3,12,1,2016,2,12090,1680,13770
2,3,12,1,2016,3,12356,1604,13960
2,3,12,1,2016,4,12354,1547,13901
2,3,12,1,2016,5,12731,1540,14271
2,3,12,1,2016,6,13493,1650,15143
2,3,12,1,2016,7,14982,1730,16712
2,3,12,1,2016,8,16710,1855,18565
2,3,12,1,2016,9,16829,1985,18814
2,3,12,1,2016,10,17121,2327,19448
2,3,12,1,2016,11,17163,2552,19715
2,3,12,1,2016,12,16478,2603,19081
2,3,12,1,2016,13,16115,2594,18709
2,3,12,1,2016,14,15998,2583,18581
2,3,12,1,2016,15,16386,2498,18884
2,3,12,1,2016,16,16418,2513,18931
2,3,12,1,2016,17,16593,2508,19101
2,3,12,1,2016,18,17237,2491,19728
2,3,12,1,2016,19,17116,2467,19583
2,3,12,1,2016,20,15583,2528,18111
2,3,12,1,2016,21,15321,2645,17966
2,3,12,1,2016,22,15110,2596,17706
2,3,12,1,2016,23,14064,2492,16556
2,3,12,1,2016,24,13105,2283,15388
2,4,12,1,2016,1,12675,1859,14534
2,4,12,1,2016,2,12603,1747,14350
2,4,12,1,2016,3,12506,1642,14148
2,4,12,1,2016,4,12720,1570,14290
2,4,12,1,2016,5,12954,1543,14497
2,4,12,1,2016,6,14055,1600,15655
2,4,12,1,2016,7,14965,1668,16633
2,4,12,1,2016,8,16736,1760,18496
2,4,12,1,2016,9,17035,1872,18907
2,4,12,1,2016,10,17291,1990,19281
2,4,12,1,2016,11,16944,2120,19064
2,4,12,1,2016,12,16726,2160,18886
2,4,12,1,2016,13,16065,2142,18207
2,4,12,1,2016,14,16213,2113,18326
2,4,12,1,2016,15,16425,2086,18511
2,4,12,1,2016,16,16338,2076,18414
2,4,12,1,2016,17,16294,2045,18339
2,4,12,1,2016,18,16285,2060,18345
2,4,12,1,2016,19,16609,2262,18871
2,4,12,1,2016,20,15260,2266,17526
2,4,12,1,2016,21,14797,2259,17056
2,4,12,1,2016,22,14875,2236,17111
2,4,12,1,2016,23,13871,2179,16050
2,4,12,1,2016,24,13294,2071,15365
1,5,12,1,2016,1,12926,1926,14852
1,5,12,1,2016,2,12565,1752,14317
1,5,12,1,2016,3,12640,1666,14306
1,5,12,1,2016,4,12659,1620,14279
1,5,12,1,2016,5,12840,1611,14451
1,5,12,1,2016,6,14089,1719,15808
1,5,12,1,2016,7,15213,1923,17136
1,5,12,1,2016,8,16719,2067,18786
1,5,12,1,2016,9,17168,2437,19605
1,5,12,1,2016,10,17764,2602,20366
1,5,12,1,2016,11,17285,2907,20192
1,5,12,1,2016,12,17019,2955,19974
1,5,12,1,2016,13,16975,2930,19905
1,5,12,1,2016,14,16948,2828,19776
1,5,12,1,2016,15,17290,2849,20139
1,5,12,1,2016,16,16789,2860,19649
1,5,12,1,2016,17,16831,2830,19661
1,5,12,1,2016,18,16577,2788,19365
1,5,12,1,2016,19,16793,2828,19621
1,5,12,1,2016,20,15762,2747,18509
1,5,12,1,2016,21,15495,2519,18014
1,5,12,1,2016,22,15270,2408,17678
1,5,12,1,2016,23,14384,2269,16653
1,5,12,1,2016,24,13587,2190,15777
1,6,12,1,2016,1,13180,1924,15104
1,6,12,1,2016,2,12712,1810,14522
1,6,12,1,2016,3,12836,1718,14554
1,6,12,1,2016,4,12809,1654,14463
1,6,12,1,2016,5,13267,1638,14905
1,6,12,1,2016,6,14281,1741,16022
1,6,12,1,2016,7,15671,1908,17579
1,6,12,1,2016,8,17422,2000,19422
1,6,12,1,2016,9,17434,2335,19769
1,6,12,1,2016,10,17554,2688,20242
1,6,12,1,2016,11,17544,2799,20343
1,6,12,1,2016,12,16869,2885,19754
1,6,12,1,2016,13,16554,2835,19389
1,6,12,1,2016,14,16625,2736,19361
1,6,12,1,2016,15,16609,2772,19381
1,6,12,1,2016,16,16798,2769,19567
1,6,12,1,2016,17,16827,2755,19582
1,6,12,1,2016,18,16422,2728,19150
1,6,12,1,2016,19,16777,2767,19544
1,6,12,1,2016,20,15807,2696,18503
1,6,12,1,2016,21,15185,2546,17731
1,6,12,1,2016,22,14385,2353,16738
1,6,12,1,2016,23,13820,2213,16033
1,6,12,1,2016,24,13400,2098,15498
1,7,12,1,2016,1,12695,1859,14554
1,7,12,1,2016,2,12706,1730,14436
1,7,12,1,2016,3,12598,1631,14229
1,7,12,1,2016,4,12745,1582,14327
1,7,12,1,2016,5,12909,1584,14493
1,7,12,1,2016,6,13631,1684,15315
1,7,12,1,2016,7,15906,1842,17748
1,7,12,1,2016,8,17036,2001,19037
1,7,12,1,2016,9,15973,2183,18156
1,7,12,1,2016,10,16183,2568,18751
1,7,12,1,2016,11,15800,2697,18497
1,7,12,1,2016,12,16335,2777,19112
1,7,12,1,2016,13,16413,2749,19162
1,7,12,1,2016,14,16583,2650,19233
1,7,12,1,2016,15,16829,2672,19501
1,7,12,1,2016,16,16790,2673,19463
1,7,12,1,2016,17,16801,2669,19470
1,7,12,1,2016,18,16210,2656,18866
1,7,12,1,2016,19,16305,2717,19022
1,7,12,1,2016,20,16084,2607,18691
1,7,12,1,2016,21,15302,2476,17778
1,7,12,1,2016,22,14802,2296,17098
1,7,12,1,2016,23,14162,2159,16321
1,7,12,1,2016,24,13372,2033,15405
1,8,12,1,2016,1,12698,1830,14528
1,8,12,1,2016,2,12572,1705,14277
1,8,12,1,2016,3,12610,1598,14208
1,8,12,1,2016,4,12771,1537,14308
1,8,12,1,2016,5,13118,1537,14655
1,8,12,1,2016,6,14039,1635,15674
1,8,12,1,2016,7,15307,1859,17166
1,8,12,1,2016,8,17188,1958,19146
1,8,12,1,2016,9,17292,2281,19573
1,8,12,1,2016,10,17598,2467,20065
1,8,12,1,2016,11,16246,2738,18984
1,8,12,1,2016,12,16554,2759,19313
1,8,12,1,2016,13,16721,2720,19441
1,8,12,1,2016,14,16831,2626,19457
1,8,12,1,2016,15,16709,2649,19358
1,8,12,1,2016,16,16481,2652,19133
1,8,12,1,2016,17,16619,2638,19257
1,8,12,1,2016,18,16154,2622,18776
1,8,12,1,2016,19,16138,2672,18810
1,8,12,1,2016,20,15966,2570,18536
1,8,12,1,2016,21,15244,2432,17676
1,8,12,1,2016,22,14806,2275,17081
1,8,12,1,2016,23,14041,2123,16164
1,8,12,1,2016,24,13357,1935,15292
1,9,12,1,2016,1,12527,1766,14293
1,9,12,1,2016,2,12226,1650,13876
1,9,12,1,2016,3,12386,1547,13933
1,9,12,1,2016,4,12512,1493,14005
1,9,12,1,2016,5,13036,1491,14527
1,9,12,1,2016,6,14015,1587,15602
1,9,12,1,2016,7,15292,1797,17089
1,9,12,1,2016,8,17030,1891,18921
1,9,12,1,2016,9,17313,2191,19504
1,9,12,1,2016,10,17274,2529,19803
1,9,12,1,2016,11,17484,2653,20137
1,9,12,1,2016,12,17049,2747,19796
1,9,12,1,2016,13,16547,2701,19248
1,9,12,1,2016,14,16520,2592,19112
1,9,12,1,2016,15,16567,2623,19190
1,9,12,1,2016,16,16393,2623,19016
1,9,12,1,2016,17,16504,2614,19118
1,9,12,1,2016,18,16602,2597,19199
1,9,12,1,2016,19,16430,2676,19106
1,9,12,1,2016,20,15534,2549,18083
1,9,12,1,2016,21,14796,2458,17254
1,9,12,1,2016,22,14460,2243,16703
1,9,12,1,2016,23,13467,2060,15527
1,9,12,1,2016,24,12809,1945,14754
2,10,12,1,2016,1,12074,1713,13787
2,10,12,1,2016,2,11841,1615,13456
2,10,12,1,2016,3,11771,1534,13305
2,10,12,1,2016,4,11865,1487,13352
2,10,12,1,2016,5,12515,1478,13993
2,10,12,1,2016,6,13271,1559,14830
2,10,12,1,2016,7,15020,1670,16690
2,10,12,1,2016,8,16450,1754,18204
2,10,12,1,2016,9,16690,1998,18688
2,10,12,1,2016,10,17345,2147,19492
2,10,12,1,2016,11,16993,2389,19382
2,10,12,1,2016,12,16917,2412,19329
2,10,12,1,2016,13,16363,2378,18741
2,10,12,1,2016,14,16491,2254,18745
2,10,12,1,2016,15,16406,2251,18657
2,10,12,1,2016,16,16280,2255,18535
2,10,12,1,2016,17,16351,2259,18610
2,10,12,1,2016,18,16503,2256,18759
2,10,12,1,2016,19,16641,2384,19025
2,10,12,1,2016,20,15244,2376,17620
2,10,12,1,2016,21,14813,2364,17177
2,10,12,1,2016,22,14486,2056,16542
2,10,12,1,2016,23,13363,1968,15331
2,10,12,1,2016,24,12258,1858,14116
2,11,12,1,2016,1,12220,1680,13900
2,11,12,1,2016,2,12153,1557,13710
2,11,12,1,2016,3,12345,1467,13812
2,11,12,1,2016,4,12439,1412,13851
2,11,12,1,2016,5,12986,1410,14396
2,11,12,1,2016,6,13271,1486,14757
2,11,12,1,2016,7,14692,1545,16237
2,11,12,1,2016,8,16190,1586,17776
2,11,12,1,2016,9,16711,1673,18384
2,11,12,1,2016,10,17097,1824,18921
2,11,12,1,2016,11,16956,1896,18852
2,11,12,1,2016,12,16539,1936,18475
2,11,12,1,2016,13,16128,1918,18046
2,11,12,1,2016,14,16113,1818,17931
2,11,12,1,2016,15,16160,1791,17951
2,11,12,1,2016,16,16310,1767,18077
2,11,12,1,2016,17,16179,1762,17941
2,11,12,1,2016,18,16229,1808,18037
2,11,12,1,2016,19,16222,2026,18248
2,11,12,1,2016,20,14800,2084,16884
2,11,12,1,2016,21,14751,2060,16811
2,11,12,1,2016,22,14256,2012,16268
2,11,12,1,2016,23,13317,1899,15216
2,11,12,1,2016,24,12475,1855,14330
3,12,12,1,2016,1,12255,1647,13902
3,12,12,1,2016,2,12180,1488,13668
3,12,12,1,2016,3,12023,1432,13455
3,12,12,1,2016,4,12197,1394,13591
3,12,12,1,2016,5,12355,1406,13761
3,12,12,1,2016,6,12897,1498,14395
3,12,12,1,2016,7,14102,1620,15722
3,12,12,1,2016,8,16495,1786,18281
3,12,12,1,2016,9,17280,2037,19317
3,12,12,1,2016,10,17741,2284,20025
3,12,12,1,2016,11,17507,2532,20039
3,12,12,1,2016,12,16817,2575,19392
3,12,12,1,2016,13,16832,2513,19345
3,12,12,1,2016,14,16813,2413,19226
3,12,12,1,2016,15,16831,2406,19237
3,12,12,1,2016,16,16900,2384,19284
3,12,12,1,2016,17,17119,2349,19468
3,12,12,1,2016,18,17209,2355,19564
3,12,12,1,2016,19,16626,2426,19052
3,12,12,1,2016,20,15664,2358,18022
3,12,12,1,2016,21,15178,2270,17448
3,12,12,1,2016,22,15055,2111,17166
3,12,12,1,2016,23,14202,1938,16140
3,12,12,1,2016,24,12884,1851,14735
1,13,12,1,2016,1,12193,1633,13826
1,13,12,1,2016,2,12286,1539,13825
1,13,12,1,2016,3,12112,1476,13588
1,13,12,1,2016,4,12112,1419,13532
1,13,12,1,2016,5,12720,1446,14166
1,13,12,1,2016,6,13479,1553,15032
1,13,12,1,2016,7,14946,1757,16703
1,13,12,1,2016,8,16720,1880,18600
1,13,12,1,2016,9,17166,2211,19377
1,13,12,1,2016,10,17681,2362,20043
1,13,12,1,2016,11,17249,2632,19881
1,13,12,1,2016,12,16443,2667,19110
1,13,12,1,2016,13,16118,2624,18742
1,13,12,1,2016,14,16341,2530,18871
1,13,12,1,2016,15,16195,2564,18759
1,13,12,1,2016,16,16310,2568,18878
1,13,12,1,2016,17,16471,2559,19030
1,13,12,1,2016,18,16704,2542,19246
1,13,12,1,2016,19,16744,2602,19346
1,13,12,1,2016,20,15613,2510,18123
1,13,12,1,2016,21,15174,2400,17574
1,13,12,1,2016,22,14548,2198,16746
1,13,12,1,2016,23,13810,2061,15871
1,13,12,1,2016,24,12828,1904,14732
1,14,12,1,2016,1,12543,1691,14234
1,14,12,1,2016,2,12312,1558,13870
1,14,12,1,2016,3,12573,1479,14052
1,14,12,1,2016,4,12580,1447,14027
1,14,12,1,2016,5,12792,1463,14255
1,14,12,1,2016,6,13775,1582,15357
1,14,12,1,2016,7,15278,1769,17047
1,14,12,1,2016,8,16639,1958,18597
1,14,12,1,2016,9,16691,2154,18845
1,14,12,1,2016,10,16458,2512,18970
1,14,12,1,2016,11,16354,2636,18990
1,14,12,1,2016,12,15833,2715,18548
1,14,12,1,2016,13,15383,2714,18097
1,14,12,1,2016,14,15685,2610,18295
1,14,12,1,2016,15,15759,2663,18422
1,14,12,1,2016,16,15769,2668,18437
1,14,12,1,2016,17,15894,2646,18540
1,14,12,1,2016,18,16453,2656,19109
1,14,12,1,2016,19,16453,2712,19165
1,14,12,1,2016,20,15482,2605,18087
1,14,12,1,2016,21,14879,2475,17354
1,14,12,1,2016,22,14323,2340,16663
1,14,12,1,2016,23,13246,2179,15425
1,14,12,1,2016,24,12682,2033,14715
1,15,12,1,2016,1,12405,1851,14256
1,15,12,1,2016,2,12246,1694,13940
1,15,12,1,2016,3,12123,1612,13735
1,15,12,1,2016,4,12283,1558,13841
1,15,12,1,2016,5,12610,1559,14169
1,15,12,1,2016,6,13907,1653,15560
1,15,12,1,2016,7,15265,1880,17145
1,15,12,1,2016,8,16757,2025,18782
1,15,12,1,2016,9,16847,2393,19240
1,15,12,1,2016,10,17104,2575,19679
1,15,12,1,2016,11,16936,2858,19794
1,15,12,1,2016,12,16451,2881,19332
1,15,12,1,2016,13,16273,2833,19106
1,15,12,1,2016,14,16359,2729,19088
1,15,12,1,2016,15,16343,2761,19104
1,15,12,1,2016,16,16463,2779,19242
1,15,12,1,2016,17,16879,2768,19647
1,15,12,1,2016,18,16493,2737,19230
1,15,12,1,2016,19,16997,2768,19765
1,15,12,1,2016,20,15510,2703,18213
1,15,12,1,2016,21,14869,2527,17396
1,15,12,1,2016,22,14438,2416,16854
1,15,12,1,2016,23,13739,2262,16001
1,15,12,1,2016,24,13386,2082,15468
1,16,12,1,2016,1,12798,1898,14696
1,16,12,1,2016,2,12636,1752,14388
1,16,12,1,2016,3,12574,1666,14240
1,16,12,1,2016,4,12743,1616,14359
1,16,12,1,2016,5,13119,1608,14727
1,16,12,1,2016,6,14066,1685,15751
1,16,12,1,2016,7,15181,1906,17087
1,16,12,1,2016,8,16518,2029,18547
1,16,12,1,2016,9,16849,2340,19189
1,16,12,1,2016,10,16949,2717,19666
1,16,12,1,2016,11,16584,2842,19426
1,16,12,1,2016,12,16765,2907,19672
1,16,12,1,2016,13,16454,2901,19355
1,16,12,1,2016,14,16369,2748,19117
1,16,12,1,2016,15,16336,2786,19122
1,16,12,1,2016,16,16261,2792,19053
1,16,12,1,2016,17,15838,2770,18608
1,16,12,1,2016,18,14265,2742,17007
1,16,12,1,2016,19,14568,2779,17347
1,16,12,1,2016,20,14129,2707,16836
1,16,12,1,2016,21,13432,2549,15981
1,16,12,1,2016,22,12615,2373,14988
1,16,12,1,2016,23,12440,2262,14702
1,16,12,1,2016,24,12558,2124,14682
2,17,12,1,2016,1,12780,1944,14724
2,17,12,1,2016,2,12954,1782,14736
2,17,12,1,2016,3,12560,1677,14237
2,17,12,1,2016,4,12912,1617,14529
2,17,12,1,2016,5,13051,1618,14669
2,17,12,1,2016,6,14222,1713,15935
2,17,12,1,2016,7,15350,1902,17252
2,17,12,1,2016,8,16440,2099,18539
2,17,12,1,2016,9,17291,2294,19585
2,17,12,1,2016,10,17305,2571,19876
2,17,12,1,2016,11,17291,2664,19955
2,17,12,1,2016,12,17202,2683,19885
2,17,12,1,2016,13,17096,2652,19748
2,17,12,1,2016,14,17044,2604,19648
2,17,12,1,2016,15,16584,2574,19158
2,17,12,1,2016,16,16913,2566,19479
2,17,12,1,2016,17,16346,2478,18824
2,17,12,1,2016,18,14955,2558,17513
2,17,12,1,2016,19,14918,2557,17475
2,17,12,1,2016,20,14261,2476,16737
2,17,12,1,2016,21,13411,2279,15690
2,17,12,1,2016,22,12815,2292,15107
2,17,12,1,2016,23,12539,2142,14681
2,17,12,1,2016,24,12510,2023,14533
2,18,12,1,2016,1,12805,1854,14659
2,18,12,1,2016,2,12945,1736,14681
2,18,12,1,2016,3,12740,1632,14372
2,18,12,1,2016,4,12911,1598,14509
2,18,12,1,2016,5,13232,1585,14817
2,18,12,1,2016,6,13878,1630,15508
2,18,12,1,2016,7,14852,1674,16526
2,18,12,1,2016,8,16356,1693,18049
2,18,12,1,2016,9,17031,1814,18845
2,18,12,1,2016,10,17078,1974,19052
2,18,12,1,2016,11,17123,2062,19185
2,18,12,1,2016,12,17062,2157,19219
2,18,12,1,2016,13,16918,2114,19032
2,18,12,1,2016,14,16649,1995,18644
2,18,12,1,2016,15,16493,1970,18463
2,18,12,1,2016,16,16642,1946,18588
2,18,12,1,2016,17,15615,1928,17543
2,18,12,1,2016,18,14185,1936,16121
2,18,12,1,2016,19,14321,2060,16381
2,18,12,1,2016,20,14024,2158,16182
2,18,12,1,2016,21,13037,2134,15171
2,18,12,1,2016,22,12314,2073,14387
2,18,12,1,2016,23,11856,2036,13892
2,18,12,1,2016,24,11972,1916,13888
1,19,12,1,2016,1,12400,1767,14167
1,19,12,1,2016,2,12230,1623,13853
1,19,12,1,2016,3,12242,1537,13779
1,19,12,1,2016,4,12447,1488,13935
1,19,12,1,2016,5,12756,1480,14236
1,19,12,1,2016,6,13524,1593,15117
1,19,12,1,2016,7,14947,1778,16725
1,19,12,1,2016,8,16408,1908,18316
1,19,12,1,2016,9,17017,2255,19272
1,19,12,1,2016,10,17370,2478,19848
1,19,12,1,2016,11,17075,2727,19802
1,19,12,1,2016,12,17270,2753,20023
1,19,12,1,2016,13,17021,2687,19708
1,19,12,1,2016,14,17200,2600,19800
1,19,12,1,2016,15,16921,2622,19543
1,19,12,1,2016,16,16975,2636,19611
1,19,12,1,2016,17,16254,2614,18868
1,19,12,1,2016,18,14761,2576,17337
1,19,12,1,2016,19,14797,2644,17441
1,19,12,1,2016,20,14558,2589,17147
1,19,12,1,2016,21,13586,2428,16014
1,19,12,1,2016,22,12576,2282,14858
1,19,12,1,2016,23,12057,2140,14197
1,19,12,1,2016,24,12525,1964,14489
1,20,12,1,2016,1,12508,1784,14292
1,20,12,1,2016,2,12480,1660,14140
1,20,12,1,2016,3,12506,1556,14062
1,20,12,1,2016,4,12579,1513,14092
1,20,12,1,2016,5,12968,1515,14483
1,20,12,1,2016,6,14000,1609,15609
1,20,12,1,2016,7,15612,1795,17407
1,20,12,1,2016,8,16771,1885,18656
1,20,12,1,2016,9,17047,2213,19260
1,20,12,1,2016,10,17404,2453,19857
1,20,12,1,2016,11,17455,2699,20154
1,20,12,1,2016,12,17000,2722,19722
1,20,12,1,2016,13,17220,2698,19918
1,20,12,1,2016,14,17003,2606,19609
1,20,12,1,2016,15,16801,2647,19448
1,20,12,1,2016,16,16835,2667,19502
1,20,12,1,2016,17,16483,2684,19167
1,20,12,1,2016,18,14894,2634,17528
1,20,12,1,2016,19,14827,2675,17502
1,20,12,1,2016,20,14274,2597,16871
1,20,12,1,2016,21,13516,2473,15989
1,20,12,1,2016,22,12542,2280,14822
1,20,12,1,2016,23,12286,2139,14425
1,20,12,1,2016,24,12153,1935,14088
1,21,12,1,2016,1,12767,1783,14550
1,21,12,1,2016,2,12580,1638,14218
1,21,12,1,2016,3,12516,1559,14075
1,21,12,1,2016,4,12579,1511,14090
1,21,12,1,2016,5,13094,1512,14606
1,21,12,1,2016,6,13907,1652,15559
1,21,12,1,2016,7,15619,1794,17413
1,21,12,1,2016,8,16669,1906,18575
1,21,12,1,2016,9,17698,2222,19920
1,21,12,1,2016,10,17524,2432,19956
1,21,12,1,2016,11,17377,2700,20077
1,21,12,1,2016,12,17283,2749,20032
1,21,12,1,2016,13,17231,2710,19941
1,21,12,1,2016,14,16669,2603,19272
1,21,12,1,2016,15,16984,2650,19634
1,21,12,1,2016,16,16822,2654,19476
1,21,12,1,2016,17,16519,2646,19165
1,21,12,1,2016,18,15034,2612,17646
1,21,12,1,2016,19,15163,2659,17822
1,21,12,1,2016,20,14378,2578,16956
1,21,12,1,2016,21,13608,2483,16091
1,21,12,1,2016,22,12729,2267,14996
1,21,12,1,2016,23,12242,2145,14387
1,21,12,1,2016,24,12414,1949,14363
1,22,12,1,2016,1,12559,1784,14343
1,22,12,1,2016,2,12712,1636,14348
1,22,12,1,2016,3,12650,1558,14208
1,22,12,1,2016,4,12770,1495,14265
1,22,12,1,2016,5,13099,1509,14608
1,22,12,1,2016,6,13963,1624,15587
1,22,12,1,2016,7,15616,1781,17397
1,22,12,1,2016,8,16930,1952,18882
1,22,12,1,2016,9,17397,2182,19579
1,22,12,1,2016,10,17505,2543,20048
1,22,12,1,2016,11,17416,2687,20103
1,22,12,1,2016,12,17457,2754,20211
1,22,12,1,2016,13,16997,2712,19709
1,22,12,1,2016,14,17067,2625,19692
1,22,12,1,2016,15,16708,2618,19326
1,22,12,1,2016,16,17089,2614,19703
1,22,12,1,2016,17,16479,2607,19086
1,22,12,1,2016,18,14835,2566,17401
1,22,12,1,2016,19,14527,2606,17133
1,22,12,1,2016,20,14386,2543,16929
1,22,12,1,2016,21,13308,2422,15730
1,22,12,1,2016,22,12594,2243,14837
1,22,12,1,2016,23,12283,2112,14395
1,22,12,1,2016,24,12162,1951,14113
1,23,12,1,2016,1,12695,1754,14449
1,23,12,1,2016,2,12568,1574,14142
1,23,12,1,2016,3,12636,1522,14158
1,23,12,1,2016,4,12655,1472,14127
1,23,12,1,2016,5,13234,1484,14718
1,23,12,1,2016,6,14278,1578,15856
1,23,12,1,2016,7,15151,1760,16911
1,23,12,1,2016,8,16527,1895,18422
1,23,12,1,2016,9,17202,2182,19384
1,23,12,1,2016,10,17093,2465,19558
1,23,12,1,2016,11,17028,2722,19750
1,23,12,1,2016,12,16934,2757,19691
1,23,12,1,2016,13,16632,2718,19350
1,23,12,1,2016,14,16638,2598,19236
1,23,12,1,2016,15,16348,2620,18968
1,23,12,1,2016,16,16316,2627,18942
1,23,12,1,2016,17,15445,2618,18063
1,23,12,1,2016,18,14115,2591,16706
1,23,12,1,2016,19,14301,2626,16927
1,23,12,1,2016,20,14333,2558,16891
1,23,12,1,2016,21,13111,2421,15532
1,23,12,1,2016,22,12351,2251,14602
1,23,12,1,2016,23,12092,2068,14160
1,23,12,1,2016,24,11995,1963,13958
2,24,12,1,2016,1,12344,1736,14080
2,24,12,1,2016,2,12386,1597,13983
2,24,12,1,2016,3,12362,1517,13879
2,24,12,1,2016,4,12440,1476,13916
2,24,12,1,2016,5,13138,1471,14609
2,24,12,1,2016,6,13993,1596,15589
2,24,12,1,2016,7,14992,1659,16651
2,24,12,1,2016,8,16585,1731,18316
2,24,12,1,2016,9,17166,1981,19147
2,24,12,1,2016,10,17318,2172,19490
2,24,12,1,2016,11,17102,2417,19519
2,24,12,1,2016,12,17489,2476,19965
2,24,12,1,2016,13,17067,2421,19488
2,24,12,1,2016,14,16527,2290,18817
2,24,12,1,2016,15,16508,2295,18803
2,24,12,1,2016,16,16638,2293,18931
2,24,12,1,2016,17,16103,2277,18380
2,24,12,1,2016,18,14610,2273,16883
2,24,12,1,2016,19,14398,2399,16797
2,24,12,1,2016,20,14121,2423,16544
2,24,12,1,2016,21,13156,2323,15479
2,24,12,1,2016,22,12517,2181,14698
2,24,12,1,2016,23,12122,2027,14149
2,24,12,1,2016,24,12264,1843,14107
3,25,12,1,2016,1,12548,1687,14235
3,25,12,1,2016,2,12508,1598,14106
3,25,12,1,2016,3,12433,1483,13916
3,25,12,1,2016,4,12573,1436,14009
3,25,12,1,2016,5,13085,1434,14519
3,25,12,1,2016,6,13797,1511,15308
3,25,12,1,2016,7,14392,1561,15953
3,25,12,1,2016,8,15741,1617,17358
3,25,12,1,2016,9,16949,1708,18657
3,25,12,1,2016,10,17014,1844,18858
3,25,12,1,2016,11,17230,1930,19160
3,25,12,1,2016,12,17289,1990,19279
3,25,12,1,2016,13,16823,1990,18813
3,25,12,1,2016,14,16573,1888,18461
3,25,12,1,2016,15,16350,1838,18188
3,25,12,1,2016,16,16718,1804,18522
3,25,12,1,2016,17,15747,1804,17551
3,25,12,1,2016,18,13874,1847,15721
3,25,12,1,2016,19,13812,2018,15830
3,25,12,1,2016,20,13684,2083,15767
3,25,12,1,2016,21,12607,2071,14678
3,25,12,1,2016,22,11513,1993,13506
3,25,12,1,2016,23,11250,1922,13172
3,25,12,1,2016,24,11303,1771,13074
1,26,12,1,2016,1,11968,1628,13596
1,26,12,1,2016,2,11995,1536,13531
1,26,12,1,2016,3,12028,1429,13457
1,26,12,1,2016,4,12041,1389,13430
1,26,12,1,2016,5,12292,1396,13688
1,26,12,1,2016,6,13413,1458,14871
1,26,12,1,2016,7,14582,1617,16199
1,26,12,1,2016,8,16575,1771,18346
1,26,12,1,2016,9,16913,2074,18987
1,26,12,1,2016,10,17118,2465,19583
1,26,12,1,2016,11,17350,2576,19926
1,26,12,1,2016,12,17605,2647,20252
1,26,12,1,2016,13,17510,2573,20083
1,26,12,1,2016,14,17415,2493,19908
1,26,12,1,2016,15,17273,2496,19769
1,26,12,1,2016,16,17227,2500,19727
1,26,12,1,2016,17,16773,2498,19271
1,26,12,1,2016,18,14535,2455,16990
1,26,12,1,2016,19,14631,2499,17130
1,26,12,1,2016,20,14351,2451,16802
1,26,12,1,2016,21,13471,2345,15816
1,26,12,1,2016,22,12442,2176,14618
1,26,12,1,2016,23,12058,1970,14028
1,26,12,1,2016,24,11846,1891,13737
1,27,12,1,2016,1,12171,1661,13832
1,27,12,1,2016,2,12195,1529,13724
1,27,12,1,2016,3,12431,1464,13895
1,27,12,1,2016,4,12649,1407,14056
1,27,12,1,2016,5,12840,1418,14258
1,27,12,1,2016,6,13332,1482,14814
1,27,12,1,2016,7,15137,1649,16786
1,27,12,1,2016,8,16674,1794,18468
1,27,12,1,2016,9,17414,2088,19502
1,27,12,1,2016,10,17516,2465,19981
1,27,12,1,2016,11,17648,2576,20224
1,27,12,1,2016,12,17510,2648,20158
1,27,12,1,2016,13,17166,2582,19748
1,27,12,1,2016,14,17271,2498,19769
1,27,12,1,2016,15,16920,2493,19413
1,27,12,1,2016,16,17051,2504,19555
1,27,12,1,2016,17,16340,2514,18854
1,27,12,1,2016,18,14986,2464,17450
1,27,12,1,2016,19,14614,2526,17140
1,27,12,1,2016,20,14585,2457,17042
1,27,12,1,2016,21,13309,2313,15622
1,27,12,1,2016,22,12442,2161,14603
1,27,12,1,2016,23,11846,2008,13854
1,27,12,1,2016,24,11930,1839,13769
1,28,12,1,2016,1,12229,1637,13866
1,28,12,1,2016,2,12101,1497,13598
1,28,12,1,2016,3,12300,1428,13728
1,28,12,1,2016,4,12339,1386,13725
1,28,12,1,2016,5,12741,1400,14141
1,28,12,1,2016,6,13550,1474,15024
1,28,12,1,2016,7,15179,1603,16782
1,28,12,1,2016,8,16648,1780,18428
1,28,12,1,2016,9,17093,2153,19246
1,28,12,1,2016,10,17483,2316,19799
1,28,12,1,2016,11,17446,2580,20026
1,28,12,1,2016,12,17521,2615,20136
1,28,12,1,2016,13,16887,2583,19470
1,28,12,1,2016,14,16903,2446,19349
1,28,12,1,2016,15,16967,2457,19424
1,28,12,1,2016,16,16731,2470,19201
1,28,12,1,2016,17,16359,2472,18831
1,28,12,1,2016,18,14789,2481,17270
1,28,12,1,2016,19,14616,2532,17148
1,28,12,1,2016,20,14158,2482,16640
1,28,12,1,2016,21,13512,2347,15859
1,28,12,1,2016,22,12426,2144,14570
1,28,12,1,2016,23,11801,1973,13774
1,28,12,1,2016,24,11740,1822,13562
1,29,12,1,2016,1,12256,1640,13896
1,29,12,1,2016,2,12347,1480,13827
1,29,12,1,2016,3,12313,1428,13741
1,29,12,1,2016,4,12691,1379,14070
1,29,12,1,2016,5,12969,1385,14354
1,29,12,1,2016,6,13002,1516,14518
1,29,12,1,2016,7,14657,1592,16249
1,29,12,1,2016,8,16581,1834,18415
1,29,12,1,2016,9,16949,2002,18951
1,29,12,1,2016,10,17662,2366,20028
1,29,12,1,2016,11,17584,2531,20116
1,29,12,1,2016,12,17579,2588,20167
1,29,12,1,2016,13,17090,2547,19637
1,29,12,1,2016,14,16847,2450,19297
1,29,12,1,2016,15,16806,2462,19268
1,29,12,1,2016,16,16794,2473,19267
1,29,12,1,2016,17,16448,2469,18917
1,29,12,1,2016,18,13976,2449,16425
1,29,12,1,2016,19,14280,2491,16771
1,29,12,1,2016,20,14158,2440,16598
1,29,12,1,2016,21,13071,2319,15390
1,29,12,1,2016,22,12759,2153,14912
1,29,12,1,2016,23,11860,1963,13823
1,29,12,1,2016,24,12188,1805,13993
1,30,12,1,2016,1,12366,1641,14007
1,30,12,1,2016,2,12398,1508,13906
1,30,12,1,2016,3,12437,1439,13876
1,30,12,1,2016,4,12651,1394,14045
1,30,12,1,2016,5,13011,1409,14420
1,30,12,1,2016,6,13440,1481,14921
1,30,12,1,2016,7,14795,1649,16444
1,30,12,1,2016,8,16667,1751,18418
1,30,12,1,2016,9,16752,2097,18849
1,30,12,1,2016,10,16754,2392,19146
1,30,12,1,2016,11,16897,2589,19486
1,30,12,1,2016,12,16942,2659,19601
1,30,12,1,2016,13,16631,2635,19266
1,30,12,1,2016,14,16326,2509,18835
1,30,12,1,2016,15,16091,2510,18601
1,30,12,1,2016,16,15997,2520,18517
1,30,12,1,2016,17,15875,2521,18396
1,30,12,1,2016,18,13826,2497,16323
1,30,12,1,2016,19,13876,2542,16418
1,30,12,1,2016,20,13706,2502,16208
1,30,12,1,2016,21,12975,2335,15310
1,30,12,1,2016,22,12284,2199,14483
1,30,12,1,2016,23,11794,1979,13773
1,30,12,1,2016,24,11796,1869,13665
2,31,12,1,2016,1,12369,1652,14021
2,31,12,1,2016,2,12312,1536,13848
2,31,12,1,2016,3,12367,1457,13824
2,31,12,1,2016,4,12338,1417,13755
2,31,12,1,2016,5,12896,1419,14315
2,31,12,1,2016,6,13466,1510,14976
2,31,12,1,2016,7,14558,1616,16174
2,31,12,1,2016,8,16312,1725,18037
2,31,12,1,2016,9,17145,1987,19132
2,31,12,1,2016,10,16980,2173,19153
2,31,12,1,2016,11,17269,2452,19721
2,31,12,1,2016,12,17468,2508,19976
2,31,12,1,2016,13,16804,2481,19285
2,31,12,1,2016,14,17181,2326,19507
2,31,12,1,2016,15,16429,2329,18758
2,31,12,1,2016,16,16704,2323,19027
2,31,12,1,2016,17,16206,2305,18511
2,31,12,1,2016,18,14259,2276,16535
2,31,12,1,2016,19,14159,2413,16572
2,31,12,1,2016,20,13699,2423,16122
2,31,12,1,2016,21,12946,2286,15232
2,31,12,1,2016,22,12100,2141,14241
2,31,12,1,2016,23,11476,1936,13412
2,31,12,1,2016,24,11664,1836,13500
2,1,1,1,2017,1,12029,1718,13747
2,1,1,1,2017,2,12316,1575,13891
2,1,1,1,2017,3,12013,1518,13531
2,1,1,1,2017,4,12108,1458,13566
2,1,1,1,2017,5,12302,1455,13757
2,1,1,1,2017,6,13126,1503,14629
2,1,1,1,2017,7,14084,1545,15629
2,1,1,1,2017,8,15983,1582,17565
2,1,1,1,2017,9,16526,1648,18174
2,1,1,1,2017,10,17162,1788,18950
2,1,1,1,2017,11,16869,1858,18727
2,1,1,1,2017,12,16976,1921,18897
2,1,1,1,2017,13,16948,1898,18846
2,1,1,1,2017,14,16520,1828,18348
2,1,1,1,2017,15,16154,1780,17934
2,1,1,1,2017,16,16077,1741,17818
2,1,1,1,2017,17,15204,1726,16930
2,1,1,1,2017,18,13500,1757,15257
2,1,1,1,2017,19,13234,1965,15199
2,1,1,1,2017,20,13259,2049,15308
2,1,1,1,2017,21,12427,2040,14467
2,1,1,1,2017,22,11732,2019,13751
2,1,1,1,2017,23,11498,1903,13401
2,1,1,1,2017,24,11618,1802,13420
1,2,1,1,2017,1,11793,1614,13407
1,2,1,1,2017,2,12160,1491,13651
1,2,1,1,2017,3,12134,1426,13560
1,2,1,1,2017,4,12162,1382,13544
1,2,1,1,2017,5,12549,1398,13947
1,2,1,1,2017,6,13585,1510,15095
1,2,1,1,2017,7,14983,1666,16649
1,2,1,1,2017,8,16641,1845,18486
1,2,1,1,2017,9,17182,2083,19265
1,2,1,1,2017,10,17284,2444,19728
1,2,1,1,2017,11,17407,2594,20001
1,2,1,1,2017,12,17626,2652,20278
1,2,1,1,2017,13,17034,2626,19660
1,2,1,1,2017,14,16917,2532,19449
1,2,1,1,2017,15,16677,2544,19221
1,2,1,1,2017,16,16880,2554,19434
1,2,1,1,2017,17,16527,2550,19077
1,2,1,1,2017,18,14319,2492,16811
1,2,1,1,2017,19,14308,2523,16831
1,2,1,1,2017,20,14095,2476,16571
1,2,1,1,2017,21,13198,2400,15598
1,2,1,1,2017,22,12527,2207,14734
1,2,1,1,2017,23,12108,2026,14134
1,2,1,1,2017,24,12173,1796,13969
1,3,1,1,2017,1,12420,1665,14085
1,3,1,1,2017,2,12532,1531,14063
1,3,1,1,2017,3,12425,1460,13885
1,3,1,1,2017,4,12643,1422,14065
1,3,1,1,2017,5,13044,1417,14461
1,3,1,1,2017,6,13629,1572,15201
1,3,1,1,2017,7,15563,1726,17289
1,3,1,1,2017,8,17081,1932,19013
1,3,1,1,2017,9,17576,2123,19699
1,3,1,1,2017,10,17436,2431,19867
1,3,1,1,2017,11,17205,2643,19848
1,3,1,1,2017,12,17333,2658,19991
1,3,1,1,2017,13,16996,2602,19598
1,3,1,1,2017,14,16723,2501,19224
1,3,1,1,2017,15,16703,2524,19227
1,3,1,1,2017,16,16991,2533,19524
1,3,1,1,2017,17,16446,2542,18988
1,3,1,1,2017,18,14687,2518,17205
1,3,1,1,2017,19,14776,2562,17338
1,3,1,1,2017,20,14694,2523,17217
1,3,1,1,2017,21,13543,2388,15931
1,3,1,1,2017,22,12770,2241,15011
1,3,1,1,2017,23,12045,2042,14087
1,3,1,1,2017,24,12139,1871,14010
1,4,1,1,2017,1,12329,1647,13976
1,4,1,1,2017,2,12307,1515,13822
1,4,1,1,2017,3,12326,1450,13776
1,4,1,1,2017,4,12816,1403,14219
1,4,1,1,2017,5,13066,1414,14480
1,4,1,1,2017,6,13810,1534,15344
1,4,1,1,2017,7,15490,1728,17218
1,4,1,1,2017,8,16864,1964,18828
1,4,1,1,2017,9,17076,2150,19226
1,4,1,1,2017,10,17505,2486,19991
1,4,1,1,2017,11,17934,2580,20514
1,4,1,1,2017,12,17915,2618,20533
1,4,1,1,2017,13,17370,2609,19979
1,4,1,1,2017,14,17194,2480,19674
1,4,1,1,2017,15,16951,2514,19465
1,4,1,1,2017,16,16936,2508,19444
1,4,1,1,2017,17,16494,2510,19004
1,4,1,1,2017,18,14789,2477,17266
1,4,1,1,2017,19,14563,2559,17122
1,4,1,1,2017,20,14800,2511,17311
1,4,1,1,2017,21,13940,2331,16271
1,4,1,1,2017,22,12892,2220,15112
1,4,1,1,2017,23,12472,1986,14458
1,4,1,1,2017,24,11895,1837,13732
1,5,1,1,2017,1,12030,1631,13661
1,5,1,1,2017,2,12222,1506,13728
1,5,1,1,2017,3,12256,1413,13669
1,5,1,1,2017,4,12444,1371,13815
1,5,1,1,2017,5,12712,1388,14100
1,5,1,1,2017,6,13699,1489,15188
1,5,1,1,2017,7,14986,1741,16727
1,5,1,1,2017,8,17114,1860,18974
1,5,1,1,2017,9,17481,2178,19659
1,5,1,1,2017,10,17631,2364,19995
1,5,1,1,2017,11,17670,2586,20256
1,5,1,1,2017,12,17606,2598,20204
1,5,1,1,2017,13,16908,2561,19469
1,5,1,1,2017,14,16753,2452,19205
1,5,1,1,2017,15,16887,2472,19359
1,5,1,1,2017,16,16555,2489,19044
1,5,1,1,2017,17,16597,2486,19083
1,5,1,1,2017,18,14288,2462,16750
1,5,1,1,2017,19,14684,2519,17203
1,5,1,1,2017,20,14587,2473,17060
1,5,1,1,2017,21,13553,2347,15900
1,5,1,1,2017,22,12657,2177,14834
1,5,1,1,2017,23,11884,2000,13884
1,5,1,1,2017,24,12132,1838,13970
1,6,1,1,2017,1,12537,1635,14172
1,6,1,1,2017,2,12610,1465,14075
1,6,1,1,2017,3,12557,1421,13978
1,6,1,1,2017,4,12719,1372,14091
1,6,1,1,2017,5,13105,1383,14488
1,6,1,1,2017,6,14286,1493,15779
1,6,1,1,2017,7,15315,1753,17068
1,6,1,1,2017,8,16752,1864,18616
1,6,1,1,2017,9,17637,2188,19825
1,6,1,1,2017,10,17471,2373,19844
1,6,1,1,2017,11,17410,2604,20014
1,6,1,1,2017,12,17333,2639,19972
1,6,1,1,2017,13,16840,2591,19431
1,6,1,1,2017,14,17085,2453,19538
1,6,1,1,2017,15,16275,2448,18723
1,6,1,1,2017,16,16167,2433,18600
1,6,1,1,2017,17,15377,2433,17810
1,6,1,1,2017,18,13566,2405,15971
1,6,1,1,2017,19,14116,2484,16600
1,6,1,1,2017,20,14061,2452,16513
1,6,1,1,2017,21,13452,2291,15743
1,6,1,1,2017,22,12603,2160,14763
1,6,1,1,2017,23,11958,1943,13901
1,6,1,1,2017,24,11849,1824,13673
2,7,1,1,2017,1,12407,1594,14001
2,7,1,1,2017,2,12628,1464,14092
2,7,1,1,2017,3,12252,1388,13640
2,7,1,1,2017,4,12586,1354,13940
2,7,1,1,2017,5,12793,1371,14164
2,7,1,1,2017,6,13720,1465,15185
2,7,1,1,2017,7,14939,1642,16581
2,7,1,1,2017,8,16691,1780,18471
2,7,1,1,2017,9,17629,2010,19639
2,7,1,1,2017,10,17658,2262,19920
2,7,1,1,2017,11,17589,2417,20006
2,7,1,1,2017,12,17857,2464,20321
2,7,1,1,2017,13,17120,2445,19565
2,7,1,1,2017,14,16828,2294,19122
2,7,1,1,2017,15,16595,2293,18888
2,7,1,1,2017,16,16640,2253,18893
2,7,1,1,2017,17,15671,2245,17916
2,7,1,1,2017,18,14515,2226,16741
2,7,1,1,2017,19,14640,2297,16937
2,7,1,1,2017,20,14417,2354,16771
2,7,1,1,2017,21,13444,2316,15760
2,7,1,1,2017,22,12825,2051,14876
2,7,1,1,2017,23,12319,1948,14267
2,7,1,1,2017,24,12347,1724,14071
2,8,1,1,2017,1,12560,1621,14181
2,8,1,1,2017,2,12596,1461,14057
2,8,1,1,2017,3,12501,1391,13892
2,8,1,1,2017,4,12795,1341,14136
2,8,1,1,2017,5,13097,1344,14441
2,8,1,1,2017,6,13736,1435,15171
2,8,1,1,2017,7,14754,1528,16282
2,8,1,1,2017,8,16296,1575,17871
2,8,1,1,2017,9,17108,1712,18820
2,8,1,1,2017,10,17588,1867,19455
2,8,1,1,2017,11,17773,1962,19735
2,8,1,1,2017,12,17696,1975,19671
2,8,1,1,2017,13,17170,1950,19120
2,8,1,1,2017,14,16998,1881,18879
2,8,1,1,2017,15,16590,1793,18383
2,8,1,1,2017,16,16686,1738,18424
2,8,1,1,2017,17,15671,1730,17401
2,8,1,1,2017,18,13926,1778,15704
2,8,1,1,2017,19,13770,1947,15717
2,8,1,1,2017,20,14278,2036,16314
2,8,1,1,2017,21,13090,2032,15122
2,8,1,1,2017,22,12479,1982,14461
2,8,1,1,2017,23,12136,1836,13972
2,8,1,1,2017,24,12114,1719,13833
1,9,1,1,2017,1,12505,1549,14054
1,9,1,1,2017,2,12615,1393,14008
1,9,1,1,2017,3,12674,1337,14011
1,9,1,1,2017,4,12753,1312,14065
1,9,1,1,2017,5,13087,1326,14413
1,9,1,1,2017,6,13803,1441,15244
1,9,1,1,2017,7,15529,1729,17258
1,9,1,1,2017,8,17075,1864,18939
1,9,1,1,2017,9,17561,2195,19756
1,9,1,1,2017,10,17728,2366,20094
1,9,1,1,2017,11,17487,2576,20063
1,9,1,1,2017,12,17761,2581,20342
1,9,1,1,2017,13,17274,2527,19801
1,9,1,1,2017,14,16970,2405,19375
1,9,1,1,2017,15,16853,2402,19255
1,9,1,1,2017,16,16957,2390,19347
1,9,1,1,2017,17,16240,2392,18632
1,9,1,1,2017,18,14460,2360,16820
1,9,1,1,2017,19,14396,2411,16807
1,9,1,1,2017,20,14485,2387,16872
1,9,1,1,2017,21,13568,2312,15880
1,9,1,1,2017,22,12927,2080,15007
1,9,1,1,2017,23,12447,1961,14408
1,9,1,1,2017,24,12125,1701,13826
1,10,1,1,2017,1,12695,1541,14236
1,10,1,1,2017,2,12686,1409,14095
1,10,1,1,2017,3,12704,1342,14046
1,10,1,1,2017,4,12719,1298,14017
1,10,1,1,2017,5,13248,1322,14570
1,10,1,1,2017,6,14041,1458,15499
1,10,1,1,2017,7,15106,1696,16802
1,10,1,1,2017,8,17272,1867,19139
1,10,1,1,2017,9,17725,2072,19797
1,10,1,1,2017,10,17889,2350,20239
1,10,1,1,2017,11,17734,2486,20220
1,10,1,1,2017,12,17652,2513,20165
1,10,1,1,2017,13,17230,2453,19683
1,10,1,1,2017,14,16990,2297,19287
1,10,1,1,2017,15,16788,2319,19107
1,10,1,1,2017,16,16927,2308,19235
1,10,1,1,2017,17,16432,2329,18761
1,10,1,1,2017,18,14741,2325,17066
1,10,1,1,2017,19,14681,2399,17080
1,10,1,1,2017,20,14727,2392,17119
1,10,1,1,2017,21,13539,2261,15800
1,10,1,1,2017,22,12786,2087,14873
1,10,1,1,2017,23,12415,1865,14280
1,10,1,1,2017,24,12471,1665,14136
1,11,1,1,2017,1,12609,1454,14063
1,11,1,1,2017,2,12584,1355,13939
1,11,1,1,2017,3,12703,1292,13995
1,11,1,1,2017,4,12823,1261,14084
1,11,1,1,2017,5,12997,1277,14274
1,11,1,1,2017,6,13955,1420,15375
1,11,1,1,2017,7,15234,1677,16911
1,11,1,1,2017,8,17049,1873,18922
1,11,1,1,2017,9,17734,2033,19767
1,11,1,1,2017,10,17630,2325,19955
1,11,1,1,2017,11,17645,2428,20073
1,11,1,1,2017,12,17362,2453,19815
1,11,1,1,2017,13,17036,2394,19430
1,11,1,1,2017,14,16935,2282,19217
1,11,1,1,2017,15,16559,2303,18862
1,11,1,1,2017,16,16823,2288,19111
1,11,1,1,2017,17,15921,2302,18223
1,11,1,1,2017,18,14821,2291,17112
1,11,1,1,2017,19,14818,2393,17211
1,11,1,1,2017,20,14581,2364,16945
1,11,1,1,2017,21,14083,2185,16268
1,11,1,1,2017,22,12922,2024,14946
1,11,1,1,2017,23,12375,1820,14195
1,11,1,1,2017,24,12480,1643,14123
1,12,1,1,2017,1,12478,1416,13894
1,12,1,1,2017,2,12489,1290,13779
1,12,1,1,2017,3,12608,1228,13836
1,12,1,1,2017,4,12749,1194,13943
1,12,1,1,2017,5,13006,1216,14222
1,12,1,1,2017,6,14075,1360,15435
1,12,1,1,2017,7,15161,1647,16808
1,12,1,1,2017,8,16660,1793,18453
1,12,1,1,2017,9,17470,2099,19569
1,12,1,1,2017,10,17595,2248,19843
1,12,1,1,2017,11,17412,2398,19810
1,12,1,1,2017,12,17404,2404,19808
1,12,1,1,2017,13,17110,2328,19438
1,12,1,1,2017,14,16764,2238,19002
1,12,1,1,2017,15,16598,2247,18845
1,12,1,1,2017,16,16618,2247,18865
1,12,1,1,2017,17,15957,2257,18214
1,12,1,1,2017,18,14712,2250,16962
1,12,1,1,2017,19,14507,2235,16742
1,12,1,1,2017,20,14566,2301,16867
1,12,1,1,2017,21,14049,2155,16204
1,12,1,1,2017,22,12899,2037,14936
1,12,1,1,2017,23,12321,1801,14122
1,12,1,1,2017,24,12033,1633,13666
1,13,1,1,2017,1,12468,1391,13859
1,13,1,1,2017,2,12248,1302,13550
1,13,1,1,2017,3,12259,1249,13508
1,13,1,1,2017,4,12392,1222,13614
1,13,1,1,2017,5,12707,1243,13950
1,13,1,1,2017,6,13697,1346,15043
1,13,1,1,2017,7,15378,1641,17019
1,13,1,1,2017,8,16877,1780,18657
1,13,1,1,2017,9,17599,2076,19675
1,13,1,1,2017,10,17328,2305,19633
1,13,1,1,2017,11,17445,2461,19906
1,13,1,1,2017,12,17250,2478,19728
1,13,1,1,2017,13,16869,2436,19305
1,13,1,1,2017,14,16741,2322,19063
1,13,1,1,2017,15,16370,2315,18685
1,13,1,1,2017,16,16402,2318,18720
1,13,1,1,2017,17,15502,2319,17821
1,13,1,1,2017,18,14081,2309,16390
1,13,1,1,2017,19,14320,2360,16680
1,13,1,1,2017,20,14447,2346,16793
1,13,1,1,2017,21,13706,2219,15925
1,13,1,1,2017,22,12858,2046,14904
1,13,1,1,2017,23,12100,1824,13924
1,13,1,1,2017,24,12228,1700,13928
2,14,1,1,2017,1,11979,1456,13435
2,14,1,1,2017,2,12097,1351,13448
2,14,1,1,2017,3,12187,1291,13478
2,14,1,1,2017,4,12309,1250,13559
2,14,1,1,2017,5,12439,1272,13711
2,14,1,1,2017,6,13430,1382,14812
2,14,1,1,2017,7,14955,1518,16473
2,14,1,1,2017,8,16123,1711,17834
2,14,1,1,2017,9,17713,1887,19600
2,14,1,1,2017,10,17448,2148,19596
2,14,1,1,2017,11,17149,2278,19427
2,14,1,1,2017,12,17298,2284,19582
2,14,1,1,2017,13,17089,2274,19363
2,14,1,1,2017,14,16591,2129,18720
2,14,1,1,2017,15,16759,2112,18871
2,14,1,1,2017,16,16666,2096,18762
2,14,1,1,2017,17,16013,2079,18092
2,14,1,1,2017,18,14725,2064,16789
2,14,1,1,2017,19,14324,2219,16543
2,14,1,1,2017,20,14210,2283,16493
2,14,1,1,2017,21,13558,2191,15749
2,14,1,1,2017,22,12707,2069,14776
2,14,1,1,2017,23,12146,1905,14051
2,14,1,1,2017,24,12526,1694,14220
2,15,1,1,2017,1,12329,1547,13876
2,15,1,1,2017,2,12296,1435,13731
2,15,1,1,2017,3,12275,1349,13624
2,15,1,1,2017,4,12264,1321,13585
2,15,1,1,2017,5,12572,1324,13896
2,15,1,1,2017,6,13067,1387,14454
2,15,1,1,2017,7,14225,1499,15724
2,15,1,1,2017,8,15807,1564,17371
2,15,1,1,2017,9,17187,1726,18913
2,15,1,1,2017,10,16996,1830,18826
2,15,1,1,2017,11,16636,1965,18601
2,15,1,1,2017,12,17399,1961,19360
2,15,1,1,2017,13,17431,1960,19391
2,15,1,1,2017,14,16625,1893,18518
2,15,1,1,2017,15,16302,1810,18112
2,15,1,1,2017,16,16236,1779,18015
2,15,1,1,2017,17,15680,1783,17463
2,15,1,1,2017,18,14723,1827,16550
2,15,1,1,2017,19,14754,1960,16714
2,15,1,1,2017,20,14293,2063,16356
2,15,1,1,2017,21,12994,2075,15069
2,15,1,1,2017,22,12874,1910,14784
2,15,1,1,2017,23,12322,1886,14208
2,15,1,1,2017,24,12220,1698,13918
1,16,1,1,2017,1,1537,13991,13991
1,16,1,1,2017,2,12504,1405,13909
1,16,1,1,2017,3,12399,1353,13752
1,16,1,1,2017,4,12650,1323,13973
1,16,1,1,2017,5,12868,1351,14219
1,16,1,1,2017,6,13647,1467,15114
1,16,1,1,2017,7,15108,1729,16837
1,16,1,1,2017,8,16729,1856,18585
1,16,1,1,2017,9,17311,2162,19473
1,16,1,1,2017,10,16943,2361,19304
1,16,1,1,2017,11,16884,2562,19446
1,16,1,1,2017,12,17584,2578,20162
1,16,1,1,2017,13,17285,2548,19833
1,16,1,1,2017,14,17329,2415,19744
1,16,1,1,2017,15,16923,2418,19341
1,16,1,1,2017,16,17002,2426,19428
1,16,1,1,2017,17,16424,2429,18853
1,16,1,1,2017,18,15781,2406,18187
1,16,1,1,2017,19,15313,2454,17767
1,16,1,1,2017,20,14585,2441,17026
1,16,1,1,2017,21,13510,2266,15776
1,16,1,1,2017,22,13238,2105,15343
1,16,1,1,2017,23,12678,1916,14594
1,16,1,1,2017,24,12419,1755,14174
1,17,1,1,2017,1,12655,1547,14202
1,17,1,1,2017,2,12659,1432,14091
1,17,1,1,2017,3,12747,1365,14112
1,17,1,1,2017,4,12836,1335,14171
1,17,1,1,2017,5,13117,1358,14475
1,17,1,1,2017,6,14129,1487,15616
1,17,1,1,2017,7,15545,1706,17251
1,17,1,1,2017,8,16847,1896,18743
1,17,1,1,2017,9,17328,2168,19496
1,17,1,1,2017,10,16821,2371,19192
1,17,1,1,2017,11,16650,2558,19208
1,17,1,1,2017,12,17599,2552,20151
1,17,1,1,2017,13,17157,2500,19657
1,17,1,1,2017,14,16968,2388,19356
1,17,1,1,2017,15,16873,2411,19284
1,17,1,1,2017,16,16998,2401,19399
1,17,1,1,2017,17,16345,2399,18744
1,17,1,1,2017,18,15669,2373,18042
1,17,1,1,2017,19,15432,2425,17857
1,17,1,1,2017,20,14937,2383,17320
1,17,1,1,2017,21,13834,2260,16094
1,17,1,1,2017,22,13158,2067,15225
1,17,1,1,2017,23,12585,1870,14455
1,17,1,1,2017,24,12793,1659,14452
1,18,1,1,2017,1,12809,1532,14341
1,18,1,1,2017,2,12796,1368,14164
1,18,1,1,2017,3,12646,1310,13956
1,18,1,1,2017,4,12774,1286,14060
1,18,1,1,2017,5,13315,1303,14618
1,18,1,1,2017,6,13873,1417,15290
1,18,1,1,2017,7,15540,1707,17247
1,18,1,1,2017,8,16752,1883,18635
1,18,1,1,2017,9,17331,2088,19419
1,18,1,1,2017,10,16783,2378,19161
1,18,1,1,2017,11,16489,2458,18947
1,18,1,1,2017,12,16721,2504,19225
1,18,1,1,2017,13,16900,2454,19354
1,18,1,1,2017,14,16322,2362,18684
1,18,1,1,2017,15,16584,2373,18957
1,18,1,1,2017,16,16743,2382,19125
1,18,1,1,2017,17,15972,2387,18359
1,18,1,1,2017,18,16031,2387,18418
1,18,1,1,2017,19,15277,2423,17700
1,18,1,1,2017,20,14683,2413,17096
1,18,1,1,2017,21,13766,2320,16086
1,18,1,1,2017,22,13243,2116,15359
1,18,1,1,2017,23,12690,1896,14586
1,18,1,1,2017,24,12643,1721,14364
1,19,1,1,2017,1,12617,1555,14172
1,19,1,1,2017,2,12565,1406,13971
1,19,1,1,2017,3,12616,1341,13957
1,19,1,1,2017,4,12720,1307,14027
1,19,1,1,2017,5,13079,1327,14406
1,19,1,1,2017,6,13832,1468,15300
1,19,1,1,2017,7,15383,1742,17125
1,19,1,1,2017,8,16725,1897,18622
1,19,1,1,2017,9,17185,2236,19421
1,19,1,1,2017,10,16724,2395,19119
1,19,1,1,2017,11,16482,2579,19061
1,19,1,1,2017,12,17138,2585,19723
1,19,1,1,2017,13,17072,2553,19625
1,19,1,1,2017,14,16703,2429,19132
1,19,1,1,2017,15,16566,2454,19020
1,19,1,1,2017,16,16800,2463,19263
1,19,1,1,2017,17,16589,2461,19050
1,19,1,1,2017,18,15737,2448,18185
1,19,1,1,2017,19,15204,2501,17705
1,19,1,1,2017,20,14706,2479,17185
1,19,1,1,2017,21,13819,2330,16149
1,19,1,1,2017,22,13522,2165,15687
1,19,1,1,2017,23,12660,1967,14627
1,19,1,1,2017,24,12622,1782,14404
1,20,1,1,2017,1,12677,1567,14244
1,20,1,1,2017,2,12750,1430,14180
1,20,1,1,2017,3,12602,1363,13965
1,20,1,1,2017,4,12970,1335,14305
1,20,1,1,2017,5,12924,1350,14274
1,20,1,1,2017,6,14163,1486,15649
1,20,1,1,2017,7,15311,1708,17019
1,20,1,1,2017,8,16901,1911,18812
1,20,1,1,2017,9,17529,2220,19749
1,20,1,1,2017,10,16540,2414,18954
1,20,1,1,2017,11,16324,2611,18935
1,20,1,1,2017,12,16851,2627,19478
1,20,1,1,2017,13,16711,2568,19279
1,20,1,1,2017,14,16272,2460,18732
1,20,1,1,2017,15,16245,2463,18708
1,20,1,1,2017,16,16484,2450,18934
1,20,1,1,2017,17,15425,2464,17889
1,20,1,1,2017,18,14955,2446,17401
1,20,1,1,2017,19,14773,2499,17272
1,20,1,1,2017,20,14492,2482,16974
1,20,1,1,2017,21,13722,2298,16020
1,20,1,1,2017,22,12930,2182,15112
1,20,1,1,2017,23,12377,1953,14330
1,20,1,1,2017,24,12692,1793,14485
2,21,1,1,2017,1,12549,1581,14130
2,21,1,1,2017,2,12419,1474,13893
2,21,1,1,2017,3,12454,1403,13857
2,21,1,1,2017,4,12640,1360,14000
2,21,1,1,2017,5,12790,1372,14162
2,21,1,1,2017,6,13881,1514,15395
2,21,1,1,2017,7,14917,1650,16567
2,21,1,1,2017,8,16875,1836,18711
2,21,1,1,2017,9,17313,2013,19326
2,21,1,1,2017,10,16575,2338,18913
2,21,1,1,2017,11,16715,2447,19162
2,21,1,1,2017,12,17343,2506,19849
2,21,1,1,2017,13,17289,2473,19762
2,21,1,1,2017,14,16837,2350,19187
2,21,1,1,2017,15,16509,2325,18834
2,21,1,1,2017,16,16674,2319,18993
2,21,1,1,2017,17,16334,2330,18664
2,21,1,1,2017,18,15586,2320,17906
2,21,1,1,2017,19,15331,2348,17679
2,21,1,1,2017,20,14687,2353,17040
2,21,1,1,2017,21,14045,2237,16282
2,21,1,1,2017,22,13335,2131,15466
2,21,1,1,2017,23,12836,1999,14835
2,21,1,1,2017,24,12734,1891,14625
2,22,1,1,2017,1,12733,1738,14471
2,22,1,1,2017,2,12646,1656,14302
2,22,1,1,2017,3,12467,1610,14077
2,22,1,1,2017,4,12649,1584,14233
2,22,1,1,2017,5,12490,1591,14081
2,22,1,1,2017,6,13427,1637,15064
2,22,1,1,2017,7,14653,1744,16397
2,22,1,1,2017,8,16095,1820,17915
2,22,1,1,2017,9,17480,1876,19356
2,22,1,1,2017,10,16581,1900,18481
2,22,1,1,2017,11,16899,1987,18886
2,22,1,1,2017,12,17784,2032,19816
2,22,1,1,2017,13,17225,2048,19273
2,22,1,1,2017,14,16839,1959,18798
2,22,1,1,2017,15,16643,1920,18563
2,22,1,1,2017,16,16344,1858,18202
2,22,1,1,2017,17,16000,1853,17853
2,22,1,1,2017,18,15418,1870,17288
2,22,1,1,2017,19,14668,2004,16672
2,22,1,1,2017,20,14160,2088,16248
2,22,1,1,2017,21,13602,2033,15635
2,22,1,1,2017,22,12964,1972,14936
2,22,1,1,2017,23,12597,1893,14490
2,22,1,1,2017,24,12723,1787,14510
1,23,1,1,2017,1,12775,1597,14372
1,23,1,1,2017,2,12653,1494,14147
1,23,1,1,2017,3,12807,1429,14236
1,23,1,1,2017,4,12709,1384,14093
1,23,1,1,2017,5,13149,1399,14548
1,23,1,1,2017,6,14354,1535,15889
1,23,1,1,2017,7,15012,1740,16752
1,23,1,1,2017,8,17012,1940,18952
1,23,1,1,2017,9,17495,2241,19736
1,23,1,1,2017,10,16862,2488,19350
1,23,1,1,2017,11,16975,2720,19695
1,23,1,1,2017,12,17873,2726,20599
1,23,1,1,2017,13,17825,2695,20520
1,23,1,1,2017,14,17513,2584,20097
1,23,1,1,2017,15,17545,2612,20157
1,23,1,1,2017,16,17508,2637,20145
1,23,1,1,2017,17,16833,2610,19443
1,23,1,1,2017,18,16346,2578,18924
1,23,1,1,2017,19,15362,2549,17911
1,23,1,1,2017,20,15027,2561,17588
1,23,1,1,2017,21,14292,2504,16796
1,23,1,1,2017,22,13641,2219,15860
1,23,1,1,2017,23,13267,2077,15344
1,23,1,1,2017,24,13385,1871,15256
1,24,1,1,2017,1,13398,1727,15125
1,24,1,1,2017,2,13321,1594,14915
1,24,1,1,2017,3,13398,1513,14911
1,24,1,1,2017,4,13045,1471,14516
1,24,1,1,2017,5,13609,1487,15096
1,24,1,1,2017,6,14452,1641,16093
1,24,1,1,2017,7,15943,1822,17765
1,24,1,1,2017,8,17178,1998,19176
1,24,1,1,2017,9,17585,2311,19896
1,24,1,1,2017,10,17399,2542,19941
1,24,1,1,2017,11,16947,2703,19650
1,24,1,1,2017,12,17781,2779,20560
1,24,1,1,2017,13,17568,2775,20343
1,24,1,1,2017,14,17516,2630,20146
1,24,1,1,2017,15,17410,2662,20072
1,24,1,1,2017,16,17467,2677,20144
1,24,1,1,2017,17,17113,2686,19799
1,24,1,1,2017,18,16020,2651,18671
1,24,1,1,2017,19,15554,2633,18187
1,24,1,1,2017,20,15440,2631,18071
1,24,1,1,2017,21,14244,2488,16732
1,24,1,1,2017,22,13826,2281,16107
1,24,1,1,2017,23,13229,2161,15390
1,24,1,1,2017,24,13574,1928,15502
1,25,1,1,2017,1,13559,1774,15333
1,25,1,1,2017,2,13358,1631,14989
1,25,1,1,2017,3,13310,1555,14865
1,25,1,1,2017,4,13501,1514,15015
1,25,1,1,2017,5,13711,1520,15231
1,25,1,1,2017,6,14572,1680,16252
1,25,1,1,2017,7,15879,1858,17737
1,25,1,1,2017,8,17420,1993,19413
1,25,1,1,2017,9,17844,2318,20162
1,25,1,1,2017,10,17153,2564,19717
1,25,1,1,2017,11,16635,2769,19404
1,25,1,1,2017,12,17648,2776,20424
1,25,1,1,2017,13,17367,2723,20090
1,25,1,1,2017,14,17494,2646,20140
1,25,1,1,2017,15,17358,2685,20043
1,25,1,1,2017,16,17398,2684,20082
1,25,1,1,2017,17,17042,2670,19712
1,25,1,1,2017,18,16385,2644,19029
1,25,1,1,2017,19,15773,2666,18439
1,25,1,1,2017,20,15251,2667,17918
1,25,1,1,2017,21,14392,2496,16888
1,25,1,1,2017,22,13619,2344,15963
1,25,1,1,2017,23,13443,2153,15596
1,25,1,1,2017,24,13439,1949,15388
3,26,1,1,2017,1,13658,1813,15471
3,26,1,1,2017,2,13548,1699,15247
3,26,1,1,2017,3,13526,1584,15110
3,26,1,1,2017,4,13495,1533,15028
3,26,1,1,2017,5,13955,1537,15492
3,26,1,1,2017,6,14926,1618,16544
3,26,1,1,2017,7,16351,1750,18101
3,26,1,1,2017,8,16468,1766,18234
3,26,1,1,2017,9,16024,1872,17896
3,26,1,1,2017,10,14995,1965,16960
3,26,1,1,2017,11,14877,2027,16904
3,26,1,1,2017,12,15868,2063,17931
3,26,1,1,2017,13,15791,2047,17838
3,26,1,1,2017,14,15965,1968,17933
3,26,1,1,2017,15,15295,1932,17227
3,26,1,1,2017,16,15321,1903,17224
3,26,1,1,2017,17,14847,1906,16753
3,26,1,1,2017,18,13962,1927,15889
3,26,1,1,2017,19,13758,2038,15796
3,26,1,1,2017,20,13029,2173,15202
3,26,1,1,2017,21,12608,2153,14761
3,26,1,1,2017,22,11707,2072,13779
3,26,1,1,2017,23,11622,1965,13587
3,26,1,1,2017,24,11631,1840,13471
1,27,1,1,2017,1,11781,1688,13469
1,27,1,1,2017,2,11911,1535,13446
1,27,1,1,2017,3,12039,1494,13533
1,27,1,1,2017,4,12371,1456,13827
1,27,1,1,2017,5,12771,1468,14239
1,27,1,1,2017,6,13858,1589,15447
1,27,1,1,2017,7,14795,1751,16546
1,27,1,1,2017,8,16145,1957,18102
1,27,1,1,2017,9,17296,2168,19464
1,27,1,1,2017,10,16373,2521,18894
1,27,1,1,2017,11,16214,2656,18870
1,27,1,1,2017,12,16990,2701,19691
1,27,1,1,2017,13,17171,2669,19840
1,27,1,1,2017,14,17014,2522,19536
1,27,1,1,2017,15,16568,2532,19100
1,27,1,1,2017,16,16394,2525,18919
1,27,1,1,2017,17,15831,2526,18357
1,27,1,1,2017,18,15379,2483,17862
1,27,1,1,2017,19,14936,2528,17464
1,27,1,1,2017,20,14593,2508,17101
1,27,1,1,2017,21,13895,2334,16229
1,27,1,1,2017,22,13149,2184,15333
1,27,1,1,2017,23,13029,2043,15072
1,27,1,1,2017,24,13025,1932,14957
2,28,1,1,2017,1,13040,1637,14677
2,28,1,1,2017,2,13050,1528,14578
2,28,1,1,2017,3,13173,1435,14608
2,28,1,1,2017,4,12894,1391,14285
2,28,1,1,2017,5,13339,1395,14734
2,28,1,1,2017,6,14361,1510,15871
2,28,1,1,2017,7,15560,1642,17202
2,28,1,1,2017,8,16932,1793,18725
2,28,1,1,2017,9,17659,1967,19626
2,28,1,1,2017,10,16993,2155,19148
2,28,1,1,2017,11,16747,2390,19137
2,28,1,1,2017,12,17362,2430,19792
2,28,1,1,2017,13,17670,2412,20082
2,28,1,1,2017,14,17152,2314,19466
2,28,1,1,2017,15,16853,2309,19162
2,28,1,1,2017,16,17073,2304,19377
2,28,1,1,2017,17,16347,2326,18673
2,28,1,1,2017,18,15870,2309,18179
2,28,1,1,2017,19,15636,2415,18051
2,28,1,1,2017,20,15066,2443,17509
2,28,1,1,2017,21,13997,2280,16277
2,28,1,1,2017,22,13533,2173,15706
2,28,1,1,2017,23,13228,1980,15208
2,28,1,1,2017,24,13219,1868,15087
2,29,1,1,2017,1,13280,1662,14942
2,29,1,1,2017,2,13269,1565,14834
2,29,1,1,2017,3,13478,1479,14957
2,29,1,1,2017,4,13299,1431,14730
2,29,1,1,2017,5,13662,1433,15095
2,29,1,1,2017,6,14298,1506,15804
2,29,1,1,2017,7,15426,1586,17012
2,29,1,1,2017,8,16649,1643,18292
2,29,1,1,2017,9,17703,1789,19492
2,29,1,1,2017,10,16962,1937,18899
2,29,1,1,2017,11,16836,2029,18865
2,29,1,1,2017,12,17443,2062,19505
2,29,1,1,2017,13,17584,2037,19621
2,29,1,1,2017,14,17363,1979,19342
2,29,1,1,2017,15,17181,1948,19129
2,29,1,1,2017,16,16738,1899,18637
2,29,1,1,2017,17,16210,1903,18113
2,29,1,1,2017,18,15422,1928,17350
2,29,1,1,2017,19,14865,2043,16908
2,29,1,1,2017,20,14719,2158,16877
2,29,1,1,2017,21,13956,2100,16056
2,29,1,1,2017,22,13204,2029,15233
2,29,1,1,2017,23,12913,2018,14931
2,29,1,1,2017,24,13114,1875,14989
1,30,1,1,2017,1,13243,1683,14926
1,30,1,1,2017,2,13219,1554,14773
1,30,1,1,2017,3,13134,1494,14628
1,30,1,1,2017,4,13185,1445,14630
1,30,1,1,2017,5,13692,1451,15143
1,30,1,1,2017,6,14384,1567,15951
1,30,1,1,2017,7,15510,1791,17301
1,30,1,1,2017,8,17058,1998,19056
1,30,1,1,2017,9,17588,2198,19786
1,30,1,1,2017,10,17045,2495,19540
1,30,1,1,2017,11,17171,2639,19810
1,30,1,1,2017,12,17777,2700,20477
1,30,1,1,2017,13,18029,2699,20728
1,30,1,1,2017,14,17668,2608,20276
1,30,1,1,2017,15,17505,2629,20134
1,30,1,1,2017,16,17687,2645,20332
1,30,1,1,2017,17,16949,2638,19587
1,30,1,1,2017,18,16134,2615,18749
1,30,1,1,2017,19,15558,2591,18149
1,30,1,1,2017,20,15248,2604,17852
1,30,1,1,2017,21,14383,2442,16825
1,30,1,1,2017,22,13761,2221,15982
1,30,1,1,2017,23,13575,2112,15687
1,30,1,1,2017,24,13635,1947,15582
1,31,1,1,2017,1,13677,1765,15442
1,31,1,1,2017,2,13602,1646,15248
1,31,1,1,2017,3,13613,1583,15196
1,31,1,1,2017,4,13665,1523,15188
1,31,1,1,2017,5,14098,1537,15635
1,31,1,1,2017,6,15418,1629,17047
1,31,1,1,2017,7,16175,1845,18020
1,31,1,1,2017,8,17739,1945,19684
1,31,1,1,2017,9,18103,2245,20348
1,31,1,1,2017,10,17552,2485,20037
1,31,1,1,2017,11,17440,2643,20083
1,31,1,1,2017,12,18283,2671,20954
1,31,1,1,2017,13,17881,2661,20542
1,31,1,1,2017,14,17733,2533,20266
1,31,1,1,2017,15,17667,2591,20258
1,31,1,1,2017,16,17690,2639,20329
1,31,1,1,2017,17,17112,2644,19756
1,31,1,1,2017,18,16607,2596,19203
1,31,1,1,2017,19,15744,2614,18358
1,31,1,1,2017,20,15238,2590,17828
1,31,1,1,2017,21,14547,2413,16960
1,31,1,1,2017,22,14009,2241,16250
1,31,1,1,2017,23,13728,2068,15796
1,31,1,1,2017,24,13626,1905,15531
1,1,2,1,2017,1,13872,1716,15588
1,1,2,1,2017,2,13621,1573,15194
1,1,2,1,2017,3,13802,1487,15289
1,1,2,1,2017,4,13688,1441,15129
1,1,2,1,2017,5,13971,1451,15422
1,1,2,1,2017,6,15248,1569,16817
1,1,2,1,2017,7,16190,1817,18007
1,1,2,1,2017,8,17718,1945,19663
1,1,2,1,2017,9,17594,2267,19861
1,1,2,1,2017,10,17076,2429,19505
1,1,2,1,2017,11,17057,2655,19712
1,1,2,1,2017,12,17586,2665,20251
1,1,2,1,2017,13,17496,2647,20143
1,1,2,1,2017,14,17352,2558,19910
1,1,2,1,2017,15,17133,2580,19713
1,1,2,1,2017,16,17467,2596,20063
1,1,2,1,2017,17,16895,2606,19501
1,1,2,1,2017,18,16365,2568,18933
1,1,2,1,2017,19,15525,2559,18084
1,1,2,1,2017,20,15010,2557,17567
1,1,2,1,2017,21,14607,2463,17070
1,1,2,1,2017,22,14198,2287,16485
1,1,2,1,2017,23,13927,2116,16043
1,1,2,1,2017,24,13905,1933,15838
1,2,2,1,2017,1,13998,1766,15764
1,2,2,1,2017,2,14107,1598,15705
1,2,2,1,2017,3,13865,1511,15376
1,2,2,1,2017,4,13900,1466,15366
1,2,2,1,2017,5,14312,1478,15790
1,2,2,1,2017,6,15371,1625,16996
1,2,2,1,2017,7,16505,1795,18300
1,2,2,1,2017,8,17595,1991,19586
1,2,2,1,2017,9,18271,2244,20515
1,2,2,1,2017,10,17465,2497,19962
1,2,2,1,2017,11,17597,2750,20347
1,2,2,1,2017,12,18288,2762,21050
1,2,2,1,2017,13,18075,2719,20794
1,2,2,1,2017,14,17770,2618,20388
1,2,2,1,2017,15,17825,2643,20468
1,2,2,1,2017,16,17908,2638,20546
1,2,2,1,2017,17,17359,2631,19990
1,2,2,1,2017,18,16407,2589,18996
1,2,2,1,2017,19,15523,2596,18119
1,2,2,1,2017,20,15383,2592,17975
1,2,2,1,2017,21,14802,2445,17247
1,2,2,1,2017,22,14132,2243,16375
1,2,2,1,2017,23,13960,2090,16050
1,2,2,1,2017,24,14097,1950,16047
1,3,2,1,2017,1,14347,1730,16077
1,3,2,1,2017,2,14181,1613,15794
1,3,2,1,2017,3,14122,1530,15652
1,3,2,1,2017,4,13931,1484,15415
1,3,2,1,2017,5,14613,1492,16105
1,3,2,1,2017,6,15725,1628,17353
1,3,2,1,2017,7,16007,1858,17865
1,3,2,1,2017,8,17525,1999,19524
1,3,2,1,2017,9,17396,2347,19743
1,3,2,1,2017,10,16468,2538,19006
1,3,2,1,2017,11,16475,2790,19265
1,3,2,1,2017,12,17334,2826,20160
1,3,2,1,2017,13,17386,2821,20207
1,3,2,1,2017,14,17279,2723,20002
1,3,2,1,2017,15,17005,2706,19711
1,3,2,1,2017,16,17040,2700,19740
1,3,2,1,2017,17,16517,2695,19212
1,3,2,1,2017,18,15616,2596,18212
1,3,2,1,2017,19,15129,2601,17730
1,3,2,1,2017,20,14591,2608,17199
1,3,2,1,2017,21,13910,2443,16353
1,3,2,1,2017,22,13666,2250,15916
1,3,2,1,2017,23,13463,2130,15593
1,3,2,1,2017,24,13787,1924,15711
2,4,2,1,2017,1,13963,1781,15744
2,4,2,1,2017,2,13729,1650,15379
2,4,2,1,2017,3,13762,1562,15324
2,4,2,1,2017,4,13956,1510,15466
2,4,2,1,2017,5,14108,1517,15625
2,4,2,1,2017,6,14827,1685,16512
2,4,2,1,2017,7,16224,1778,18002
2,4,2,1,2017,8,17439,1912,19351
2,4,2,1,2017,9,17701,2120,19821
2,4,2,1,2017,10,16790,2470,19260
2,4,2,1,2017,11,16986,2581,19567
2,4,2,1,2017,12,17669,2602,20271
2,4,2,1,2017,13,17581,2597,20178
2,4,2,1,2017,14,17370,2448,19818
2,4,2,1,2017,15,17473,2431,19904
2,4,2,1,2017,16,17044,2423,19467
2,4,2,1,2017,17,16697,2387,19084
2,4,2,1,2017,18,16106,2350,18456
2,4,2,1,2017,19,15464,2415,17879
2,4,2,1,2017,20,15314,2432,17746
2,4,2,1,2017,21,14344,2354,16698
2,4,2,1,2017,22,14071,2144,16215
2,4,2,1,2017,23,14029,2054,16083
2,4,2,1,2017,24,14221,1886,16107
2,5,2,1,2017,1,14596,1703,16299
2,5,2,1,2017,2,14292,1602,15894
2,5,2,1,2017,3,14282,1508,15790
2,5,2,1,2017,4,14180,1461,15641
2,5,2,1,2017,5,14569,1473,16042
2,5,2,1,2017,6,15145,1563,16708
2,5,2,1,2017,7,16187,1652,17839
2,5,2,1,2017,8,16986,1726,18712
2,5,2,1,2017,9,17754,1810,19564
2,5,2,1,2017,10,17097,1987,19084
2,5,2,1,2017,11,17152,2058,19210
2,5,2,1,2017,12,17770,2078,19848
2,5,2,1,2017,13,17509,2056,19565
2,5,2,1,2017,14,17284,1943,19227
2,5,2,1,2017,15,17024,1883,18907
2,5,2,1,2017,16,17126,1842,18968
2,5,2,1,2017,17,16495,1816,18311
2,5,2,1,2017,18,15601,1826,17427
2,5,2,1,2017,19,14820,1978,16798
2,5,2,1,2017,20,14661,2074,16735
2,5,2,1,2017,21,14224,2093,16317
2,5,2,1,2017,22,13682,1912,15594
2,5,2,1,2017,23,13463,1877,15340
2,5,2,1,2017,24,13576,1755,15331
1,6,2,1,2017,1,13937,1584,15521
1,6,2,1,2017,2,13809,1463,15272
1,6,2,1,2017,3,13796,1380,15176
1,6,2,1,2017,4,13789,1345,15134
1,6,2,1,2017,5,14169,1367,15536
1,6,2,1,2017,6,15141,1497,16638
1,6,2,1,2017,7,16101,1761,17862
1,6,2,1,2017,8,17528,1918,19446
1,6,2,1,2017,9,17786,2248,20034
1,6,2,1,2017,10,17351,2415,19766
1,6,2,1,2017,11,17354,2588,19942
1,6,2,1,2017,12,17639,2604,20243
1,6,2,1,2017,13,17737,2563,20300
1,6,2,1,2017,14,17633,2452,20085
1,6,2,1,2017,15,17708,2431,20139
1,6,2,1,2017,16,17641,2431,20072
1,6,2,1,2017,17,16810,2418,19228
1,6,2,1,2017,18,16312,2354,18666
1,6,2,1,2017,19,15541,2356,17897
1,6,2,1,2017,20,15453,2368,17821
1,6,2,1,2017,21,14622,2281,16903
1,6,2,1,2017,22,14030,2078,16108
1,6,2,1,2017,23,13881,1910,15791
1,6,2,1,2017,24,13889,1709,15598
1,7,2,1,2017,1,14423,1551,15974
1,7,2,1,2017,2,14224,1405,15629
1,7,2,1,2017,3,13986,1362,15348
1,7,2,1,2017,4,14376,1322,15698
1,7,2,1,2017,5,14212,1344,15556
1,7,2,1,2017,6,15350,1497,16847
1,7,2,1,2017,7,16534,1694,18228
1,7,2,1,2017,8,17639,1922,19561
1,7,2,1,2017,9,18529,2086,20615
1,7,2,1,2017,10,17434,2405,19839
1,7,2,1,2017,11,17165,2534,19699
1,7,2,1,2017,12,18030,2568,20598
1,7,2,1,2017,13,17550,2540,20090
1,7,2,1,2017,14,17597,2436,20033
1,7,2,1,2017,15,17667,2450,20117
1,7,2,1,2017,16,17503,2444,19947
1,7,2,1,2017,17,17042,2452,19494
1,7,2,1,2017,18,16403,2438,18841
1,7,2,1,2017,19,15689,2440,18129
1,7,2,1,2017,20,15541,2454,17995
1,7,2,1,2017,21,14794,2333,17127
1,7,2,1,2017,22,14207,2162,16369
1,7,2,1,2017,23,14211,1991,16202
1,7,2,1,2017,24,14384,1774,16158
1,8,2,1,2017,1,14547,1600,16147
1,8,2,1,2017,2,14320,1470,15790
1,8,2,1,2017,3,14441,1391,15832
1,8,2,1,2017,4,14304,1351,15655
1,8,2,1,2017,5,14775,1373,16148
1,8,2,1,2017,6,15598,1535,17133
1,8,2,1,2017,7,16346,1742,18088
1,8,2,1,2017,8,17975,1961,19936
1,8,2,1,2017,9,18325,2132,20457
1,8,2,1,2017,10,17581,2472,20053
1,8,2,1,2017,11,17344,2645,19989
1,8,2,1,2017,12,18103,2665,20768
1,8,2,1,2017,13,17878,2602,20480
1,8,2,1,2017,14,17687,2494,20181
1,8,2,1,2017,15,17753,2524,20277
1,8,2,1,2017,16,17514,2524,20038
1,8,2,1,2017,17,17252,2526,19778
1,8,2,1,2017,18,16793,2480,19273
1,8,2,1,2017,19,15554,2482,18036
1,8,2,1,2017,20,15573,2493,18066
1,8,2,1,2017,21,14869,2421,17290
1,8,2,1,2017,22,14487,2219,16706
1,8,2,1,2017,23,14214,2028,16242
1,8,2,1,2017,24,14463,1790,16253
1,9,2,1,2017,1,14670,1632,16302
1,9,2,1,2017,2,14701,1501,16202
1,9,2,1,2017,3,14446,1429,15875
1,9,2,1,2017,4,14569,1392,15961
1,9,2,1,2017,5,14825,1409,16234
1,9,2,1,2017,6,15619,1534,17153
1,9,2,1,2017,7,16808,1772,18580
1,9,2,1,2017,8,17972,1929,19901
1,9,2,1,2017,9,18363,2194,20557
1,9,2,1,2017,10,17604,2535,20139
1,9,2,1,2017,11,17551,2623,20174
1,9,2,1,2017,12,18132,2639,20771
1,9,2,1,2017,13,18232,2604,20836
1,9,2,1,2017,14,18012,2467,20479
1,9,2,1,2017,15,17752,2499,20251
1,9,2,1,2017,16,17624,2525,20149
1,9,2,1,2017,17,16949,2516,19465
1,9,2,1,2017,18,16151,2480,18631
1,9,2,1,2017,19,16077,2491,18568
1,9,2,1,2017,20,15762,2504,18266
1,9,2,1,2017,21,14686,2391,17077
1,9,2,1,2017,22,14282,2174,16456
1,9,2,1,2017,23,14000,2045,16045
1,9,2,1,2017,24,14238,1798,16036
1,10,2,1,2017,1,14521,1638,16159
1,10,2,1,2017,2,14423,1504,15927
1,10,2,1,2017,3,14460,1431,15891
1,10,2,1,2017,4,14600,1399,15999
1,10,2,1,2017,5,14883,1413,16296
1,10,2,1,2017,6,15621,1635,17256
1,10,2,1,2017,7,16962,1776,18738
1,10,2,1,2017,8,17661,1880,19541
1,10,2,1,2017,9,18145,2223,20368
1,10,2,1,2017,10,17346,2437,19783
1,10,2,1,2017,11,17092,2691,19783
1,10,2,1,2017,12,18003,2693,20696
1,10,2,1,2017,13,17413,2656,20069
1,10,2,1,2017,14,17711,2528,20239
1,10,2,1,2017,15,17394,2524,19918
1,10,2,1,2017,16,17262,2518,19780
1,10,2,1,2017,17,16615,2525,19140
1,10,2,1,2017,18,15708,2460,18168
1,10,2,1,2017,19,15357,2461,17818
1,10,2,1,2017,20,14947,2493,17440
1,10,2,1,2017,21,14532,2407,16939
1,10,2,1,2017,22,13915,2199,16114
1,10,2,1,2017,23,13843,2026,15869
1,10,2,1,2017,24,14225,1843,16068
2,11,2,1,2017,1,14180,1698,15878
2,11,2,1,2017,2,14375,1526,15901
2,11,2,1,2017,3,14131,1460,15591
2,11,2,1,2017,4,14307,1427,15734
2,11,2,1,2017,5,14652,1432,16084
2,11,2,1,2017,6,15297,1552,16849
2,11,2,1,2017,7,16690,1734,18424
2,11,2,1,2017,8,17811,1807,19618
2,11,2,1,2017,9,18205,1953,20158
2,11,2,1,2017,10,17250,2283,19533
2,11,2,1,2017,11,17501,2433,19934
2,11,2,1,2017,12,18024,2479,20503
2,11,2,1,2017,13,17757,2417,20174
2,11,2,1,2017,14,17640,2279,19919
2,11,2,1,2017,15,17613,2261,19874
2,11,2,1,2017,16,17342,2239,19581
2,11,2,1,2017,17,16792,2228,19020
2,11,2,1,2017,18,16224,2198,18422
2,11,2,1,2017,19,15588,2262,17850
2,11,2,1,2017,20,15367,2345,17712
2,11,2,1,2017,21,14574,2241,16815
2,11,2,1,2017,22,13841,2105,15946
2,11,2,1,2017,23,13631,1966,15597
2,11,2,1,2017,24,14195,1785,15980
2,12,2,1,2017,1,14272,1629,15901
2,12,2,1,2017,2,14203,1464,15667
2,12,2,1,2017,3,13940,1408,15348
2,12,2,1,2017,4,14068,1361,15429
2,12,2,1,2017,5,14359,1371,15730
2,12,2,1,2017,6,14889,1459,16348
2,12,2,1,2017,7,15988,1552,17540
2,12,2,1,2017,8,17240,1640,18880
2,12,2,1,2017,9,17837,1731,19568
2,12,2,1,2017,10,16986,1881,18867
2,12,2,1,2017,11,16975,1975,18950
2,12,2,1,2017,12,17744,1992,19736
2,12,2,1,2017,13,17736,1938,19674
2,12,2,1,2017,14,17317,1880,19197
2,12,2,1,2017,15,16969,1810,18779
2,12,2,1,2017,16,17183,1778,18961
2,12,2,1,2017,17,16388,1749,18137
2,12,2,1,2017,18,15564,1756,17320
2,12,2,1,2017,19,15022,1862,16884
2,12,2,1,2017,20,14867,2000,16867
2,12,2,1,2017,21,14290,1997,16287
2,12,2,1,2017,22,13686,1970,15656
2,12,2,1,2017,23,13410,1877,15287
2,12,2,1,2017,24,13703,1730,15433
1,13,2,1,2017,1,13940,1542,15482
1,13,2,1,2017,2,13456,1448,14904
1,13,2,1,2017,3,13760,1356,15116
1,13,2,1,2017,4,13752,1328,15080
1,13,2,1,2017,5,14139,1338,15477
1,13,2,1,2017,6,15110,1476,16586
1,13,2,1,2017,7,16273,1694,17967
1,13,2,1,2017,8,17500,1939,19439
1,13,2,1,2017,9,17893,2159,20052
1,13,2,1,2017,10,17081,2472,19553
1,13,2,1,2017,11,17237,2620,19857
1,13,2,1,2017,12,17977,2663,20640
1,13,2,1,2017,13,17876,2628,20504
1,13,2,1,2017,14,17640,2528,20168
1,13,2,1,2017,15,17599,2562,20161
1,13,2,1,2017,16,17601,2566,20167
1,13,2,1,2017,17,17158,2562,19720
1,13,2,1,2017,18,16781,2481,19262
1,13,2,1,2017,19,15726,2469,18195
1,13,2,1,2017,20,15612,2479,18091
1,13,2,1,2017,21,14785,2416,17201
1,13,2,1,2017,22,13778,2212,15990
1,13,2,1,2017,23,14064,2081,16145
1,13,2,1,2017,24,14241,1844,16085
1,14,2,1,2017,1,14539,1687,16226
1,14,2,1,2017,2,14335,1550,15885
1,14,2,1,2017,3,14114,1477,15591
1,14,2,1,2017,4,14141,1430,15571
1,14,2,1,2017,5,14650,1446,16096
1,14,2,1,2017,6,15606,1603,17209
1,14,2,1,2017,7,16521,1807,18328
1,14,2,1,2017,8,17835,2020,19855
1,14,2,1,2017,9,18250,2253,20503
1,14,2,1,2017,10,17415,2615,20030
1,14,2,1,2017,11,17436,2731,20167
1,14,2,1,2017,12,18154,2800,20954
1,14,2,1,2017,13,18037,2744,20781
1,14,2,1,2017,14,17428,2642,20070
1,14,2,1,2017,15,17548,2664,20212
1,14,2,1,2017,16,17466,2667,20133
1,14,2,1,2017,17,17281,2666,19947
1,14,2,1,2017,18,16496,2629,19125
1,14,2,1,2017,19,15887,2597,18484
1,14,2,1,2017,20,15769,2594,18363
1,14,2,1,2017,21,15165,2440,17605
1,14,2,1,2017,22,14596,2290,16886
1,14,2,1,2017,23,14553,2168,16721
1,14,2,1,2017,24,14664,1933,16597
1,15,2,1,2017,1,14817,1794,16611
1,15,2,1,2017,2,14575,1645,16220
1,15,2,1,2017,3,14493,1568,16061
1,15,2,1,2017,4,14661,1523,16184
1,15,2,1,2017,5,14973,1516,16489
1,15,2,1,2017,6,15655,1681,17336
1,15,2,1,2017,7,16774,1793,18567
1,15,2,1,2017,8,17744,2052,19796
1,15,2,1,2017,9,18182,2334,20516
1,15,2,1,2017,10,17798,2617,20415
1,15,2,1,2017,11,17538,2831,20369
1,15,2,1,2017,12,17940,2829,20769
1,15,2,1,2017,13,17801,2810,20611
1,15,2,1,2017,14,17628,2729,20357
1,15,2,1,2017,15,17897,2768,20665
1,15,2,1,2017,16,17995,2793,20788
1,15,2,1,2017,17,17572,2782,20354
1,15,2,1,2017,18,16970,2739,19709
1,15,2,1,2017,19,15885,2693,18578
1,15,2,1,2017,20,15732,2680,18412
1,15,2,1,2017,21,15157,2523,17680
1,15,2,1,2017,22,14781,2375,17156
1,15,2,1,2017,23,14492,2205,16697
1,15,2,1,2017,24,14736,2088,16824
1,16,2,1,2017,1,14470,1899,16369
1,16,2,1,2017,2,14663,1740,16403
1,16,2,1,2017,3,14299,1662,15961
1,16,2,1,2017,4,14479,1606,16085
1,16,2,1,2017,5,15053,1613,16666
1,16,2,1,2017,6,15597,1726,17323
1,16,2,1,2017,7,17158,1881,19039
1,16,2,1,2017,8,18006,2108,20114
1,16,2,1,2017,9,18662,2304,20966
1,16,2,1,2017,10,17583,2661,20244
1,16,2,1,2017,11,17504,2875,20379
1,16,2,1,2017,12,17912,2947,20859
1,16,2,1,2017,13,17642,2853,20495
1,16,2,1,2017,14,17456,2750,20206
1,16,2,1,2017,15,17474,2796,20270
1,16,2,1,2017,16,17654,2817,20471
1,16,2,1,2017,17,17256,2789,20045
1,16,2,1,2017,18,16278,2724,19002
1,16,2,1,2017,19,15789,2687,18476
1,16,2,1,2017,20,15434,2654,18088
1,16,2,1,2017,21,15022,2558,17580
1,16,2,1,2017,22,14689,2366,17055
1,16,2,1,2017,23,14635,2214,16849
1,16,2,1,2017,24,14699,2115,16814
1,17,2,1,2017,1,14671,1945,16616
1,17,2,1,2017,2,14815,1769,16584
1,17,2,1,2017,3,14492,1679,16171
1,17,2,1,2017,4,14702,1623,16325
1,17,2,1,2017,5,14978,1636,16614
1,17,2,1,2017,6,15769,1740,17509
1,17,2,1,2017,7,16798,1916,18714
1,17,2,1,2017,8,17657,2135,19792
1,17,2,1,2017,9,18211,2315,20526
1,17,2,1,2017,10,17260,2696,19956
1,17,2,1,2017,11,16753,2871,19624
1,17,2,1,2017,12,17322,2939,20261
1,17,2,1,2017,13,16980,2909,19889
1,17,2,1,2017,14,16747,2786,19533
1,17,2,1,2017,15,16601,2845,19446
1,17,2,1,2017,16,16487,2863,19350
1,17,2,1,2017,17,16190,2853,19043
1,17,2,1,2017,18,15649,2802,18451
1,17,2,1,2017,19,15079,2745,17824
1,17,2,1,2017,20,15349,2741,18090
1,17,2,1,2017,21,14891,2560,17451
1,17,2,1,2017,22,14224,2426,16650
1,17,2,1,2017,23,14500,2253,16753
1,17,2,1,2017,24,14619,2160,16779
2,18,2,1,2017,1,14663,1998,16661
2,18,2,1,2017,2,14714,1810,16524
2,18,2,1,2017,3,14541,1713,16254
2,18,2,1,2017,4,14563,1655,16218
2,18,2,1,2017,5,14664,1652,16316
2,18,2,1,2017,6,15554,1735,17289
2,18,2,1,2017,7,17061,1871,18932
2,18,2,1,2017,8,17737,1961,19698
2,18,2,1,2017,9,18267,2203,20470
2,18,2,1,2017,10,17588,2551,20139
2,18,2,1,2017,11,17709,2713,20422
2,18,2,1,2017,12,18242,2771,21013
2,18,2,1,2017,13,17966,2763,20729
2,18,2,1,2017,14,17416,2634,20050
2,18,2,1,2017,15,17768,2648,20416
2,18,2,1,2017,16,17920,2685,20605
2,18,2,1,2017,17,16828,2658,19486
2,18,2,1,2017,18,16201,2584,18785
2,18,2,1,2017,19,15595,2578,18173
2,18,2,1,2017,20,15892,2604,18496
2,18,2,1,2017,21,15380,2498,17878
2,18,2,1,2017,22,14747,2362,17109
2,18,2,1,2017,23,14584,2272,16856
2,18,2,1,2017,24,14819,2169,16988
3,19,2,1,2017,1,15309,2035,17344
3,19,2,1,2017,2,15296,1860,17156
3,19,2,1,2017,3,15050,1785,16835
3,19,2,1,2017,4,14995,1713,16708
3,19,2,1,2017,5,15006,1693,16699
3,19,2,1,2017,6,15965,1759,17724
3,19,2,1,2017,7,16684,1808,18492
3,19,2,1,2017,8,17743,1847,19590
3,19,2,1,2017,9,18207,1950,20157
3,19,2,1,2017,10,17513,2089,19602
3,19,2,1,2017,11,17677,2200,19877
3,19,2,1,2017,12,18334,2227,20561
3,19,2,1,2017,13,17865,2218,20083
3,19,2,1,2017,14,17509,2167,19676
3,19,2,1,2017,15,17470,2119,19589
3,19,2,1,2017,16,17640,2107,19747
3,19,2,1,2017,17,16788,2063,18851
3,19,2,1,2017,18,15913,2051,17964
3,19,2,1,2017,19,15169,2154,17323
3,19,2,1,2017,20,15465,2259,17724
3,19,2,1,2017,21,14953,2259,17212
3,19,2,1,2017,22,14495,2249,16744
3,19,2,1,2017,23,14514,2213,16727
3,19,2,1,2017,24,14894,2148,17042
1,20,2,1,2017,1,15090,2011,17101
1,20,2,1,2017,2,14811,1869,16680
1,20,2,1,2017,3,14632,1753,16385
1,20,2,1,2017,4,14705,1703,16408
1,20,2,1,2017,5,15038,1696,16734
1,20,2,1,2017,6,15947,1790,17737
1,20,2,1,2017,7,16690,1948,18638
1,20,2,1,2017,8,18081,2102,20183
1,20,2,1,2017,9,18290,2393,20683
1,20,2,1,2017,10,17507,2663,20170
1,20,2,1,2017,11,18014,2958,20972
1,20,2,1,2017,12,18830,2988,21818
1,20,2,1,2017,13,18478,2984,21462
1,20,2,1,2017,14,18148,2879,21027
1,20,2,1,2017,15,18226,2905,21131
1,20,2,1,2017,16,18192,2890,21082
1,20,2,1,2017,17,17720,2861,20581
1,20,2,1,2017,18,16767,2731,19498
1,20,2,1,2017,19,16370,2657,19027
1,20,2,1,2017,20,16263,2686,18949
1,20,2,1,2017,21,15660,2577,18237
1,20,2,1,2017,22,15276,2423,17699
1,20,2,1,2017,23,15117,2301,17418
1,20,2,1,2017,24,15414,2231,17645
1,21,2,1,2017,1,15409,2079,17488
1,21,2,1,2017,2,15412,1891,17303
1,21,2,1,2017,3,15201,1794,16995
1,21,2,1,2017,4,15123,1742,16865
1,21,2,1,2017,5,15293,1728,17021
1,21,2,1,2017,6,16298,1803,18101
1,21,2,1,2017,7,17280,1892,19172
1,21,2,1,2017,8,18168,2062,20230
1,21,2,1,2017,9,18197,2248,20445
1,21,2,1,2017,10,17554,2556,20110
1,21,2,1,2017,11,17797,2678,20475
1,21,2,1,2017,12,18442,2706,21148
1,21,2,1,2017,13,18182,2677,20859
1,21,2,1,2017,14,17711,2511,20222
1,21,2,1,2017,15,17505,2517,20022
1,21,2,1,2017,16,17618,2474,20092
1,21,2,1,2017,17,17142,2451,19593
1,21,2,1,2017,18,16440,2406,18846
1,21,2,1,2017,19,15767,2420,18187
1,21,2,1,2017,20,16156,2484,18640
1,21,2,1,2017,21,15420,2403,17823
1,21,2,1,2017,22,14861,2321,17182
1,21,2,1,2017,23,14880,2177,17057
1,21,2,1,2017,24,14970,2061,17031
1,22,2,1,2017,1,15249,1852,17101
1,22,2,1,2017,2,15273,1739,17012
1,22,2,1,2017,3,15206,1654,16860
1,22,2,1,2017,4,15037,1599,16636
1,22,2,1,2017,5,15514,1601,17115
1,22,2,1,2017,6,16191,1711,17902
1,22,2,1,2017,7,17221,1941,19162
1,22,2,1,2017,8,18362,2058,20420
1,22,2,1,2017,9,18512,2427,20939
1,22,2,1,2017,10,17942,2588,20530
1,22,2,1,2017,11,18097,2862,20959
1,22,2,1,2017,12,18821,2895,21716
1,22,2,1,2017,13,18095,2890,20985
1,22,2,1,2017,14,17835,2736,20571
1,22,2,1,2017,15,18212,2773,20985
1,22,2,1,2017,16,18426,2777,21203
1,22,2,1,2017,17,18038,2778,20816
1,22,2,1,2017,18,17104,2721,19825
1,22,2,1,2017,19,16062,2659,18721
1,22,2,1,2017,20,16525,2658,19183
1,22,2,1,2017,21,15721,2501,18222
1,22,2,1,2017,22,15366,2362,17728
1,22,2,1,2017,23,15195,2182,17377
1,22,2,1,2017,24,15544,2056,17600
1,23,2,1,2017,1,15355,1869,17224
1,23,2,1,2017,2,15213,1722,16935
1,23,2,1,2017,3,15288,1622,16910
1,23,2,1,2017,4,15110,1570,16680
1,23,2,1,2017,5,15865,1580,17445
1,23,2,1,2017,6,15987,1698,17685
1,23,2,1,2017,7,17395,1862,19257
1,23,2,1,2017,8,18118,2058,20176
1,23,2,1,2017,9,18482,2219,20701
1,23,2,1,2017,10,17654,2602,20256
1,23,2,1,2017,11,17803,2837,20640
1,23,2,1,2017,12,18477,2871,21348
1,23,2,1,2017,13,18189,2854,21043
1,23,2,1,2017,14,18084,2720,20804
1,23,2,1,2017,15,18061,2759,20820
1,23,2,1,2017,16,18150,2797,20947
1,23,2,1,2017,17,17557,2789,20346
1,23,2,1,2017,18,16729,2724,19453
1,23,2,1,2017,19,16025,2663,18688
1,23,2,1,2017,20,16308,2680,18988
1,23,2,1,2017,21,15800,2496,18296
1,23,2,1,2017,22,15043,2320,17363
1,23,2,1,2017,23,15020,2225,17245
1,23,2,1,2017,24,15308,2103,17411
3,24,2,1,2017,1,15815,1852,17667
3,24,2,1,2017,2,15703,1716,17419
3,24,2,1,2017,3,15174,1628,16802
3,24,2,1,2017,4,15390,1575,16965
3,24,2,1,2017,5,15467,1574,17041
3,24,2,1,2017,6,16100,1671,17771
3,24,2,1,2017,7,17146,1801,18947
3,24,2,1,2017,8,18025,1921,19946
3,24,2,1,2017,9,18106,2201,20307
3,24,2,1,2017,10,17477,2439,19916
3,24,2,1,2017,11,17304,2711,20015
3,24,2,1,2017,12,18166,2733,20899
3,24,2,1,2017,13,18086,2701,20787
3,24,2,1,2017,14,17604,2563,20167
3,24,2,1,2017,15,17710,2595,20305
3,24,2,1,2017,16,17480,2602,20082
3,24,2,1,2017,17,16733,2602,19335
3,24,2,1,2017,18,16208,2550,18758
3,24,2,1,2017,19,15330,2516,17846
3,24,2,1,2017,20,15511,2557,18068
3,24,2,1,2017,21,15106,2478,17584
3,24,2,1,2017,22,14996,2306,17302
3,24,2,1,2017,23,14723,2205,16928
3,24,2,1,2017,24,15461,2093,17554
2,25,2,1,2017,1,15506,1906,17412
2,25,2,1,2017,2,15438,1759,17197
2,25,2,1,2017,3,15160,1675,16835
2,25,2,1,2017,4,15096,1600,16696
2,25,2,1,2017,5,15335,1606,16941
2,25,2,1,2017,6,16014,1687,17701
2,25,2,1,2017,7,17212,1796,19008
2,25,2,1,2017,8,18134,1906,20040
2,25,2,1,2017,9,18120,2091,20211
2,25,2,1,2017,10,17407,2440,19847
2,25,2,1,2017,11,17424,2568,19992
2,25,2,1,2017,12,18354,2639,20993
2,25,2,1,2017,13,17947,2635,20582
2,25,2,1,2017,14,17726,2519,20245
2,25,2,1,2017,15,17964,2539,20503
2,25,2,1,2017,16,18015,2534,20549
2,25,2,1,2017,17,17487,2508,19995
2,25,2,1,2017,18,16489,2487,18976
2,25,2,1,2017,19,15738,2513,18251
2,25,2,1,2017,20,15855,2562,18417
2,25,2,1,2017,21,15469,2489,17958
2,25,2,1,2017,22,15020,2368,17388
2,25,2,1,2017,23,14766,2257,17023
2,25,2,1,2017,24,15197,2115,17312
2,26,2,1,2017,1,15700,2017,17717
2,26,2,1,2017,2,15230,1827,17057
2,26,2,1,2017,3,15328,1720,17048
2,26,2,1,2017,4,15206,1641,16847
2,26,2,1,2017,5,15485,1627,17112
2,26,2,1,2017,6,16216,1673,17889
2,26,2,1,2017,7,16868,1742,18610
2,26,2,1,2017,8,17613,1773,19386
2,26,2,1,2017,9,18061,1865,19926
2,26,2,1,2017,10,17420,2006,19426
2,26,2,1,2017,11,17553,2109,19662
2,26,2,1,2017,12,18240,2158,20398
2,26,2,1,2017,13,18237,2156,20393
2,26,2,1,2017,14,17773,2117,19890
2,26,2,1,2017,15,17616,2113,19729
2,26,2,1,2017,16,17704,2074,19778
2,26,2,1,2017,17,17047,2089,19136
2,26,2,1,2017,18,16326,2017,18343
2,26,2,1,2017,19,15475,2098,17573
2,26,2,1,2017,20,15783,2219,18002
2,26,2,1,2017,21,15001,2227,17228
2,26,2,1,2017,22,14847,2216,17063
2,26,2,1,2017,23,14807,2192,16999
2,26,2,1,2017,24,15213,2144,17357
1,27,2,1,2017,1,15346,1961,17307
1,27,2,1,2017,2,15157,1827,16984
1,27,2,1,2017,3,14766,1725,16491
1,27,2,1,2017,4,14848,1668,16516
1,27,2,1,2017,5,15478,1649,17127
1,27,2,1,2017,6,15874,1748,17622
1,27,2,1,2017,7,17037,1934,18971
1,27,2,1,2017,8,17982,2037,20019
1,27,2,1,2017,9,18003,2350,20353
1,27,2,1,2017,10,17565,2601,20166
1,27,2,1,2017,11,17691,2912,20603
1,27,2,1,2017,12,18225,2975,21200
1,27,2,1,2017,13,18249,2965,21214
1,27,2,1,2017,14,18060,2864,20924
1,27,2,1,2017,15,18064,2908,20972
1,27,2,1,2017,16,18139,2923,21062
1,27,2,1,2017,17,17611,2895,20506
1,27,2,1,2017,18,16438,2814,19252
1,27,2,1,2017,19,15920,2708,18628
1,27,2,1,2017,20,15990,2712,18702
1,27,2,1,2017,21,15462,2536,17998
1,27,2,1,2017,22,15578,2394,17972
1,27,2,1,2017,23,15202,2295,17497
1,27,2,1,2017,24,15600,2239,17839
1,28,2,1,2017,1,15847,2017,17864
1,28,2,1,2017,2,15460,1874,17334
1,28,2,1,2017,3,15461,1753,17214
1,28,2,1,2017,4,15375,1682,17057
1,28,2,1,2017,5,15522,1681,17203
1,28,2,1,2017,6,16317,1772,18089
1,28,2,1,2017,7,17495,1965,19460
1,28,2,1,2017,8,18226,2138,20364
1,28,2,1,2017,9,18365,2369,20734
1,28,2,1,2017,10,17693,2723,20416
1,28,2,1,2017,11,17872,2863,20735
1,28,2,1,2017,12,18681,2981,21662
1,28,2,1,2017,13,18605,2977,21582
1,28,2,1,2017,14,18021,2853,20874
1,28,2,1,2017,15,18252,2905,21157
1,28,2,1,2017,16,18149,2946,21095
1,28,2,1,2017,17,17610,2951,20561
1,28,2,1,2017,18,16863,2845,19708
1,28,2,1,2017,19,16108,2783,18891
1,28,2,1,2017,20,16334,2768,19102
1,28,2,1,2017,21,15823,2603,18426
1,28,2,1,2017,22,15322,2453,17775
1,28,2,1,2017,23,15430,2353,17783
1,28,2,1,2017,24,15571,2223,17794
1,1,3,1,2017,1,15923,2082,18005
1,1,3,1,2017,2,15579,1897,17476
1,1,3,1,2017,3,15381,1809,17190
1,1,3,1,2017,4,15501,1736,17237
1,1,3,1,2017,5,15626,1717,17343
1,1,3,1,2017,6,15926,1821,17747
1,1,3,1,2017,7,17412,1967,19379
1,1,3,1,2017,8,18207,2127,20334
1,1,3,1,2017,9,18208,2321,20529
1,1,3,1,2017,10,17603,2724,20327
1,1,3,1,2017,11,17988,2893,20881
1,1,3,1,2017,12,18569,3011,21580
1,1,3,1,2017,13,18676,2985,21661
1,1,3,1,2017,14,18277,2917,21194
1,1,3,1,2017,15,18343,2993,21336
1,1,3,1,2017,16,18383,2995,21378
1,1,3,1,2017,17,17675,2987,20662
1,1,3,1,2017,18,17157,2946,20103
1,1,3,1,2017,19,15999,2827,18826
1,1,3,1,2017,20,16397,2809,19206
1,1,3,1,2017,21,15920,2667,18587
1,1,3,1,2017,22,15411,2488,17899
1,1,3,1,2017,23,15328,2377,17705
1,1,3,1,2017,24,15511,2313,17824
1,2,3,1,2017,1,15638,2115,17753
1,2,3,1,2017,2,15851,1940,17791
1,2,3,1,2017,3,15554,1831,17385
1,2,3,1,2017,4,15385,1752,17137
1,2,3,1,2017,5,15781,1732,17513
1,2,3,1,2017,6,16115,1864,17979
1,2,3,1,2017,7,17406,1986,19392
1,2,3,1,2017,8,17977,2176,20153
1,2,3,1,2017,9,18648,2379,21027
1,2,3,1,2017,10,17556,2770,20326
1,2,3,1,2017,11,17673,2898,20571
1,2,3,1,2017,12,18579,2994,21573
1,2,3,1,2017,13,18492,2982,21474
1,2,3,1,2017,14,18413,2883,21296
1,2,3,1,2017,15,18346,2953,21299
1,2,3,1,2017,16,18436,2957,21393
1,2,3,1,2017,17,17932,2919,20851
1,2,3,1,2017,18,16881,2860,19741
1,2,3,1,2017,19,16360,2737,19097
1,2,3,1,2017,20,16396,2761,19157
1,2,3,1,2017,21,16065,2588,18653
1,2,3,1,2017,22,15347,2446,17793
1,2,3,1,2017,23,15461,2313,17774
1,2,3,1,2017,24,15485,2213,17698
1,3,3,1,2017,1,16070,2038,18108
1,3,3,1,2017,2,15601,1898,17499
1,3,3,1,2017,3,15243,1795,17038
1,3,3,1,2017,4,15366,1741,17107
1,3,3,1,2017,5,15668,1732,17400
1,3,3,1,2017,6,16169,1828,17997
1,3,3,1,2017,7,17822,2012,19834
1,3,3,1,2017,8,18599,2138,20737
1,3,3,1,2017,9,18300,2350,20650
1,3,3,1,2017,10,17520,2698,20218
1,3,3,1,2017,11,17286,2961,20247
1,3,3,1,2017,12,18461,2997,21458
1,3,3,1,2017,13,18200,2952,21152
1,3,3,1,2017,14,17972,2853,20825
1,3,3,1,2017,15,17850,2906,20756
1,3,3,1,2017,16,17899,2918,20817
1,3,3,1,2017,17,17261,2899,20160
1,3,3,1,2017,18,16365,2844,19209
1,3,3,1,2017,19,15928,2717,18645
1,3,3,1,2017,20,16256,2742,18998
1,3,3,1,2017,21,15694,2592,18286
1,3,3,1,2017,22,15249,2446,17695
1,3,3,1,2017,23,14921,2284,17205
1,3,3,1,2017,24,15412,2184,17596
2,4,3,1,2017,1,15568,2005,17573
2,4,3,1,2017,2,15666,1844,17510
2,4,3,1,2017,3,15472,1751,17223
2,4,3,1,2017,4,15647,1696,17343
2,4,3,1,2017,5,15618,1681,17299
2,4,3,1,2017,6,16409,1757,18166
2,4,3,1,2017,7,17641,1872,19513
2,4,3,1,2017,8,18213,1935,20148
2,4,3,1,2017,9,18325,2227,20552
2,4,3,1,2017,10,17745,2482,20227
2,4,3,1,2017,11,17856,2741,20597
2,4,3,1,2017,12,18369,2761,21130
2,4,3,1,2017,13,18504,2758,21262
2,4,3,1,2017,14,18353,2627,20980
2,4,3,1,2017,15,18508,2649,21157
2,4,3,1,2017,16,18250,2645,20895
2,4,3,1,2017,17,17611,2632,20243
2,4,3,1,2017,18,16689,2566,19255
2,4,3,1,2017,19,16025,2533,18558
2,4,3,1,2017,20,16495,2561,19056
2,4,3,1,2017,21,15778,2491,18269
2,4,3,1,2017,22,15459,2364,17823
2,4,3,1,2017,23,15243,2242,17485
2,4,3,1,2017,24,15614,2154,17768
2,5,3,1,2017,1,15803,2018,17821
2,5,3,1,2017,2,15812,1813,17625
2,5,3,1,2017,3,15738,1750,17488
2,5,3,1,2017,4,15598,1681,17279
2,5,3,1,2017,5,15819,1672,17491
2,5,3,1,2017,6,16721,1743,18464
2,5,3,1,2017,7,17145,1771,18916
2,5,3,1,2017,8,17952,1796,19748
2,5,3,1,2017,9,17874,1916,19790
2,5,3,1,2017,10,17054,2038,19092
2,5,3,1,2017,11,17619,2119,19738
2,5,3,1,2017,12,18403,2164,20567
2,5,3,1,2017,13,18078,2160,20238
2,5,3,1,2017,14,17718,2088,19806
2,5,3,1,2017,15,17614,2042,19656
2,5,3,1,2017,16,17350,2012,19362
2,5,3,1,2017,17,16858,1987,18845
2,5,3,1,2017,18,15951,1982,17933
2,5,3,1,2017,19,15210,2017,17227
2,5,3,1,2017,20,15639,2168,17807
2,5,3,1,2017,21,15057,2178,17235
2,5,3,1,2017,22,14715,2151,16866
2,5,3,1,2017,23,14949,2066,17015
2,5,3,1,2017,24,15293,2015,17308
1,6,3,1,2017,1,15592,1857,17449
1,6,3,1,2017,2,15198,1719,16917
1,6,3,1,2017,3,15093,1643,16736
1,6,3,1,2017,4,14980,1597,16577
1,6,3,1,2017,5,15252,1601,16853
1,6,3,1,2017,6,16038,1708,17746
1,6,3,1,2017,7,17404,1895,19299
1,6,3,1,2017,8,17793,2099,19892
1,6,3,1,2017,9,18330,2355,20685
1,6,3,1,2017,10,17304,2694,19998
1,6,3,1,2017,11,17621,2880,20501
1,6,3,1,2017,12,18200,2916,21116
1,6,3,1,2017,13,18569,2912,21481
1,6,3,1,2017,14,18282,2817,21099
1,6,3,1,2017,15,18050,2835,20885
1,6,3,1,2017,16,18085,2840,20925
1,6,3,1,2017,17,17352,2812,20164
1,6,3,1,2017,18,16476,2736,19212
1,6,3,1,2017,19,16524,2675,19199
1,6,3,1,2017,20,16030,2698,18728
1,6,3,1,2017,21,15770,2547,18317
1,6,3,1,2017,22,15487,2416,17903
1,6,3,1,2017,23,15401,2312,17713
1,6,3,1,2017,24,15599,2143,17742
1,7,3,1,2017,1,15652,1961,17613
1,7,3,1,2017,2,15718,1799,17517
1,7,3,1,2017,3,15656,1707,17363
1,7,3,1,2017,4,15489,1637,17126
1,7,3,1,2017,5,15885,1635,17520
1,7,3,1,2017,6,16394,1739,18133
1,7,3,1,2017,7,17767,1908,19675
1,7,3,1,2017,8,18184,2043,20227
1,7,3,1,2017,9,18545,2403,20948
1,7,3,1,2017,10,17642,2639,20281
1,7,3,1,2017,11,17963,2909,20872
1,7,3,1,2017,12,18506,2954,21460
1,7,3,1,2017,13,18136,2926,21062
1,7,3,1,2017,14,17395,2811,20206
1,7,3,1,2017,15,17574,2812,20386
1,7,3,1,2017,16,17603,2828,20431
1,7,3,1,2017,17,17169,2797,19966
1,7,3,1,2017,18,16389,2758,19147
1,7,3,1,2017,19,16227,2644,18871
1,7,3,1,2017,20,16105,2681,18786
1,7,3,1,2017,21,15742,2549,18291
1,7,3,1,2017,22,15380,2425,17805
1,7,3,1,2017,23,15205,2259,17464
1,7,3,1,2017,24,15410,2159,17569
1,8,3,1,2017,1,15725,1990,17715
1,8,3,1,2017,2,15453,1772,17225
1,8,3,1,2017,3,15138,1693,16831
1,8,3,1,2017,4,15432,1631,17063
1,8,3,1,2017,5,15446,1630,17076
1,8,3,1,2017,6,16404,1747,18151
1,8,3,1,2017,7,17430,1924,19354
1,8,3,1,2017,8,18041,2099,20140
1,8,3,1,2017,9,18056,2380,20436
1,8,3,1,2017,10,17439,2670,20109
1,8,3,1,2017,11,17607,2908,20515
1,8,3,1,2017,12,18434,2974,21408
1,8,3,1,2017,13,18160,2948,21108
1,8,3,1,2017,14,18246,2856,21102
1,8,3,1,2017,15,18134,2885,21019
1,8,3,1,2017,16,18030,2904,20934
1,8,3,1,2017,17,17709,2890,20599
1,8,3,1,2017,18,16747,2818,19565
1,8,3,1,2017,19,16004,2708,18712
1,8,3,1,2017,20,16681,2696,19377
1,8,3,1,2017,21,15818,2580,18398
1,8,3,1,2017,22,15365,2435,17800
1,8,3,1,2017,23,15292,2288,17580
1,8,3,1,2017,24,15442,2161,17603
1,9,3,1,2017,1,15716,1995,17711
1,9,3,1,2017,2,15401,1818,17219
1,9,3,1,2017,3,15265,1737,17002
1,9,3,1,2017,4,15314,1675,16989
1,9,3,1,2017,5,15513,1679,17192
1,9,3,1,2017,6,16144,1775,17919
1,9,3,1,2017,7,17434,1961,19395
1,9,3,1,2017,8,18143,2081,20224
1,9,3,1,2017,9,18218,2406,20624
1,9,3,1,2017,10,17673,2668,20341
1,9,3,1,2017,11,17858,2902,20760
1,9,3,1,2017,12,18626,2922,21548
1,9,3,1,2017,13,18531,2884,21415
1,9,3,1,2017,14,18087,2746,20833
1,9,3,1,2017,15,18040,2769,20809
1,9,3,1,2017,16,17954,2786,20740
1,9,3,1,2017,17,17103,2758,19861
1,9,3,1,2017,18,16346,2692,19038
1,9,3,1,2017,19,15820,2607,18427
1,9,3,1,2017,20,16161,2633,18794
1,9,3,1,2017,21,15490,2527,18017
1,9,3,1,2017,22,15226,2360,17586
1,9,3,1,2017,23,15104,2263,17367
1,9,3,1,2017,24,15154,2096,17250
1,10,3,1,2017,1,15577,1940,17517
1,10,3,1,2017,2,15245,1787,17032
1,10,3,1,2017,3,15287,1693,16980
1,10,3,1,2017,4,15144,1639,16783
1,10,3,1,2017,5,15454,1644,17098
1,10,3,1,2017,6,16259,1763,18022
1,10,3,1,2017,7,17236,1917,19153
1,10,3,1,2017,8,18023,2059,20082
1,10,3,1,2017,9,18393,2308,20701
1,10,3,1,2017,10,17056,2659,19715
1,10,3,1,2017,11,16807,2857,19664
1,10,3,1,2017,12,17208,2916,20124
1,10,3,1,2017,13,17009,2871,19880
1,10,3,1,2017,14,16260,2711,18971
1,10,3,1,2017,15,15992,2727,18719
1,10,3,1,2017,16,15988,2751,18739
1,10,3,1,2017,17,15546,2740,18286
1,10,3,1,2017,18,15115,2672,17787
1,10,3,1,2017,19,14817,2621,17438
1,10,3,1,2017,20,15422,2653,18075
1,10,3,1,2017,21,14909,2521,17430
1,10,3,1,2017,22,14860,2353,17213
1,10,3,1,2017,23,14398,2230,16628
1,10,3,1,2017,24,14933,2077,17010
2,11,3,1,2017,1,15052,1910,16962
2,11,3,1,2017,2,14875,1759,16634
2,11,3,1,2017,3,14637,1659,16296
2,11,3,1,2017,4,14735,1602,16337
2,11,3,1,2017,5,15192,1609,16801
2,11,3,1,2017,6,15849,1706,17555
2,11,3,1,2017,7,17015,1816,18831
2,11,3,1,2017,8,17661,1920,19581
2,11,3,1,2017,9,17905,2128,20033
2,11,3,1,2017,10,17114,2434,19548
2,11,3,1,2017,11,17179,2559,19738
2,11,3,1,2017,12,17968,2605,20573
2,11,3,1,2017,13,17511,2550,20061
2,11,3,1,2017,14,17341,2362,19703
2,11,3,1,2017,15,16974,2360,19334
2,11,3,1,2017,16,16982,2348,19330
2,11,3,1,2017,17,16422,2321,18743
2,11,3,1,2017,18,15892,2255,18147
2,11,3,1,2017,19,15481,2292,17773
2,11,3,1,2017,20,16053,2395,18448
2,11,3,1,2017,21,15153,2321,17474
2,11,3,1,2017,22,14760,2227,16987
2,11,3,1,2017,23,14146,2052,16198
2,11,3,1,2017,24,14581,1939,16520
2,12,3,1,2017,1,14520,1789,16309
2,12,3,1,2017,2,14778,1626,16404
2,12,3,1,2017,3,14679,1547,16226
2,12,3,1,2017,4,14694,1497,16191
2,12,3,1,2017,5,14876,1485,16361
2,12,3,1,2017,6,15573,1563,17136
2,12,3,1,2017,7,16403,1606,18009
2,12,3,1,2017,8,17236,1664,18900
2,12,3,1,2017,9,17698,1809,19507
2,12,3,1,2017,10,17016,1893,18909
2,12,3,1,2017,11,17176,2017,19193
2,12,3,1,2017,12,17908,2049,19957
2,12,3,1,2017,13,17709,2008,19717
2,12,3,1,2017,14,17434,1932,19366
2,12,3,1,2017,15,17453,1904,19357
2,12,3,1,2017,16,17369,1844,19213
2,12,3,1,2017,17,16624,1813,18437
2,12,3,1,2017,18,15823,1806,17629
2,12,3,1,2017,19,15115,1875,16990
2,12,3,1,2017,20,14658,2049,16707
2,12,3,1,2017,21,14437,2007,16444
2,12,3,1,2017,22,13743,1965,15708
2,12,3,1,2017,23,13583,1918,15501
2,12,3,1,2017,24,13860,1846,15706
3,13,3,1,2017,1,14355,1669,16024
3,13,3,1,2017,2,14096,1556,15652
3,13,3,1,2017,3,13945,1506,15451
3,13,3,1,2017,4,13869,1479,15348
3,13,3,1,2017,5,14002,1480,15482
3,13,3,1,2017,6,14524,1504,16028
3,13,3,1,2017,7,15285,1512,16797
3,13,3,1,2017,8,15830,1518,17348
3,13,3,1,2017,9,15556,1531,17087
3,13,3,1,2017,10,15097,1571,16668
3,13,3,1,2017,11,15136,1616,16752
3,13,3,1,2017,12,15828,1719,17547
3,13,3,1,2017,13,16073,1805,17878
3,13,3,1,2017,14,15811,1830,17641
3,13,3,1,2017,15,15484,1736,17220
3,13,3,1,2017,16,15487,1720,17207
3,13,3,1,2017,17,14667,1724,16391
3,13,3,1,2017,18,13973,1735,15708
3,13,3,1,2017,19,13399,1812,15211
3,13,3,1,2017,20,13439,1981,15420
3,13,3,1,2017,21,13292,1998,15290
3,13,3,1,2017,22,12564,1977,14541
3,13,3,1,2017,23,12873,1902,14775
3,13,3,1,2017,24,12843,1822,14665
1,14,3,1,2017,1,13356,1670,15026
1,14,3,1,2017,2,13083,1548,14631
1,14,3,1,2017,3,13032,1476,14508
1,14,3,1,2017,4,13162,1433,14595
1,14,3,1,2017,5,13173,1445,14618
1,14,3,1,2017,6,14333,1567,15900
1,14,3,1,2017,7,15615,1733,17348
1,14,3,1,2017,8,16449,1915,18364
1,14,3,1,2017,9,17071,2174,19245
1,14,3,1,2017,10,16676,2514,19190
1,14,3,1,2017,11,16858,2736,19594
1,14,3,1,2017,12,17719,2811,20530
1,14,3,1,2017,13,17652,2779,20431
1,14,3,1,2017,14,17463,2690,20153
1,14,3,1,2017,15,17332,2720,20052
1,14,3,1,2017,16,17621,2731,20352
1,14,3,1,2017,17,17292,2725,20017
1,14,3,1,2017,18,16164,2667,18831
1,14,3,1,2017,19,15383,2575,17958
1,14,3,1,2017,20,15994,2635,18629
1,14,3,1,2017,21,15088,2490,17578
1,14,3,1,2017,22,14837,2360,17197
1,14,3,1,2017,23,14880,2174,17054
1,14,3,1,2017,24,14920,2063,16983
1,15,3,1,2017,1,15061,1865,16926
1,15,3,1,2017,2,14928,1715,16643
1,15,3,1,2017,3,14846,1633,16479
1,15,3,1,2017,4,14949,1575,16524
1,15,3,1,2017,5,15152,1586,16738
1,15,3,1,2017,6,15966,1649,17615
1,15,3,1,2017,7,17022,1869,18891
1,15,3,1,2017,8,17960,2035,19995
1,15,3,1,2017,9,17734,2388,20122
1,15,3,1,2017,10,17068,2613,19681
1,15,3,1,2017,11,17588,2888,20476
1,15,3,1,2017,12,18266,2924,21190
1,15,3,1,2017,13,18033,2901,20934
1,15,3,1,2017,14,17658,2811,20469
1,15,3,1,2017,15,17723,2865,20588
1,15,3,1,2017,16,17749,2862,20611
1,15,3,1,2017,17,16973,2829,19802
1,15,3,1,2017,18,15898,2776,18674
1,15,3,1,2017,19,15561,2684,18245
1,15,3,1,2017,20,15843,2726,18569
1,15,3,1,2017,21,15173,2615,17788
1,15,3,1,2017,22,14613,2479,17092
1,15,3,1,2017,23,14625,2301,16926
1,15,3,1,2017,24,14608,2199,16807
1,16,3,1,2017,1,14896,2004,16900
1,16,3,1,2017,2,14667,1776,16443
1,16,3,1,2017,3,14187,1699,15886
1,16,3,1,2017,4,14244,1639,15883
1,16,3,1,2017,5,14606,1649,16255
1,16,3,1,2017,6,15432,1755,17187
1,16,3,1,2017,7,17145,1926,19071
1,16,3,1,2017,8,17325,2092,19417
1,16,3,1,2017,9,17072,2370,19442
1,16,3,1,2017,10,16614,2704,19318
1,16,3,1,2017,11,17159,2928,20087
1,16,3,1,2017,12,17665,2960,20625
1,16,3,1,2017,13,17664,2929,20593
1,16,3,1,2017,14,17422,2820,20242
1,16,3,1,2017,15,17682,2847,20529
1,16,3,1,2017,16,17418,2848,20266
1,16,3,1,2017,17,16602,2822,19424
1,16,3,1,2017,18,15846,2748,18594
1,16,3,1,2017,19,15464,2682,18146
1,16,3,1,2017,20,15559,2729,18288
1,16,3,1,2017,21,15228,2634,17862
1,16,3,1,2017,22,15046,2444,17490
1,16,3,1,2017,23,14803,2353,17156
1,16,3,1,2017,24,14997,2280,17277
1,17,3,1,2017,1,15249,2011,17260
1,17,3,1,2017,2,14792,1887,16679
1,17,3,1,2017,3,14516,1782,16298
1,17,3,1,2017,4,14577,1708,16285
1,17,3,1,2017,5,15017,1687,16704
1,17,3,1,2017,6,15246,1792,17038
1,17,3,1,2017,7,16869,1940,18809
1,17,3,1,2017,8,17451,2093,19544
1,17,3,1,2017,9,17431,2390,19821
1,17,3,1,2017,10,16586,2715,19301
1,17,3,1,2017,11,16689,2952,19641
1,17,3,1,2017,12,17401,3040,20441
1,17,3,1,2017,13,17455,3020,20475
1,17,3,1,2017,14,17288,2870,20158
1,17,3,1,2017,15,16978,2922,19900
1,17,3,1,2017,16,16875,2936,19811
1,17,3,1,2017,17,16165,2921,19086
1,17,3,1,2017,18,15595,2822,18417
1,17,3,1,2017,19,15278,2736,18014
1,17,3,1,2017,20,15920,2721,18641
1,17,3,1,2017,21,15213,2641,17854
1,17,3,1,2017,22,15013,2422,17435
1,17,3,1,2017,23,14847,2313,17160
1,17,3,1,2017,24,15022,2207,17229
2,18,3,1,2017,1,15195,2063,17258
2,18,3,1,2017,2,15125,1908,17033
2,18,3,1,2017,3,14806,1794,16600
2,18,3,1,2017,4,14761,1721,16482
2,18,3,1,2017,5,15078,1707,16785
2,18,3,1,2017,6,16111,1772,17883
2,18,3,1,2017,7,17082,1877,18959
2,18,3,1,2017,8,17374,1975,19349
2,18,3,1,2017,9,17556,2271,19827
2,18,3,1,2017,10,16836,2519,19355
2,18,3,1,2017,11,17125,2779,19904
2,18,3,1,2017,12,17853,2853,20706
2,18,3,1,2017,13,17898,2839,20737
2,18,3,1,2017,14,17402,2712,20114
2,18,3,1,2017,15,17542,2680,20222
2,18,3,1,2017,16,17436,2688,20124
2,18,3,1,2017,17,16873,2639,19512
2,18,3,1,2017,18,15733,2587,18320
2,18,3,1,2017,19,15523,2538,18061
2,18,3,1,2017,20,16093,2613,18706
2,18,3,1,2017,21,15594,2507,18101
2,18,3,1,2017,22,15217,2394,17611
2,18,3,1,2017,23,15207,2252,17459
2,18,3,1,2017,24,15214,2183,17397
2,19,3,1,2017,1,15262,2056,17318
2,19,3,1,2017,2,15187,1875,17062
2,19,3,1,2017,3,15120,1778,16898
2,19,3,1,2017,4,14998,1706,16704
2,19,3,1,2017,5,15279,1695,16974
2,19,3,1,2017,6,15961,1750,17711
2,19,3,1,2017,7,16910,1776,18686
2,19,3,1,2017,8,17284,1827,19111
2,19,3,1,2017,9,17638,1951,19589
2,19,3,1,2017,10,16952,2074,19026
2,19,3,1,2017,11,16848,2224,19072
2,19,3,1,2017,12,17786,2276,20062
2,19,3,1,2017,13,17860,2273,20133
2,19,3,1,2017,14,17513,2213,19726
2,19,3,1,2017,15,17168,2130,19298
2,19,3,1,2017,16,17277,2117,19394
2,19,3,1,2017,17,16235,2079,18314
2,19,3,1,2017,18,15599,2044,17643
2,19,3,1,2017,19,15115,2075,17190
2,19,3,1,2017,20,15666,2265,17931
2,19,3,1,2017,21,15264,2260,17524
2,19,3,1,2017,22,14866,2245,17111
2,19,3,1,2017,23,14927,2198,17125
2,19,3,1,2017,24,15103,2158,17261
1,20,3,1,2017,1,15439,2025,17464
1,20,3,1,2017,2,15127,1832,16959
1,20,3,1,2017,3,14809,1725,16534
1,20,3,1,2017,4,14852,1677,16529
1,20,3,1,2017,5,15338,1665,17003
1,20,3,1,2017,6,16031,1767,17798
1,20,3,1,2017,7,17119,1912,19031
1,20,3,1,2017,8,17452,2091,19543
1,20,3,1,2017,9,17617,2374,19991
1,20,3,1,2017,10,16659,2763,19422
1,20,3,1,2017,11,17212,2934,20146
1,20,3,1,2017,12,17812,3056,20868
1,20,3,1,2017,13,17983,3022,21005
1,20,3,1,2017,14,17776,2911,20687
1,20,3,1,2017,15,18089,2948,21037
1,20,3,1,2017,16,18015,2972,20987
1,20,3,1,2017,17,17333,2952,20285
1,20,3,1,2017,18,17031,2856,19887
1,20,3,1,2017,19,15906,2754,18660
1,20,3,1,2017,20,16414,2759,19173
1,20,3,1,2017,21,16005,2655,18660
1,20,3,1,2017,22,15553,2492,18045
1,20,3,1,2017,23,15361,2399,17760
1,20,3,1,2017,24,15922,2329,18251
1,21,3,1,2017,1,15739,2102,17841
1,21,3,1,2017,2,15536,1938,17474
1,21,3,1,2017,3,15465,1826,17291
1,21,3,1,2017,4,15301,1762,17063
1,21,3,1,2017,5,15669,1739,17408
1,21,3,1,2017,6,16424,1838,18262
1,21,3,1,2017,7,17491,1997,19488
1,21,3,1,2017,8,18168,2176,20344
1,21,3,1,2017,9,17964,2399,20363
1,21,3,1,2017,10,17579,2833,20412
1,21,3,1,2017,11,17717,3045,20762
1,21,3,1,2017,12,18674,3123,21797
1,21,3,1,2017,13,18503,3093,21596
1,21,3,1,2017,14,18013,2969,20982
1,21,3,1,2017,15,18271,2999,21270
1,21,3,1,2017,16,18504,3011,21515
1,21,3,1,2017,17,17793,2996,20789
1,21,3,1,2017,18,17146,2923,20069
1,21,3,1,2017,19,16298,2816,19114
1,21,3,1,2017,20,16539,2843,19382
1,21,3,1,2017,21,16208,2707,18915
1,21,3,1,2017,22,16094,2522,18616
1,21,3,1,2017,23,15598,2435,18033
1,21,3,1,2017,24,16049,2345,18394
1,22,3,1,2017,1,16236,2164,18400
1,22,3,1,2017,2,16037,1971,18008
1,22,3,1,2017,3,15617,1848,17465
1,22,3,1,2017,4,16028,1761,17789
1,22,3,1,2017,5,16048,1749,17797
1,22,3,1,2017,6,16240,1814,18054
1,22,3,1,2017,7,17867,2005,19872
1,22,3,1,2017,8,18384,2155,20539
1,22,3,1,2017,9,18051,2552,20603
1,22,3,1,2017,10,17539,2800,20339
1,22,3,1,2017,11,17980,3086,21066
1,22,3,1,2017,12,18552,3133,21685
1,22,3,1,2017,13,18830,3086,21916
1,22,3,1,2017,14,18308,2964,21272
1,22,3,1,2017,15,18635,2986,21621
1,22,3,1,2017,16,18433,2973,21406
1,22,3,1,2017,17,17844,2970,20814
1,22,3,1,2017,18,17345,2895,20240
1,22,3,1,2017,19,16516,2750,19266
1,22,3,1,2017,20,16777,2795,19572
1,22,3,1,2017,21,15917,2657,18574
1,22,3,1,2017,22,15879,2525,18404
1,22,3,1,2017,23,15870,2424,18294
1,22,3,1,2017,24,16267,2374,18641
1,23,3,1,2017,1,16531,2182,18713
1,23,3,1,2017,2,16022,1980,18002
1,23,3,1,2017,3,15780,1849,17629
1,23,3,1,2017,4,15745,1775,17520
1,23,3,1,2017,5,15869,1767,17636
1,23,3,1,2017,6,16640,1845,18485
1,23,3,1,2017,7,17848,2025,19873
1,23,3,1,2017,8,17951,2169,20120
1,23,3,1,2017,9,17980,2464,20444
1,23,3,1,2017,10,17865,2804,20669
1,23,3,1,2017,11,18062,3025,21087
1,23,3,1,2017,12,18795,3090,21885
1,23,3,1,2017,13,18826,3077,21903
1,23,3,1,2017,14,18319,2967,21286
1,23,3,1,2017,15,18333,3014,21347
1,23,3,1,2017,16,18674,3029,21703
1,23,3,1,2017,17,18159,2986,21145
1,23,3,1,2017,18,17253,2908,20161
1,23,3,1,2017,19,16474,2778,19252
1,23,3,1,2017,20,16867,2772,19639
1,23,3,1,2017,21,16152,2641,18793
1,23,3,1,2017,22,16272,2474,18746
1,23,3,1,2017,23,16205,2400,18605
1,23,3,1,2017,24,16314,2341,18655
1,24,3,1,2017,1,16668,2154,18822
1,24,3,1,2017,2,16558,1972,18530
1,24,3,1,2017,3,16339,1860,18199
1,24,3,1,2017,4,16206,1794,18000
1,24,3,1,2017,5,16507,1782,18289
1,24,3,1,2017,6,16727,1876,18603
1,24,3,1,2017,7,17998,1989,19987
1,24,3,1,2017,8,18351,2144,20495
1,24,3,1,2017,9,18228,2435,20663
1,24,3,1,2017,10,17520,2854,20374
1,24,3,1,2017,11,17656,2996,20652
1,24,3,1,2017,12,18386,3106,21492
1,24,3,1,2017,13,18379,3122,21501
1,24,3,1,2017,14,18281,2969,21250
1,24,3,1,2017,15,18230,2995,21225
1,24,3,1,2017,16,18234,3036,21270
1,24,3,1,2017,17,17924,3026,20950
1,24,3,1,2017,18,16810,3026,19836
1,24,3,1,2017,19,15898,2810,18708
1,24,3,1,2017,20,16655,2831,19486
1,24,3,1,2017,21,16281,2686,18967
1,24,3,1,2017,22,16136,2567,18703
1,24,3,1,2017,23,16282,2474,18756
1,24,3,1,2017,24,16641,2420,19061
2,25,3,1,2017,1,17073,2254,19327
2,25,3,1,2017,2,16817,2062,18879
2,25,3,1,2017,3,16150,1933,18083
2,25,3,1,2017,4,16167,1841,18008
2,25,3,1,2017,5,16553,1807,18360
2,25,3,1,2017,6,17055,1858,18913
2,25,3,1,2017,7,18212,1944,20156
2,25,3,1,2017,8,18388,2037,20425
2,25,3,1,2017,9,17982,2309,20291
2,25,3,1,2017,10,17443,2522,19965
2,25,3,1,2017,11,17716,2824,20540
2,25,3,1,2017,12,18985,2885,21870
2,25,3,1,2017,13,18954,2904,21858
2,25,3,1,2017,14,18638,2778,21416
2,25,3,1,2017,15,18657,2832,21489
2,25,3,1,2017,16,18823,2827,21650
2,25,3,1,2017,17,18155,2746,20901
2,25,3,1,2017,18,17532,2691,20223
2,25,3,1,2017,19,16648,2604,19252
2,25,3,1,2017,20,16852,2662,19514
2,25,3,1,2017,21,16592,2544,19136
2,25,3,1,2017,22,16783,2554,19337
2,25,3,1,2017,23,16611,2408,19019
2,25,3,1,2017,24,16954,2384,19338
2,26,3,1,2017,1,17255,2229,19484
2,26,3,1,2017,2,16799,2065,18864
2,26,3,1,2017,3,16880,1947,18827
2,26,3,1,2017,4,16612,1860,18472
2,26,3,1,2017,5,16816,1830,18646
2,26,3,1,2017,6,17245,1881,19126
2,26,3,1,2017,7,18307,1879,20186
2,26,3,1,2017,8,18133,1903,20036
2,26,3,1,2017,9,18280,2000,20280
2,26,3,1,2017,10,17474,2144,19618
2,26,3,1,2017,11,17928,2250,20178
2,26,3,1,2017,12,18628,2317,20945
2,26,3,1,2017,13,18630,2331,20961
2,26,3,1,2017,14,18442,2303,20745
2,26,3,1,2017,15,18532,2331,20863
2,26,3,1,2017,16,18663,2289,20952
2,26,3,1,2017,17,17864,2246,20110
2,26,3,1,2017,18,17093,2184,19277
2,26,3,1,2017,19,16278,2190,18468
2,26,3,1,2017,20,16725,2321,19046
2,26,3,1,2017,21,16513,2255,18768
2,26,3,1,2017,22,16465,2336,18801
2,26,3,1,2017,23,16728,2410,19138
2,26,3,1,2017,24,17104,2425,19529
1,27,3,1,2017,1,17224,2287,19511
1,27,3,1,2017,2,16910,2124,19034
1,27,3,1,2017,3,16876,1979,18855
1,27,3,1,2017,4,16841,1885,18726
1,27,3,1,2017,5,17125,1844,18969
1,27,3,1,2017,6,17138,1887,19025
1,27,3,1,2017,7,18063,2045,20108
1,27,3,1,2017,8,18170,2133,20303
1,27,3,1,2017,9,18331,2487,20818
1,27,3,1,2017,10,17842,2781,20623
1,27,3,1,2017,11,18368,3054,21422
1,27,3,1,2017,12,19410,3228,22638
1,27,3,1,2017,13,19545,3239,22784
1,27,3,1,2017,14,18911,3162,22073
1,27,3,1,2017,15,18743,3226,21969
1,27,3,1,2017,16,19195,3264,22459
1,27,3,1,2017,17,18760,3262,22022
1,27,3,1,2017,18,17726,3094,20820
1,27,3,1,2017,19,16826,2917,19743
1,27,3,1,2017,20,17359,2971,20330
1,27,3,1,2017,21,17206,2833,20039
1,27,3,1,2017,22,17017,2709,19726
1,27,3,1,2017,23,16893,2681,19574
1,27,3,1,2017,24,17401,2661,20062
3,28,3,1,2017,1,17851,2508,20359
3,28,3,1,2017,2,17124,2297,19421
3,28,3,1,2017,3,17037,2133,19170
3,28,3,1,2017,4,17023,2025,19048
3,28,3,1,2017,5,17184,2000,19184
3,28,3,1,2017,6,17966,2040,20006
3,28,3,1,2017,7,18117,2059,20176
3,28,3,1,2017,8,18344,2126,20470
3,28,3,1,2017,9,18243,2266,20509
3,28,3,1,2017,10,17645,2564,20209
3,28,3,1,2017,11,18331,2792,21123
3,28,3,1,2017,12,19330,2866,22196
3,28,3,1,2017,13,18939,2920,21859
3,28,3,1,2017,14,18695,2861,21556
3,28,3,1,2017,15,18608,2902,21510
3,28,3,1,2017,16,18842,2894,21736
3,28,3,1,2017,17,18541,2862,21403
3,28,3,1,2017,18,17277,2734,20011
3,28,3,1,2017,19,16187,2698,18885
3,28,3,1,2017,20,16599,2773,19372
3,28,3,1,2017,21,16581,2748,19329
3,28,3,1,2017,22,16780,2708,19488
3,28,3,1,2017,23,16939,2758,19697
3,28,3,1,2017,24,17246,2742,19988
1,29,3,1,2017,1,17224,2484,19708
1,29,3,1,2017,2,17117,2305,19422
1,29,3,1,2017,3,16937,2148,19085
1,29,3,1,2017,4,17032,2042,19074
1,29,3,1,2017,5,17099,2013,19112
1,29,3,1,2017,6,17649,2058,19707
1,29,3,1,2017,7,18362,2177,20539
1,29,3,1,2017,8,18485,2248,20733
1,29,3,1,2017,9,18307,2593,20900
1,29,3,1,2017,10,18017,3060,21077
1,29,3,1,2017,11,18644,3192,21836
1,29,3,1,2017,12,19557,3336,22893
1,29,3,1,2017,13,19328,3341,22669
1,29,3,1,2017,14,17634,3251,20885
1,29,3,1,2017,15,18694,3287,21981
1,29,3,1,2017,16,18708,3298,22006
1,29,3,1,2017,17,19019,3216,22235
1,29,3,1,2017,18,17907,3138,21045
1,29,3,1,2017,19,17203,3034,20237
1,29,3,1,2017,20,17935,3084,21019
1,29,3,1,2017,21,17402,2939,20341
1,29,3,1,2017,22,17147,2790,19937
1,29,3,1,2017,23,17305,2791,20096
1,29,3,1,2017,24,17855,2779,20634
1,30,3,1,2017,1,17830,2574,20404
1,30,3,1,2017,2,17336,2282,19618
1,30,3,1,2017,3,17319,2164,19483
1,30,3,1,2017,4,17144,2065,19209
1,30,3,1,2017,5,17525,2028,19553
1,30,3,1,2017,6,17932,2095,20027
1,30,3,1,2017,7,18707,2174,20881
1,30,3,1,2017,8,18337,2326,20663
1,30,3,1,2017,9,18330,2589,20919
1,30,3,1,2017,10,18083,3047,21130
1,30,3,1,2017,11,18825,3195,22020
1,30,3,1,2017,12,19682,3332,23014
1,30,3,1,2017,13,19745,3310,23055
1,30,3,1,2017,14,19639,3208,22847
1,30,3,1,2017,15,19264,3277,22541
1,30,3,1,2017,16,19591,3278,22869
1,30,3,1,2017,17,18945,3237,22182
1,30,3,1,2017,18,17869,3110,20979
1,30,3,1,2017,19,17271,2990,20261
1,30,3,1,2017,20,17714,2964,20678
1,30,3,1,2017,21,17447,2832,20279
1,30,3,1,2017,22,16932,2773,19705
1,30,3,1,2017,23,17555,2750,20305
1,30,3,1,2017,24,17843,2650,20493
1,31,3,1,2017,1,17973,2519,20492
1,31,3,1,2017,2,17578,2291,19869
1,31,3,1,2017,3,17503,2128,19631
1,31,3,1,2017,4,17781,2013,19794
1,31,3,1,2017,5,17499,1982,19481
1,31,3,1,2017,6,17965,2048,20013
1,31,3,1,2017,7,18585,2146,20731
1,31,3,1,2017,8,18458,2277,20735
1,31,3,1,2017,9,18150,2512,20662
1,31,3,1,2017,10,17349,2934,20283
1,31,3,1,2017,11,18184,3240,21424
1,31,3,1,2017,12,18921,3287,22208
1,31,3,1,2017,13,18877,3303,22180
1,31,3,1,2017,14,18829,3183,22012
1,31,3,1,2017,15,18771,3205,21976
1,31,3,1,2017,16,19185,3212,22397
1,31,3,1,2017,17,18374,3186,21560
1,31,3,1,2017,18,17350,3023,20373
1,31,3,1,2017,19,16785,2916,19701
1,31,3,1,2017,20,17150,2920,20070
1,31,3,1,2017,21,16726,2825,19551
1,31,3,1,2017,22,16792,2718,19510
1,31,3,1,2017,23,17078,2627,19705
1,31,3,1,2017,24,17351,2664,20015
3,1,4,2,2017,1,17660,2499,20159
3,1,4,2,2017,2,17904,2225,20129
3,1,4,2,2017,3,17343,2123,19466
3,1,4,2,2017,4,17477,2026,19503
3,1,4,2,2017,5,17555,1980,19535
3,1,4,2,2017,6,17850,2023,19873
3,1,4,2,2017,7,18658,2070,20728
3,1,4,2,2017,8,17957,2145,20102
3,1,4,2,2017,9,17891,2257,20148
3,1,4,2,2017,10,17261,2634,19895
3,1,4,2,2017,11,18116,2921,21037
3,1,4,2,2017,12,18871,2979,21850
3,1,4,2,2017,13,19043,2992,22035
3,1,4,2,2017,14,18830,2911,21741
3,1,4,2,2017,15,19015,2943,21958
3,1,4,2,2017,16,19114,2933,22047
3,1,4,2,2017,17,18427,2877,21304
3,1,4,2,2017,18,16733,2764,19497
3,1,4,2,2017,19,16415,2707,19122
3,1,4,2,2017,20,16864,2769,19633
3,1,4,2,2017,21,16494,2731,19225
3,1,4,2,2017,22,16241,2624,18865
3,1,4,2,2017,23,16732,2567,19299
3,1,4,2,2017,24,17038,2552,19590
2,2,4,2,2017,1,17014,2459,19473
2,2,4,2,2017,2,16945,2230,19175
2,2,4,2,2017,3,16466,2102,18568
2,2,4,2,2017,4,16258,2010,18268
2,2,4,2,2017,5,16409,1962,18371
2,2,4,2,2017,6,17249,1979,19228
2,2,4,2,2017,7,17859,1965,19824
2,2,4,2,2017,8,17764,1964,19728
2,2,4,2,2017,9,17602,2050,19652
2,2,4,2,2017,10,17112,2140,19252
2,2,4,2,2017,11,17787,2244,20031
2,2,4,2,2017,12,18475,2306,20781
2,2,4,2,2017,13,18490,2390,20880
2,2,4,2,2017,14,18377,2327,20704
2,2,4,2,2017,15,18200,2305,20505
2,2,4,2,2017,16,18546,2279,20825
2,2,4,2,2017,17,17784,2243,20027
2,2,4,2,2017,18,16875,2196,19071
2,2,4,2,2017,19,15892,2231,18123
2,2,4,2,2017,20,16745,2404,19149
2,2,4,2,2017,21,16504,2413,18917
2,2,4,2,2017,22,16371,2373,18744
2,2,4,2,2017,23,16592,2338,18930
2,2,4,2,2017,24,17281,2300,19581
1,3,4,2,2017,1,17397,2424,19821
1,3,4,2,2017,2,17071,2196,19267
1,3,4,2,2017,3,16744,2033,18777
1,3,4,2,2017,4,16346,1929,18275
1,3,4,2,2017,5,16595,1893,18488
1,3,4,2,2017,6,17234,1957,19191
1,3,4,2,2017,7,17759,2056,19815
1,3,4,2,2017,8,17782,2186,19968
1,3,4,2,2017,9,18114,2422,20536
1,3,4,2,2017,10,17570,2854,20424
1,3,4,2,2017,11,18018,3211,21229
1,3,4,2,2017,12,19193,3256,22449
1,3,4,2,2017,13,19158,3158,22316
1,3,4,2,2017,14,19072,3080,22152
1,3,4,2,2017,15,18971,3126,22097
1,3,4,2,2017,16,18965,3141,22106
1,3,4,2,2017,17,18721,3084,21805
1,3,4,2,2017,18,17507,2982,20489
1,3,4,2,2017,19,16682,2833,19515
1,3,4,2,2017,20,17075,2822,19897
1,3,4,2,2017,21,16643,2802,19445
1,3,4,2,2017,22,16789,2688,19477
1,3,4,2,2017,23,17159,2641,19800
1,3,4,2,2017,24,17596,2618,20214
3,4,4,2,2017,1,17779,2449,20228
3,4,4,2,2017,2,17231,2220,19451
3,4,4,2,2017,3,17078,2058,19136
3,4,4,2,2017,4,17017,1947,18964
3,4,4,2,2017,5,17151,1912,19063
3,4,4,2,2017,6,17786,1977,19763
3,4,4,2,2017,7,18121,2077,20198
3,4,4,2,2017,8,18573,2206,20779
3,4,4,2,2017,9,18280,2442,20722
3,4,4,2,2017,10,18037,2864,20901
3,4,4,2,2017,11,18229,3190,21419
3,4,4,2,2017,12,19172,3196,22368
3,4,4,2,2017,13,18037,3129,21166
3,4,4,2,2017,14,18328,3044,21372
3,4,4,2,2017,15,18233,3088,21321
3,4,4,2,2017,16,18276,3101,21377
3,4,4,2,2017,17,18217,3028,21245
3,4,4,2,2017,18,18040,2952,20992
3,4,4,2,2017,19,16782,2807,19589
3,4,4,2,2017,20,17167,2868,20035
3,4,4,2,2017,21,16736,2755,19491
3,4,4,2,2017,22,16491,2753,19244
3,4,4,2,2017,23,17115,2640,19755
3,4,4,2,2017,24,17538,2596,20134
1,5,4,2,2017,1,17815,2483,20298
1,5,4,2,2017,2,17882,2255,20137
1,5,4,2,2017,3,17101,2093,19194
1,5,4,2,2017,4,16904,1982,18886
1,5,4,2,2017,5,17115,1947,19062
1,5,4,2,2017,6,17712,2047,19759
1,5,4,2,2017,7,18641,2192,20833
1,5,4,2,2017,8,18716,2260,20976
1,5,4,2,2017,9,18291,2497,20788
1,5,4,2,2017,10,18008,3130,21138
1,5,4,2,2017,11,18542,3224,21766
1,5,4,2,2017,12,19688,3177,22865
1,5,4,2,2017,13,19258,3116,22374
1,5,4,2,2017,14,18906,3252,22158
1,5,4,2,2017,15,18845,3277,22122
1,5,4,2,2017,16,19154,3118,22272
1,5,4,2,2017,17,18784,3092,21876
1,5,4,2,2017,18,17629,3120,20749
1,5,4,2,2017,19,16521,3054,19575
1,5,4,2,2017,20,17375,2925,20300
1,5,4,2,2017,21,16919,2913,19832
1,5,4,2,2017,22,17051,2558,19609
1,5,4,2,2017,23,16902,2713,19615
1,5,4,2,2017,24,17623,2692,20315
1,6,4,2,2017,1,17858,2508,20366
1,6,4,2,2017,2,17670,2325,19995
1,6,4,2,2017,3,17307,2125,19432
1,6,4,2,2017,4,17232,2038,19270
1,6,4,2,2017,5,17617,1985,19602
1,6,4,2,2017,6,18021,2047,20068
1,6,4,2,2017,7,18175,2150,20325
1,6,4,2,2017,8,18246,2249,20495
1,6,4,2,2017,9,18215,2616,20831
1,6,4,2,2017,10,18346,2856,21202
1,6,4,2,2017,11,18459,3175,21634
1,6,4,2,2017,12,19184,3263,22447
1,6,4,2,2017,13,19219,3267,22486
1,6,4,2,2017,14,18894,3142,22036
1,6,4,2,2017,15,19014,3203,22217
1,6,4,2,2017,16,18973,3231,22204
1,6,4,2,2017,17,18852,3188,22040
1,6,4,2,2017,18,17592,3129,20721
1,6,4,2,2017,19,16954,2954,19908
1,6,4,2,2017,20,17245,2944,20189
1,6,4,2,2017,21,17269,2902,20171
1,6,4,2,2017,22,17138,2782,19920
1,6,4,2,2017,23,17167,2743,19910
1,6,4,2,2017,24,17821,2665,20486
1,7,4,2,2017,1,17657,2505,20162
1,7,4,2,2017,2,17658,2285,19943
1,7,4,2,2017,3,17423,2098,19521
1,7,4,2,2017,4,17331,2017,19348
1,7,4,2,2017,5,17433,1976,19409
1,7,4,2,2017,6,18259,2037,20296
1,7,4,2,2017,7,18620,2125,20745
1,7,4,2,2017,8,18524,2245,20769
1,7,4,2,2017,9,18086,2598,20684
1,7,4,2,2017,10,17490,2808,20298
1,7,4,2,2017,11,17944,3151,21095
1,7,4,2,2017,12,18289,3211,21500
1,7,4,2,2017,13,18580,3191,21771
1,7,4,2,2017,14,18465,3054,21519
1,7,4,2,2017,15,18189,3083,21272
1,7,4,2,2017,16,18538,3095,21633
1,7,4,2,2017,17,17768,3040,20808
1,7,4,2,2017,18,17236,2941,20177
1,7,4,2,2017,19,16224,2800,19024
1,7,4,2,2017,20,16811,2839,19650
1,7,4,2,2017,21,16606,2724,19330
1,7,4,2,2017,22,16445,2577,19022
1,7,4,2,2017,23,16908,2488,19396
1,7,4,2,2017,24,17476,2410,19886
2,8,4,2,2017,1,17612,2270,19882
2,8,4,2,2017,2,17282,2125,19407
2,8,4,2,2017,3,17153,1950,19103
2,8,4,2,2017,4,17066,1861,18927
2,8,4,2,2017,5,17039,1833,18872
2,8,4,2,2017,6,17096,1891,18987
2,8,4,2,2017,7,18002,1934,19936
2,8,4,2,2017,8,17970,2006,19976
2,8,4,2,2017,9,18003,2122,20125
2,8,4,2,2017,10,17635,2439,20074
2,8,4,2,2017,11,17545,2707,20252
2,8,4,2,2017,12,18476,2804,21280
2,8,4,2,2017,13,18527,2814,21341
2,8,4,2,2017,14,18586,2721,21307
2,8,4,2,2017,15,18732,2764,21496
2,8,4,2,2017,16,18987,2770,21757
2,8,4,2,2017,17,18425,2752,21177
2,8,4,2,2017,18,17679,2655,20334
2,8,4,2,2017,19,16630,2595,19225
2,8,4,2,2017,20,17244,2682,19926
2,8,4,2,2017,21,16966,2658,19624
2,8,4,2,2017,22,16940,2479,19419
2,8,4,2,2017,23,16988,2465,19453
2,8,4,2,2017,24,17504,2396,19900
3,9,4,2,2017,1,17629,2247,19876
3,9,4,2,2017,2,17547,2099,19646
3,9,4,2,2017,3,17201,1976,19177
3,9,4,2,2017,4,17064,1901,18965
3,9,4,2,2017,5,17244,1874,19118
3,9,4,2,2017,6,17410,1910,19320
3,9,4,2,2017,7,18206,1912,20118
3,9,4,2,2017,8,18132,1925,20057
3,9,4,2,2017,9,17924,1997,19921
3,9,4,2,2017,10,17262,2098,19360
3,9,4,2,2017,11,17616,2175,19791
3,9,4,2,2017,12,18376,2269,20645
3,9,4,2,2017,13,18404,2300,20704
3,9,4,2,2017,14,18107,2290,20397
3,9,4,2,2017,15,18420,2337,20757
3,9,4,2,2017,16,18435,2339,20774
3,9,4,2,2017,17,18121,2297,20418
3,9,4,2,2017,18,17255,2238,19493
3,9,4,2,2017,19,16219,2246,18465
3,9,4,2,2017,20,16704,2401,19105
3,9,4,2,2017,21,16464,2469,18933
3,9,4,2,2017,22,16686,2478,19164
3,9,4,2,2017,23,16755,2498,19253
3,9,4,2,2017,24,17378,2508,19886
1,10,4,2,2017,1,17691,2404,20095
1,10,4,2,2017,2,17327,2147,19474
1,10,4,2,2017,3,17060,2038,19098
1,10,4,2,2017,4,16752,1926,18678
1,10,4,2,2017,5,16974,1888,18862
1,10,4,2,2017,6,17443,1946,19389
1,10,4,2,2017,7,18000,2044,20044
1,10,4,2,2017,8,17840,2137,19977
1,10,4,2,2017,9,17733,2521,20254
1,10,4,2,2017,10,17466,2814,20280
1,10,4,2,2017,11,17938,3153,21091
1,10,4,2,2017,12,18525,3284,21809
1,10,4,2,2017,13,19004,3290,22294
1,10,4,2,2017,14,18778,3241,22019
1,10,4,2,2017,15,19228,3307,22535
1,10,4,2,2017,16,19310,3326,22636
1,10,4,2,2017,17,18814,3287,22101
1,10,4,2,2017,18,17862,3104,20966
1,10,4,2,2017,19,16656,2938,19594
1,10,4,2,2017,20,17469,2941,20410
1,10,4,2,2017,21,17269,2858,20127
1,10,4,2,2017,22,16735,2795,19530
1,10,4,2,2017,23,17089,2804,19893
1,10,4,2,2017,24,17540,2836,20376
1,11,4,2,2017,1,17952,2645,20597
1,11,4,2,2017,2,17697,2417,20114
1,11,4,2,2017,3,17378,2244,19622
1,11,4,2,2017,4,17383,2107,19490
1,11,4,2,2017,5,17212,2063,19275
1,11,4,2,2017,6,17757,2128,19885
1,11,4,2,2017,7,18301,2175,20476
1,11,4,2,2017,8,18016,2337,20353
1,11,4,2,2017,9,18187,2558,20745
1,11,4,2,2017,10,17707,3025,20732
1,11,4,2,2017,11,18698,3225,21923
1,11,4,2,2017,12,18919,3391,22310
1,11,4,2,2017,13,19018,3413,22431
1,11,4,2,2017,14,19130,3341,22471
1,11,4,2,2017,15,19230,3432,22662
1,11,4,2,2017,16,19552,3442,22994
1,11,4,2,2017,17,19251,3317,22568
1,11,4,2,2017,18,17987,3350,21337
1,11,4,2,2017,19,16829,3049,19878
1,11,4,2,2017,20,17572,3036,20608
1,11,4,2,2017,21,17041,2974,20015
1,11,4,2,2017,22,17286,2848,20134
1,11,4,2,2017,23,17616,2857,20473
1,11,4,2,2017,24,17840,2863,20703
1,12,4,2,2017,1,17948,2669,20617
1,12,4,2,2017,2,17766,2457,20223
1,12,4,2,2017,3,17529,2283,19812
1,12,4,2,2017,4,17201,2156,19357
1,12,4,2,2017,5,17437,2104,19541
1,12,4,2,2017,6,18130,2164,20294
1,12,4,2,2017,7,17439,2218,19657
1,12,4,2,2017,8,18347,2344,20691
1,12,4,2,2017,9,17856,2599,20455
1,12,4,2,2017,10,17390,3088,20478
1,12,4,2,2017,11,17776,3247,21023
1,12,4,2,2017,12,18182,3446,21628
1,12,4,2,2017,13,18678,3456,22134
1,12,4,2,2017,14,18622,3398,22020
1,12,4,2,2017,15,18726,3463,22189
1,12,4,2,2017,16,19288,3471,22759
1,12,4,2,2017,17,19103,3439,22542
1,12,4,2,2017,18,18001,3269,21270
1,12,4,2,2017,19,16831,3108,19939
1,12,4,2,2017,20,17870,3109,20979
1,12,4,2,2017,21,17368,2973,20341
1,12,4,2,2017,22,17120,2875,19995
1,12,4,2,2017,23,17673,2867,20540
1,12,4,2,2017,24,18089,2863,20952
1,13,4,2,2017,1,17657,2722,20379
1,13,4,2,2017,2,17582,2420,20002
1,13,4,2,2017,3,17281,2258,19539
1,13,4,2,2017,4,16959,2134,19093
1,13,4,2,2017,5,17106,2089,19195
1,13,4,2,2017,6,17782,2114,19896
1,13,4,2,2017,7,18024,2175,20199
1,13,4,2,2017,8,18198,2246,20444
1,13,4,2,2017,9,18034,2620,20654
1,13,4,2,2017,10,17005,2936,19941
1,13,4,2,2017,11,17173,3270,20443
1,13,4,2,2017,12,18567,3417,21984
1,13,4,2,2017,13,18871,3425,22296
1,13,4,2,2017,14,18753,3317,22070
1,13,4,2,2017,15,18822,3393,22215
1,13,4,2,2017,16,19283,3404,22687
1,13,4,2,2017,17,19167,3332,22499
1,13,4,2,2017,18,17898,3245,21143
1,13,4,2,2017,19,16868,3038,19906
1,13,4,2,2017,20,17413,3055,20468
1,13,4,2,2017,21,17290,2988,20278
1,13,4,2,2017,22,17252,2846,20098
1,13,4,2,2017,23,17594,2848,20442
1,13,4,2,2017,24,17855,2872,20727
3,14,4,2,2017,1,18211,2742,20953
3,14,4,2,2017,2,17845,2473,20318
3,14,4,2,2017,3,17776,2333,20109
3,14,4,2,2017,4,17407,2203,19610
3,14,4,2,2017,5,17632,2140,19772
3,14,4,2,2017,6,18125,2154,20279
3,14,4,2,2017,7,18656,2145,20801
3,14,4,2,2017,8,18645,2224,20869
3,14,4,2,2017,9,18561,2393,20954
3,14,4,2,2017,10,17856,2748,20604
3,14,4,2,2017,11,18114,2906,21020
3,14,4,2,2017,12,18950,3051,22001
3,14,4,2,2017,13,18903,3063,21966
3,14,4,2,2017,14,18888,2964,21852
3,14,4,2,2017,15,18835,3076,21911
3,14,4,2,2017,16,18944,3092,22036
3,14,4,2,2017,17,18637,3056,21693
3,14,4,2,2017,18,17768,2970,20738
3,14,4,2,2017,19,16606,2869,19475
3,14,4,2,2017,20,17383,2938,20321
3,14,4,2,2017,21,17324,2904,20228
3,14,4,2,2017,22,16619,2783,19402
3,14,4,2,2017,23,17095,2769,19864
3,14,4,2,2017,24,17677,2784,20461
2,15,4,2,2017,1,17866,2684,20550
2,15,4,2,2017,2,17427,2468,19895
2,15,4,2,2017,3,17370,2299,19669
2,15,4,2,2017,4,17074,2183,19257
2,15,4,2,2017,5,17323,2130,19453
2,15,4,2,2017,6,17786,2152,19938
2,15,4,2,2017,7,18576,2133,20709
2,15,4,2,2017,8,18165,2211,20376
2,15,4,2,2017,9,17907,2401,20308
2,15,4,2,2017,10,17772,2813,20585
2,15,4,2,2017,11,18257,3006,21263
2,15,4,2,2017,12,18944,3130,22074
2,15,4,2,2017,13,18747,3174,21921
2,15,4,2,2017,14,18677,3069,21746
2,15,4,2,2017,15,19059,3119,22178
2,15,4,2,2017,16,18880,3145,22025
2,15,4,2,2017,17,18460,3060,21520
2,15,4,2,2017,18,17530,3006,20536
2,15,4,2,2017,19,16932,2855,19787
2,15,4,2,2017,20,17780,2941,20721
2,15,4,2,2017,21,17516,2905,20421
2,15,4,2,2017,22,17186,2776,19962
2,15,4,2,2017,23,17479,2747,20226
2,15,4,2,2017,24,17999,2754,20753
2,16,4,2,2017,1,18381,2657,21038
2,16,4,2,2017,2,17667,2403,20070
2,16,4,2,2017,3,17359,2276,19635
2,16,4,2,2017,4,17403,2165,19568
2,16,4,2,2017,5,17397,2097,19494
2,16,4,2,2017,6,17898,2098,19996
2,16,4,2,2017,7,18419,2055,20474
2,16,4,2,2017,8,17959,2039,19998
2,16,4,2,2017,9,17626,2115,19741
2,16,4,2,2017,10,17109,2193,19302
2,16,4,2,2017,11,17770,2327,20097
2,16,4,2,2017,12,18557,2376,20933
2,16,4,2,2017,13,18230,2425,20655
2,16,4,2,2017,14,18045,2412,20457
2,16,4,2,2017,15,18445,2437,20882
2,16,4,2,2017,16,18444,2430,20874
2,16,4,2,2017,17,18208,2379,20587
2,16,4,2,2017,18,17087,2258,19345
2,16,4,2,2017,19,16390,2270,18660
2,16,4,2,2017,20,16825,2443,19268
2,16,4,2,2017,21,16503,2504,19007
2,16,4,2,2017,22,16345,2556,18901
2,16,4,2,2017,23,16622,2634,19256
2,16,4,2,2017,24,17346,2716,20062
1,17,4,2,2017,1,17789,2588,20377
1,17,4,2,2017,2,17204,2418,19622
1,17,4,2,2017,3,17057,2252,19309
1,17,4,2,2017,4,16667,2142,18809
1,17,4,2,2017,5,17146,2091,19237
1,17,4,2,2017,6,17474,2124,19598
1,17,4,2,2017,7,18036,2172,20208
1,17,4,2,2017,8,17950,2280,20230
1,17,4,2,2017,9,17777,2563,20340
1,17,4,2,2017,10,17692,2986,20678
1,17,4,2,2017,11,18209,3200,21409
1,17,4,2,2017,12,18869,3376,22245
1,17,4,2,2017,13,18675,3369,22044
1,17,4,2,2017,14,18431,3278,21709
1,17,4,2,2017,15,18613,3397,22010
1,17,4,2,2017,16,18870,3426,22296
1,17,4,2,2017,17,18596,3377,21973
1,17,4,2,2017,18,17754,3226,20980
1,17,4,2,2017,19,16677,3062,19739
1,17,4,2,2017,20,17420,3050,20470
1,17,4,2,2017,21,17043,2922,19965
1,17,4,2,2017,22,17131,2827,19958
1,17,4,2,2017,23,17520,2853,20373
1,17,4,2,2017,24,18156,2847,21003
1,18,4,2,2017,1,18052,2659,20711
1,18,4,2,2017,2,17801,2458,20259
1,18,4,2,2017,3,17495,2293,19788
1,18,4,2,2017,4,17444,2179,19623
1,18,4,2,2017,5,17333,2135,19468
1,18,4,2,2017,6,17991,2163,20154
1,18,4,2,2017,7,18055,2180,20235
1,18,4,2,2017,8,18176,2340,20516
1,18,4,2,2017,9,18209,2513,20722
1,18,4,2,2017,10,17635,2994,20629
1,18,4,2,2017,11,18319,3288,21607
1,18,4,2,2017,12,18907,3347,22254
1,18,4,2,2017,13,18883,3378,22261
1,18,4,2,2017,14,18574,3313,21887
1,18,4,2,2017,15,19079,3364,22443
1,18,4,2,2017,16,19459,3398,22857
1,18,4,2,2017,17,19167,3326,22493
1,18,4,2,2017,18,17894,3214,21108
1,18,4,2,2017,19,16769,3005,19774
1,18,4,2,2017,20,18106,3034,21140
1,18,4,2,2017,21,17207,2955,20162
1,18,4,2,2017,22,17258,2827,20085
1,18,4,2,2017,23,17358,2831,20189
1,18,4,2,2017,24,17925,2871,20796
1,19,4,2,2017,1,17939,2761,20700
1,19,4,2,2017,2,17577,2468,20045
1,19,4,2,2017,3,17922,2300,20222
1,19,4,2,2017,4,17050,2176,19226
1,19,4,2,2017,5,17035,2126,19161
1,19,4,2,2017,6,18224,2163,20387
1,19,4,2,2017,7,18324,2179,20503
1,19,4,2,2017,8,18133,2337,20470
1,19,4,2,2017,9,18461,2516,20977
1,19,4,2,2017,10,18218,3004,21222
1,19,4,2,2017,11,18652,3292,21944
1,19,4,2,2017,12,19080,3392,22472
1,19,4,2,2017,13,18617,3402,22019
1,19,4,2,2017,14,18782,3273,22055
1,19,4,2,2017,15,18868,3386,22254
1,19,4,2,2017,16,18795,3414,22209
1,19,4,2,2017,17,18646,3365,22011
1,19,4,2,2017,18,17562,3176,20738
1,19,4,2,2017,19,16711,3061,19772
1,19,4,2,2017,20,17661,3072,20733
1,19,4,2,2017,21,16916,2989,19905
1,19,4,2,2017,22,16731,2843,19574
1,19,4,2,2017,23,17549,2835,20384
1,19,4,2,2017,24,17855,2856,20711
1,20,4,2,2017,1,17826,2731,20557
1,20,4,2,2017,2,17699,2434,20133
1,20,4,2,2017,3,17030,2284,19314
1,20,4,2,2017,4,16996,2168,19164
1,20,4,2,2017,5,17144,2114,19258
1,20,4,2,2017,6,17565,2156,19721
1,20,4,2,2017,7,17929,2162,20091
1,20,4,2,2017,8,17446,2334,19780
1,20,4,2,2017,9,17258,2527,19785
1,20,4,2,2017,10,17355,3020,20375
1,20,4,2,2017,11,18100,3221,21321
1,20,4,2,2017,12,18885,3327,22212
1,20,4,2,2017,13,18114,3310,21424
1,20,4,2,2017,14,17952,3236,21188
1,20,4,2,2017,15,17938,3310,21248
1,20,4,2,2017,16,18373,3351,21724
1,20,4,2,2017,17,17967,3315,21282
1,20,4,2,2017,18,17014,3179,20193
1,20,4,2,2017,19,16087,3039,19126
1,20,4,2,2017,20,17229,3026,20255
1,20,4,2,2017,21,17098,2928,20026
1,20,4,2,2017,22,16906,2855,19761
1,20,4,2,2017,23,17265,2814,20079
1,20,4,2,2017,24,17596,2822,20418
1,21,4,2,2017,1,17939,2656,20595
1,21,4,2,2017,2,17646,2425,20071
1,21,4,2,2017,3,17467,2263,19730
1,21,4,2,2017,4,17074,2187,19261
1,21,4,2,2017,5,17262,2098,19360
1,21,4,2,2017,6,17731,2136,19867
1,21,4,2,2017,7,17996,2175,20171
1,21,4,2,2017,8,17780,2296,20076
1,21,4,2,2017,9,17653,2535,20188
1,21,4,2,2017,10,17500,2938,20438
1,21,4,2,2017,11,17538,3251,20789
1,21,4,2,2017,12,18095,3320,21415
1,21,4,2,2017,13,18258,3315,21573
1,21,4,2,2017,14,17796,3197,20993
1,21,4,2,2017,15,17763,3261,21024
1,21,4,2,2017,16,17966,3330,21296
1,21,4,2,2017,17,17867,3271,21138
1,21,4,2,2017,18,16614,3163,19777
1,21,4,2,2017,19,15915,2986,18901
1,21,4,2,2017,20,16555,3001,19556
1,21,4,2,2017,21,16775,2908,19683
1,21,4,2,2017,22,16815,2768,19583
1,21,4,2,2017,23,17000,2757,19757
1,21,4,2,2017,24,17652,2756,20408
2,22,4,2,2017,1,17525,2648,20173
2,22,4,2,2017,2,17549,2471,20020
2,22,4,2,2017,3,17125,2265,19390
2,22,4,2,2017,4,17242,2153,19395
2,22,4,2,2017,5,17292,2098,19390
2,22,4,2,2017,6,17511,2121,19632
2,22,4,2,2017,7,18197,2098,20295
2,22,4,2,2017,8,18165,2148,20313
2,22,4,2,2017,9,17826,2383,20209
2,22,4,2,2017,10,17966,2569,20535
2,22,4,2,2017,11,18145,2892,21037
2,22,4,2,2017,12,18783,3016,21799
2,22,4,2,2017,13,18680,3045,21725
2,22,4,2,2017,14,18616,2827,21443
2,22,4,2,2017,15,18333,2924,21257
2,22,4,2,2017,16,18500,3004,21504
2,22,4,2,2017,17,18037,2944,20981
2,22,4,2,2017,18,16941,2861,19802
2,22,4,2,2017,19,16231,2750,18981
2,22,4,2,2017,20,16947,2833,19780
2,22,4,2,2017,21,16872,2694,19566
2,22,4,2,2017,22,16874,2639,19513
2,22,4,2,2017,23,17062,2625,19687
2,22,4,2,2017,24,17795,2580,20375
2,23,4,2,2017,1,18158,2581,20739
2,23,4,2,2017,2,17772,2373,20145
2,23,4,2,2017,3,17460,2245,19705
2,23,4,2,2017,4,17070,2136,19206
2,23,4,2,2017,5,17250,2081,19331
2,23,4,2,2017,6,17542,2096,19638
2,23,4,2,2017,7,18303,2036,20339
2,23,4,2,2017,8,17620,2017,19637
2,23,4,2,2017,9,17876,2072,19948
2,23,4,2,2017,10,17528,2146,19674
2,23,4,2,2017,11,17643,2297,19940
2,23,4,2,2017,12,18255,2355,20610
2,23,4,2,2017,13,18296,2382,20678
2,23,4,2,2017,14,17960,2345,20305
2,23,4,2,2017,15,17708,2383,20091
2,23,4,2,2017,16,18032,2375,20407
2,23,4,2,2017,17,17378,2349,19727
2,23,4,2,2017,18,16517,2310,18827
2,23,4,2,2017,19,15785,2266,18051
2,23,4,2,2017,20,16446,2401,18847
2,23,4,2,2017,21,16478,2469,18947
2,23,4,2,2017,22,16386,2489,18875
2,23,4,2,2017,23,16594,2540,19134
2,23,4,2,2017,24,17219,2580,19799
1,24,4,2,2017,1,17748,2500,20248
1,24,4,2,2017,2,17231,2334,19565
1,24,4,2,2017,3,16890,2178,19068
1,24,4,2,2017,4,16692,2068,18760
1,24,4,2,2017,5,16698,2021,18719
1,24,4,2,2017,6,17322,2044,19366
1,24,4,2,2017,7,18146,2088,20234
1,24,4,2,2017,8,17726,2171,19897
1,24,4,2,2017,9,17695,2525,20220
1,24,4,2,2017,10,17621,2849,20470
1,24,4,2,2017,11,18052,3149,21201
1,24,4,2,2017,12,18956,3236,22192
1,24,4,2,2017,13,18685,3224,21909
1,24,4,2,2017,14,18613,3139,21752
1,24,4,2,2017,15,18762,3211,21973
1,24,4,2,2017,16,18817,3225,22042
1,24,4,2,2017,17,18362,3189,21551
1,24,4,2,2017,18,17426,3047,20473
1,24,4,2,2017,19,16568,2926,19494
1,24,4,2,2017,20,17226,2914,20140
1,24,4,2,2017,21,17383,2808,20191
1,24,4,2,2017,22,17292,2783,20075
1,24,4,2,2017,23,17524,2693,20217
1,24,4,2,2017,24,18267,2685,20952
1,25,4,2,2017,1,18163,2575,20738
1,25,4,2,2017,2,17621,2355,19976
1,25,4,2,2017,3,17215,2204,19419
1,25,4,2,2017,4,16905,2084,18989
1,25,4,2,2017,5,17108,2049,19157
1,25,4,2,2017,6,17549,2087,19636
1,25,4,2,2017,7,18237,2124,20361
1,25,4,2,2017,8,18053,2247,20300
1,25,4,2,2017,9,18155,2570,20725
1,25,4,2,2017,10,17885,2840,20725
1,25,4,2,2017,11,18392,3162,21554
1,25,4,2,2017,12,19017,3232,22249
1,25,4,2,2017,13,18518,3219,21737
1,25,4,2,2017,14,18343,3110,21453
1,25,4,2,2017,15,18592,3159,21751
1,25,4,2,2017,16,18941,3173,22114
1,25,4,2,2017,17,18503,3143,21646
1,25,4,2,2017,18,17390,3015,20405
1,25,4,2,2017,19,16665,2882,19547
1,25,4,2,2017,20,17423,2897,20320
1,25,4,2,2017,21,17109,2821,19930
1,25,4,2,2017,22,16661,2688,19349
1,25,4,2,2017,23,16706,2649,19355
1,25,4,2,2017,24,17435,2649,20084
1,26,4,2,2017,1,17663,2546,20209
1,26,4,2,2017,2,17391,2284,19675
1,26,4,2,2017,3,17338,2145,19483
1,26,4,2,2017,4,16827,2043,18870
1,26,4,2,2017,5,17311,1998,19309
1,26,4,2,2017,6,17601,2031,19632
1,26,4,2,2017,7,18139,2054,20193
1,26,4,2,2017,8,17802,2220,20022
1,26,4,2,2017,9,17851,2424,20275
1,26,4,2,2017,10,17518,2861,20379
1,26,4,2,2017,11,16417,3125,19542
1,26,4,2,2017,12,18333,3193,21526
1,26,4,2,2017,13,18863,3205,22068
1,26,4,2,2017,14,18505,3111,21616
1,26,4,2,2017,15,18579,3191,21770
1,26,4,2,2017,16,18855,3231,22086
1,26,4,2,2017,17,18999,3205,22204
1,26,4,2,2017,18,18056,3064,21120
1,26,4,2,2017,19,16446,2936,19382
1,26,4,2,2017,20,17298,2934,20232
1,26,4,2,2017,21,17390,2871,20261
1,26,4,2,2017,22,17163,2744,19907
1,26,4,2,2017,23,16904,2724,19628
1,26,4,2,2017,24,16557,2692,19249
1,27,4,2,2017,1,16518,2480,18998
1,27,4,2,2017,2,16641,2325,18966
1,27,4,2,2017,3,16816,2172,18988
1,27,4,2,2017,4,16684,2072,18756
1,27,4,2,2017,5,16391,2022,18413
1,27,4,2,2017,6,17380,2058,19438
1,27,4,2,2017,7,17895,2068,19963
1,27,4,2,2017,8,17618,2234,19852
1,27,4,2,2017,9,17683,2431,20114
1,27,4,2,2017,10,17761,2889,20650
1,27,4,2,2017,11,17396,3173,20569
1,27,4,2,2017,12,16918,3235,20153
1,27,4,2,2017,13,17681,3220,20901
1,27,4,2,2017,14,17514,3141,20655
1,27,4,2,2017,15,17668,3184,20852
1,27,4,2,2017,16,18229,3201,21430
1,27,4,2,2017,17,18163,3196,21359
1,27,4,2,2017,18,17622,3099,20721
1,27,4,2,2017,19,16651,2925,19576
1,27,4,2,2017,20,17033,2947,19980
1,27,4,2,2017,21,17081,2866,19947
1,27,4,2,2017,22,16682,2704,19386
1,27,4,2,2017,23,16431,2698,19129
1,27,4,2,2017,24,16268,2705,18973
1,28,4,2,2017,1,16306,2579,18885
1,28,4,2,2017,2,16724,2318,19042
1,28,4,2,2017,3,16545,2174,18719
1,28,4,2,2017,4,16938,2069,19007
1,28,4,2,2017,5,17079,2023,19102
1,28,4,2,2017,6,17044,2054,19098
1,28,4,2,2017,7,18529,2090,20619
1,28,4,2,2017,8,17426,2209,19635
1,28,4,2,2017,9,17781,2583,20364
1,28,4,2,2017,10,17377,2781,20158
1,28,4,2,2017,11,17718,3116,20834
1,28,4,2,2017,12,18356,3259,21615
1,28,4,2,2017,13,18003,3248,21251
1,28,4,2,2017,14,17839,3130,20969
1,28,4,2,2017,15,18009,3215,21224
1,28,4,2,2017,16,17966,3269,21235
1,28,4,2,2017,17,17932,3210,21142
1,28,4,2,2017,18,16461,3158,19619
1,28,4,2,2017,19,15485,2926,18411
1,28,4,2,2017,20,16385,2915,19300
1,28,4,2,2017,21,15944,2831,18775
1,28,4,2,2017,22,15665,2670,18335
1,28,4,2,2017,23,15815,2645,18460
1,28,4,2,2017,24,15692,2648,18340
2,29,4,2,2017,1,16211,2534,18745
2,29,4,2,2017,2,16544,2338,18882
2,29,4,2,2017,3,16555,2189,18744
2,29,4,2,2017,4,16637,2080,18717
2,29,4,2,2017,5,16670,2039,18709
2,29,4,2,2017,6,17162,2061,19223
2,29,4,2,2017,7,16453,2059,18512
2,29,4,2,2017,8,16511,2146,18657
2,29,4,2,2017,9,17461,2328,19789
2,29,4,2,2017,10,17136,2709,19845
2,29,4,2,2017,11,17448,2909,20357
2,29,4,2,2017,12,17887,3002,20889
2,29,4,2,2017,13,17740,3026,20766
2,29,4,2,2017,14,17439,2904,20343
2,29,4,2,2017,15,17763,2935,20698
2,29,4,2,2017,16,17738,2954,20692
2,29,4,2,2017,17,16919,2897,19816
2,29,4,2,2017,18,16327,2789,19116
2,29,4,2,2017,19,15957,2660,18617
2,29,4,2,2017,20,16231,2731,18962
2,29,4,2,2017,21,15993,2716,18709
2,29,4,2,2017,22,16180,2628,18808
2,29,4,2,2017,23,15650,2561,18211
2,29,4,2,2017,24,15749,2547,18296
2,30,4,2,2017,1,15517,2474,17991
2,30,4,2,2017,2,15367,2333,17700
2,30,4,2,2017,3,15934,2142,18076
2,30,4,2,2017,4,16176,2037,18213
2,30,4,2,2017,5,16137,1995,18132
2,30,4,2,2017,6,15833,2009,17842
2,30,4,2,2017,7,15891,1961,17852
2,30,4,2,2017,8,16744,1944,18688
2,30,4,2,2017,9,16777,2036,18813
2,30,4,2,2017,10,16419,2106,18525
2,30,4,2,2017,11,16890,2232,19122
2,30,4,2,2017,12,17678,2308,19986
2,30,4,2,2017,13,17995,2336,20331
2,30,4,2,2017,14,17226,2291,19517
2,30,4,2,2017,15,17589,2292,19881
2,30,4,2,2017,16,17792,2326,20118
2,30,4,2,2017,17,16650,2309,18959
2,30,4,2,2017,18,15193,2215,17408
2,30,4,2,2017,19,14838,2186,17024
2,30,4,2,2017,20,15219,2380,17599
2,30,4,2,2017,21,14821,2404,17225
2,30,4,2,2017,22,14959,2381,17340
2,30,4,2,2017,23,15472,2392,17864
2,30,4,2,2017,24,16023,2462,18485
3,1,5,2,2017,1,16346,2413,18758
3,1,5,2,2017,2,16310,2215,18525
3,1,5,2,2017,3,15965,2119,18084
3,1,5,2,2017,4,15886,2024,17910
3,1,5,2,2017,5,15950,1955,17905
3,1,5,2,2017,6,16526,1958,18484
3,1,5,2,2017,7,16898,1938,18836
3,1,5,2,2017,8,16075,1939,18014
3,1,5,2,2017,9,15581,2033,17614
3,1,5,2,2017,10,15203,2101,17304
3,1,5,2,2017,11,15606,2290,17896
3,1,5,2,2017,12,16201,2395,18596
3,1,5,2,2017,13,16630,2433,19063
3,1,5,2,2017,14,16362,2417,18779
3,1,5,2,2017,15,16280,2465,18745
3,1,5,2,2017,16,16686,2468,19154
3,1,5,2,2017,17,16011,2428,18439
3,1,5,2,2017,18,15271,2348,17619
3,1,5,2,2017,19,14765,2336,17101
3,1,5,2,2017,20,15187,2456,17643
3,1,5,2,2017,21,15216,2530,17746
3,1,5,2,2017,22,15128,2530,17658
3,1,5,2,2017,23,15445,2590,18035
3,1,5,2,2017,24,15581,2601,18182
1,2,5,2,2017,1,15735,2457,18192
1,2,5,2,2017,2,15461,2276,17737
1,2,5,2,2017,3,15484,2156,17640
1,2,5,2,2017,4,15594,2017,17611
1,2,5,2,2017,5,15731,1968,17699
1,2,5,2,2017,6,16442,2000,18442
1,2,5,2,2017,7,17143,2020,19163
1,2,5,2,2017,8,17237,2170,19407
1,2,5,2,2017,9,17479,2516,19995
1,2,5,2,2017,10,17373,2840,20213
1,2,5,2,2017,11,17626,3194,20820
1,2,5,2,2017,12,18483,3267,21750
1,2,5,2,2017,13,18225,3271,21496
1,2,5,2,2017,14,18265,3148,21413
1,2,5,2,2017,15,18544,3199,21743
1,2,5,2,2017,16,18372,3242,21614
1,2,5,2,2017,17,17658,3203,20861
1,2,5,2,2017,18,17565,3096,20661
1,2,5,2,2017,19,16822,2934,19756
1,2,5,2,2017,20,17093,2934,20027
1,2,5,2,2017,21,17047,2882,19929
1,2,5,2,2017,22,16579,2740,19319
1,2,5,2,2017,23,16850,2705,19555
1,2,5,2,2017,24,16613,2721,19334
1,3,5,2,2017,1,16664,2573,19237
1,3,5,2,2017,2,16676,2324,19000
1,3,5,2,2017,3,16810,2177,18987
1,3,5,2,2017,4,17081,2090,19171
1,3,5,2,2017,5,17151,2017,19168
1,3,5,2,2017,6,16928,2062,18990
1,3,5,2,2017,7,16985,2060,19045
1,3,5,2,2017,8,17411,2251,19662
1,3,5,2,2017,9,18123,2395,20518
1,3,5,2,2017,10,17727,2887,20614
1,3,5,2,2017,11,18202,3203,21405
1,3,5,2,2017,12,17678,3307,20985
1,3,5,2,2017,13,17800,3316,21116
1,3,5,2,2017,14,18077,3239,21316
1,3,5,2,2017,15,18454,3281,21735
1,3,5,2,2017,16,18622,3315,21937
1,3,5,2,2017,17,17634,3282,20916
1,3,5,2,2017,18,16866,3153,20019
1,3,5,2,2017,19,16958,2864,19822
1,3,5,2,2017,20,16784,2888,19672
1,3,5,2,2017,21,16992,2893,19885
1,3,5,2,2017,22,16754,2717,19471
1,3,5,2,2017,23,17094,2717,19811
1,3,5,2,2017,24,16899,2822,19721
1,4,5,2,2017,1,16735,2634,19369
1,4,5,2,2017,2,16387,2345,18732
1,4,5,2,2017,3,15680,2220,17900
1,4,5,2,2017,4,15855,2106,17961
1,4,5,2,2017,5,16313,2055,18368
1,4,5,2,2017,6,16789,2081,18870
1,4,5,2,2017,7,16559,2095,18654
1,4,5,2,2017,8,16637,2189,18826
1,4,5,2,2017,9,16955,2589,19544
1,4,5,2,2017,10,17061,2835,19896
1,4,5,2,2017,11,16881,3207,20088
1,4,5,2,2017,12,17098,3306,20404
1,4,5,2,2017,13,17534,3286,20820
1,4,5,2,2017,14,17529,3175,20704
1,4,5,2,2017,15,18235,3230,21465
1,4,5,2,2017,16,17567,3294,20861
1,4,5,2,2017,17,17035,3250,20285
1,4,5,2,2017,18,16861,3120,19981
1,4,5,2,2017,19,16833,2980,19813
1,4,5,2,2017,20,16978,3002,19980
1,4,5,2,2017,21,17160,2909,20069
1,4,5,2,2017,22,16593,2831,19424
1,4,5,2,2017,23,17065,2805,19870
1,4,5,2,2017,24,16801,2807,19608
1,5,5,2,2017,1,16567,2670,19237
1,5,5,2,2017,2,16687,2441,19128
1,5,5,2,2017,3,17169,2269,19438
1,5,5,2,2017,4,16749,2165,18914
1,5,5,2,2017,5,16967,2096,19063
1,5,5,2,2017,6,17579,2105,19684
1,5,5,2,2017,7,17748,2095,19843
1,5,5,2,2017,8,17824,2262,20086
1,5,5,2,2017,9,17605,2497,20102
1,5,5,2,2017,10,17179,3001,20180
1,5,5,2,2017,11,17474,3258,20732
1,5,5,2,2017,12,18821,3381,22202
1,5,5,2,2017,13,18587,3391,21978
1,5,5,2,2017,14,18603,3290,21893
1,5,5,2,2017,15,18536,3372,21908
1,5,5,2,2017,16,18744,3388,22132
1,5,5,2,2017,17,18471,3362,21833
1,5,5,2,2017,18,16789,3205,19994
1,5,5,2,2017,19,15555,3052,18607
1,5,5,2,2017,20,16938,3011,19949
1,5,5,2,2017,21,16985,2951,19936
1,5,5,2,2017,22,16238,2876,19114
1,5,5,2,2017,23,16351,2866,19217
1,5,5,2,2017,24,16138,2903,19041
2,6,5,2,2017,1,15871,2723,18594
2,6,5,2,2017,2,16249,2524,18773
2,6,5,2,2017,3,16772,2340,19112
2,6,5,2,2017,4,17136,2169,19305
2,6,5,2,2017,5,16838,2143,18981
2,6,5,2,2017,6,17271,2163,19434
2,6,5,2,2017,7,18002,2135,20137
2,6,5,2,2017,8,18129,2180,20309
2,6,5,2,2017,9,17944,2435,20379
2,6,5,2,2017,10,17775,2839,20614
2,6,5,2,2017,11,18055,3028,21083
2,6,5,2,2017,12,19155,3189,22344
2,6,5,2,2017,13,18981,3185,22166
2,6,5,2,2017,14,19005,3119,22124
2,6,5,2,2017,15,19116,3182,22298
2,6,5,2,2017,16,19146,3200,22346
2,6,5,2,2017,17,18673,3093,21766
2,6,5,2,2017,18,17527,2887,20414
2,6,5,2,2017,19,16410,2789,19199
2,6,5,2,2017,20,16826,2837,19663
2,6,5,2,2017,21,16785,2795,19580
2,6,5,2,2017,22,16479,2715,19194
2,6,5,2,2017,23,16164,2707,18871
2,6,5,2,2017,24,15997,2720,18717
2,7,5,2,2017,1,15715,2621,18336
2,7,5,2,2017,2,16181,2459,18640
2,7,5,2,2017,3,16718,2305,19023
2,7,5,2,2017,4,16700,2191,18891
2,7,5,2,2017,5,16635,2134,18769
2,7,5,2,2017,6,17331,2131,19462
2,7,5,2,2017,7,17612,2069,19681
2,7,5,2,2017,8,17323,2014,19337
2,7,5,2,2017,9,17310,2059,19369
2,7,5,2,2017,10,17090,2187,19277
2,7,5,2,2017,11,16897,2267,19164
2,7,5,2,2017,12,17810,2351,20161
2,7,5,2,2017,13,17817,2385,20202
2,7,5,2,2017,14,17704,2379,20083
2,7,5,2,2017,15,17617,2418,20035
2,7,5,2,2017,16,17717,2403,20120
2,7,5,2,2017,17,16733,2358,19091
2,7,5,2,2017,18,15426,2267,17693
2,7,5,2,2017,19,14060,2238,16298
2,7,5,2,2017,20,14648,2414,17062
2,7,5,2,2017,21,14795,2452,17247
2,7,5,2,2017,22,14959,2468,17427
2,7,5,2,2017,23,15055,2526,17581
2,7,5,2,2017,24,14748,2621,17369
1,8,5,2,2017,1,14603,2605,17208
1,8,5,2,2017,2,14873,2391,17264
1,8,5,2,2017,3,15216,2248,17464
1,8,5,2,2017,4,15577,2139,17716
1,8,5,2,2017,5,15530,2069,17599
1,8,5,2,2017,6,15959,2082,18041
1,8,5,2,2017,7,16647,2083,18730
1,8,5,2,2017,8,16769,2199,18968
1,8,5,2,2017,9,16846,2602,19448
1,8,5,2,2017,10,16976,2829,19805
1,8,5,2,2017,11,17177,3203,20380
1,8,5,2,2017,12,18087,3309,21396
1,8,5,2,2017,13,18183,3321,21504
1,8,5,2,2017,14,17995,3212,21207
1,8,5,2,2017,15,18343,3263,21606
1,8,5,2,2017,16,18666,3305,21971
1,8,5,2,2017,17,18154,3240,21394
1,8,5,2,2017,18,16694,3149,19843
1,8,5,2,2017,19,15260,2925,18185
1,8,5,2,2017,20,16372,2908,19280
1,8,5,2,2017,21,16069,2855,18924
1,8,5,2,2017,22,16098,2756,18854
1,8,5,2,2017,23,15951,2754,18705
1,8,5,2,2017,24,15831,2793,18624
1,9,5,2,2017,1,15502,2690,18192
1,9,5,2,2017,2,15778,2424,18202
1,9,5,2,2017,3,16551,2294,18845
1,9,5,2,2017,4,16676,2183,18859
1,9,5,2,2017,5,16806,2111,18917
1,9,5,2,2017,6,17536,2111,19647
1,9,5,2,2017,7,17815,2090,19905
1,9,5,2,2017,8,17554,2249,19803
1,9,5,2,2017,9,17338,2524,19862
1,9,5,2,2017,10,17454,2995,20449
1,9,5,2,2017,11,17720,3137,20857
1,9,5,2,2017,12,18468,3257,21725
1,9,5,2,2017,13,18547,3291,21838
1,9,5,2,2017,14,18413,3230,21643
1,9,5,2,2017,15,18762,3280,22042
1,9,5,2,2017,16,18635,3299,21934
1,9,5,2,2017,17,18625,3170,21795
1,9,5,2,2017,18,16965,3157,20122
1,9,5,2,2017,19,16004,2972,18976
1,9,5,2,2017,20,16697,2986,19683
1,9,5,2,2017,21,16556,2889,19445
1,9,5,2,2017,22,16399,2734,19133
1,9,5,2,2017,23,16381,2818,19199
1,9,5,2,2017,24,15936,2805,18741
3,10,5,2,2017,1,15338,2678,18016
3,10,5,2,2017,2,15722,2456,18178
3,10,5,2,2017,3,16379,2298,18677
3,10,5,2,2017,4,16717,2146,18863
3,10,5,2,2017,5,17139,2110,19249
3,10,5,2,2017,6,17314,2121,19435
3,10,5,2,2017,7,17756,2094,19850
3,10,5,2,2017,8,17969,2168,20137
3,10,5,2,2017,9,17842,2449,20291
3,10,5,2,2017,10,17659,2763,20422
3,10,5,2,2017,11,17771,3081,20852
3,10,5,2,2017,12,18381,3121,21502
3,10,5,2,2017,13,18238,3143,21381
3,10,5,2,2017,14,18585,3090,21675
3,10,5,2,2017,15,18776,3151,21927
3,10,5,2,2017,16,18741,3191,21932
3,10,5,2,2017,17,18748,3151,21899
3,10,5,2,2017,18,17485,3044,20529
3,10,5,2,2017,19,16303,2871,19174
3,10,5,2,2017,20,17120,2907,20027
3,10,5,2,2017,21,17226,2840,20066
3,10,5,2,2017,22,16513,2779,19292
3,10,5,2,2017,23,16344,2790,19134
3,10,5,2,2017,24,15907,2821,18728
1,12,5,2,2017,1,15331,2707,18038
1,12,5,2,2017,2,15941,2502,18443
1,12,5,2,2017,3,16768,2341,19109
1,12,5,2,2017,4,16914,2238,19152
1,12,5,2,2017,5,16740,2173,18913
1,12,5,2,2017,6,17241,2177,19418
1,12,5,2,2017,7,17461,2156,19617
1,12,5,2,2017,8,17446,2271,19717
1,12,5,2,2017,9,17487,2689,20176
1,12,5,2,2017,10,17421,2898,20319
1,12,5,2,2017,11,17033,3231,20264
1,12,5,2,2017,12,18129,3332,21461
1,12,5,2,2017,13,17508,3361,20869
1,12,5,2,2017,14,17857,3288,21145
1,12,5,2,2017,15,17985,3401,21386
1,12,5,2,2017,16,17794,3428,21222
1,12,5,2,2017,17,17425,3372,20797
1,12,5,2,2017,18,15992,3196,19188
1,12,5,2,2017,19,14998,3010,18008
1,12,5,2,2017,20,15734,2979,18713
1,12,5,2,2017,21,15592,2835,18427
1,12,5,2,2017,22,15334,2795,18129
1,12,5,2,2017,23,15134,2811,17945
1,12,5,2,2017,24,14441,2818,17259
2,13,5,2,2017,1,14811,2677,17488
2,13,5,2,2017,2,15333,2505,17838
2,13,5,2,2017,3,16298,2347,18645
2,13,5,2,2017,4,16227,2231,18458
2,13,5,2,2017,5,16526,2163,18689
2,13,5,2,2017,6,16842,2167,19009
2,13,5,2,2017,7,16956,2113,19069
2,13,5,2,2017,8,16840,2167,19007
2,13,5,2,2017,9,16877,2294,19171
2,13,5,2,2017,10,16617,2616,19233
2,13,5,2,2017,11,16590,2770,19360
2,13,5,2,2017,12,17276,2861,20137
2,13,5,2,2017,13,17407,2900,20307
2,13,5,2,2017,14,17613,2831,20444
2,13,5,2,2017,15,17661,2896,20557
2,13,5,2,2017,16,17607,3013,20620
2,13,5,2,2017,17,17153,2968,20121
2,13,5,2,2017,18,16152,2854,19006
2,13,5,2,2017,19,14881,2718,17599
2,13,5,2,2017,20,16012,2763,18775
2,13,5,2,2017,21,15271,2746,18017
2,13,5,2,2017,22,15176,2681,17857
2,13,5,2,2017,23,15221,2676,17897
2,13,5,2,2017,24,15086,2746,17832
2,14,5,2,2017,1,15206,2696,17902
2,14,5,2,2017,2,15427,2555,17982
2,14,5,2,2017,3,16230,2383,18613
2,14,5,2,2017,4,15856,2286,18142
2,14,5,2,2017,5,16048,2207,18255
2,14,5,2,2017,6,16579,2207,18786
2,14,5,2,2017,7,16177,2131,18308
2,14,5,2,2017,8,16321,2122,18443
2,14,5,2,2017,9,16661,2166,18827
2,14,5,2,2017,10,16342,2259,18601
2,14,5,2,2017,11,16344,2379,18723
2,14,5,2,2017,12,16985,2438,19423
2,14,5,2,2017,13,17248,2469,19717
2,14,5,2,2017,14,17071,2466,19537
2,14,5,2,2017,15,17359,2511,19870
2,14,5,2,2017,16,17581,2538,20119
2,14,5,2,2017,17,17756,2457,20213
2,14,5,2,2017,18,16553,2369,18922
2,14,5,2,2017,19,15526,2356,17882
2,14,5,2,2017,20,16192,2454,18646
2,14,5,2,2017,21,16123,2536,18659
2,14,5,2,2017,22,15576,2550,18126
2,14,5,2,2017,23,15606,2668,18274
2,14,5,2,2017,24,15272,2743,18015
1,15,5,2,2017,1,15115,2681,17796
1,15,5,2,2017,2,15595,2485,18080
1,15,5,2,2017,3,16383,2320,18703
1,15,5,2,2017,4,16099,2210,18309
1,15,5,2,2017,5,16027,2161,18188
1,15,5,2,2017,6,16649,2167,18816
1,15,5,2,2017,7,16910,2151,19061
1,15,5,2,2017,8,17294,2254,19548
1,15,5,2,2017,9,17273,2507,19780
1,15,5,2,2017,10,17399,2929,20328
1,15,5,2,2017,11,17451,3251,20702
1,15,5,2,2017,12,17949,3337,21286
1,15,5,2,2017,13,17935,3333,21268
1,15,5,2,2017,14,17609,3267,20876
1,15,5,2,2017,15,18079,3329,21408
1,15,5,2,2017,16,17703,3344,21047
1,15,5,2,2017,17,17851,3296,21147
1,15,5,2,2017,18,16979,3160,20139
1,15,5,2,2017,19,15689,2950,18639
1,15,5,2,2017,20,16417,2943,19360
1,15,5,2,2017,21,16356,2879,19235
1,15,5,2,2017,22,16065,2801,18866
1,15,5,2,2017,23,15899,2827,18726
1,15,5,2,2017,24,15808,2862,18670
1,16,5,2,2017,1,15507,2723,18230
1,16,5,2,2017,2,15649,2523,18172
1,16,5,2,2017,3,16460,2358,18818
1,16,5,2,2017,4,16453,2251,18704
1,16,5,2,2017,5,16622,2202,18824
1,16,5,2,2017,6,17181,2222,19403
1,16,5,2,2017,7,17269,2194,19463
1,16,5,2,2017,8,17817,2252,20069
1,16,5,2,2017,9,17783,2508,20291
1,16,5,2,2017,10,17916,2751,20667
1,16,5,2,2017,11,17413,3237,20650
1,16,5,2,2017,12,18054,3328,21382
1,16,5,2,2017,13,17993,3327,21320
1,16,5,2,2017,14,17751,3248,20999
1,16,5,2,2017,15,18245,3312,21557
1,16,5,2,2017,16,18278,3393,21671
1,16,5,2,2017,17,18193,3322,21515
1,16,5,2,2017,18,17332,3241,20573
1,16,5,2,2017,19,15530,3007,18537
1,16,5,2,2017,20,16686,2984,19670
1,16,5,2,2017,21,16537,2965,19502
1,16,5,2,2017,22,16151,2858,19009
1,16,5,2,2017,23,16160,2880,19040
1,16,5,2,2017,24,15864,2898,18762
1,17,5,2,2017,1,15280,2722,18002
1,17,5,2,2017,2,15808,2539,18347
1,17,5,2,2017,3,16462,2383,18845
1,17,5,2,2017,4,16808,2258,19066
1,17,5,2,2017,5,16946,2219,19165
1,17,5,2,2017,6,17218,2228,19446
1,17,5,2,2017,7,17502,2191,19693
1,17,5,2,2017,8,17449,2254,19703
1,17,5,2,2017,9,17741,2604,20345
1,17,5,2,2017,10,17406,3036,20442
1,17,5,2,2017,11,17631,3185,20816
1,17,5,2,2017,12,18442,3332,21774
1,17,5,2,2017,13,18252,3343,21595
1,17,5,2,2017,14,18367,3272,21639
1,17,5,2,2017,15,18372,3354,21726
1,17,5,2,2017,16,18759,3392,22151
1,17,5,2,2017,17,18578,3330,21908
1,17,5,2,2017,18,17400,3197,20597
1,17,5,2,2017,19,15880,2978,18858
1,17,5,2,2017,20,16626,2973,19599
1,17,5,2,2017,21,16916,2942,19858
1,17,5,2,2017,22,16687,2832,19519
1,17,5,2,2017,23,16407,2844,19251
1,17,5,2,2017,24,15887,2876,18763
1,18,5,2,2017,1,15566,2743,18309
1,18,5,2,2017,2,15957,2557,18514
1,18,5,2,2017,3,16595,2382,18977
1,18,5,2,2017,4,16686,2248,18934
1,18,5,2,2017,5,16935,2207,19142
1,18,5,2,2017,6,17177,2222,19399
1,18,5,2,2017,7,17559,2182,19741
1,18,5,2,2017,8,17918,2241,20159
1,18,5,2,2017,9,18037,2600,20637
1,18,5,2,2017,10,17844,3035,20879
1,18,5,2,2017,11,17492,3178,20670
1,18,5,2,2017,12,18231,3326,21557
1,18,5,2,2017,13,18024,3350,21374
1,18,5,2,2017,14,18027,3296,21323
1,18,5,2,2017,15,18091,3369,21460
1,18,5,2,2017,16,18116,3371,21487
1,18,5,2,2017,17,18293,3351,21644
1,18,5,2,2017,18,17521,3201,20722
1,18,5,2,2017,19,15932,3064,18996
1,18,5,2,2017,20,16562,3016,19578
1,18,5,2,2017,21,16467,2929,19396
1,18,5,2,2017,22,16234,2810,19044
1,18,5,2,2017,23,16384,2810,19194
1,18,5,2,2017,24,16113,2811,18924
1,19,5,2,2017,1,15613,2733,18346
1,19,5,2,2017,2,15936,2546,18482
1,19,5,2,2017,3,16958,2372,19330
1,19,5,2,2017,4,16987,2238,19225
1,19,5,2,2017,5,16954,2196,19150
1,19,5,2,2017,6,17208,2211,19419
1,19,5,2,2017,7,17505,2171,19676
1,19,5,2,2017,8,17428,2230,19658
1,19,5,2,2017,9,17446,2591,20037
1,19,5,2,2017,10,17308,3024,20332
1,19,5,2,2017,11,17099,3168,20267
1,19,5,2,2017,12,17296,3308,20604
1,19,5,2,2017,13,17276,3319,20595
1,19,5,2,2017,14,17216,3234,20450
1,19,5,2,2017,15,17515,3282,20797
1,19,5,2,2017,16,17777,3323,21100
1,19,5,2,2017,17,17466,3281,20747
1,19,5,2,2017,18,16085,3191,19276
1,19,5,2,2017,19,14986,3078,18064
1,19,5,2,2017,20,15954,3015,18969
1,19,5,2,2017,21,15960,2883,18843
1,19,5,2,2017,22,15876,2796,18672
1,19,5,2,2017,23,16077,2789,18866
1,19,5,2,2017,24,15749,2779,18528
2,20,5,2,2017,1,16020,2749,18769
2,20,5,2,2017,2,16531,2579,19110
2,20,5,2,2017,3,16434,2419,18853
2,20,5,2,2017,4,16351,2305,18656
2,20,5,2,2017,5,16493,2237,18730
2,20,5,2,2017,6,16873,2230,19103
2,20,5,2,2017,7,17366,2186,19552
2,20,5,2,2017,8,17081,2240,19321
2,20,5,2,2017,9,17174,2373,19547
2,20,5,2,2017,10,17107,2690,19797
2,20,5,2,2017,11,17679,2843,20522
2,20,5,2,2017,12,18140,2950,21090
2,20,5,2,2017,13,18292,2999,21291
2,20,5,2,2017,14,18216,2926,21142
2,20,5,2,2017,15,18337,2994,21331
2,20,5,2,2017,16,18444,3102,21546
2,20,5,2,2017,17,18096,3068,21164
2,20,5,2,2017,18,16789,2951,19740
2,20,5,2,2017,19,16226,2816,19042
2,20,5,2,2017,20,16750,2862,19612
2,20,5,2,2017,21,16602,2807,19409
2,20,5,2,2017,22,16503,2688,19191
2,20,5,2,2017,23,16840,2684,19524
2,20,5,2,2017,24,16891,2752,19643
2,21,5,2,2017,1,17327,2648,19975
2,21,5,2,2017,2,17222,2489,19711
2,21,5,2,2017,3,17077,2318,19395
2,21,5,2,2017,4,17130,2220,19350
2,21,5,2,2017,5,16864,2141,19005
2,21,5,2,2017,6,17691,2141,19832
2,21,5,2,2017,7,17557,2064,19621
2,21,5,2,2017,8,16981,2056,19037
2,21,5,2,2017,9,17005,2100,19105
2,21,5,2,2017,10,16328,2192,18520
2,21,5,2,2017,11,17228,2313,19541
2,21,5,2,2017,12,17653,2371,20024
2,21,5,2,2017,13,17703,2407,20110
2,21,5,2,2017,14,17692,2332,20024
2,21,5,2,2017,15,17766,2360,20126
2,21,5,2,2017,16,17851,2396,20247
2,21,5,2,2017,17,17201,2375,19576
2,21,5,2,2017,18,16106,2290,18396
2,21,5,2,2017,19,15308,2251,17559
2,21,5,2,2017,20,15878,2403,18281
2,21,5,2,2017,21,16234,2489,18723
2,21,5,2,2017,22,16037,2488,18525
2,21,5,2,2017,23,16715,2544,19259
2,21,5,2,2017,24,17062,2651,19713
1,22,5,2,2017,1,17294,2646,19940
1,22,5,2,2017,2,16956,2443,19399
1,22,5,2,2017,3,16699,2325,19024
1,22,5,2,2017,4,16460,2206,18666
1,22,5,2,2017,5,16568,2142,18710
1,22,5,2,2017,6,16887,2154,19041
1,22,5,2,2017,7,17424,2126,19550
1,22,5,2,2017,8,17016,2239,19255
1,22,5,2,2017,9,16858,2553,19411
1,22,5,2,2017,10,16730,2896,19626
1,22,5,2,2017,11,17825,3246,21071
1,22,5,2,2017,12,18210,3301,21511
1,22,5,2,2017,13,18607,3339,21946
1,22,5,2,2017,14,18469,3269,21738
1,22,5,2,2017,15,18886,3330,22216
1,22,5,2,2017,16,18775,3376,22151
1,22,5,2,2017,17,18393,3331,21724
1,22,5,2,2017,18,17080,3199,20279
1,22,5,2,2017,19,16255,2949,19204
1,22,5,2,2017,20,16678,2948,19626
1,22,5,2,2017,21,16606,2860,19466
1,22,5,2,2017,22,16572,2771,19343
1,22,5,2,2017,23,17163,2794,19957
1,22,5,2,2017,24,17377,2867,20244
1,23,5,2,2017,1,17856,2754,20610
1,23,5,2,2017,2,17510,2527,20037
1,23,5,2,2017,3,16977,2376,19353
1,23,5,2,2017,4,16667,2260,18927
1,23,5,2,2017,5,16859,2200,19059
1,23,5,2,2017,6,17188,2204,19392
1,23,5,2,2017,7,17650,2172,19822
1,23,5,2,2017,8,17099,2268,19367
1,23,5,2,2017,9,17185,2589,19774
1,23,5,2,2017,10,16931,3092,20023
1,23,5,2,2017,11,17248,3241,20489
1,23,5,2,2017,12,18041,3433,21474
1,23,5,2,2017,13,18212,3441,21653
1,23,5,2,2017,14,18299,3386,21685
1,23,5,2,2017,15,18415,3481,21896
1,23,5,2,2017,16,18287,3503,21790
1,23,5,2,2017,17,17794,3403,21197
1,23,5,2,2017,18,16620,3304,19924
1,23,5,2,2017,19,16360,3033,19393
1,23,5,2,2017,20,16365,3025,19390
1,23,5,2,2017,21,16774,2960,19734
1,23,5,2,2017,22,16673,2891,19564
1,23,5,2,2017,23,17263,2912,20175
1,23,5,2,2017,24,17504,2972,20476
1,24,5,2,2017,1,18457,2830,21287
1,24,5,2,2017,2,17530,2598,20128
1,24,5,2,2017,3,17101,2440,19541
1,24,5,2,2017,4,17000,2324,19324
1,24,5,2,2017,5,16898,2256,19154
1,24,5,2,2017,6,17489,2261,19750
1,24,5,2,2017,7,17563,2223,19786
1,24,5,2,2017,8,17248,2287,19535
1,24,5,2,2017,9,17192,2654,19846
1,24,5,2,2017,10,16767,3078,19845
1,24,5,2,2017,11,17446,3295,20741
1,24,5,2,2017,12,18182,3442,21624
1,24,5,2,2017,13,18547,3465,22012
1,24,5,2,2017,14,18361,3380,21741
1,24,5,2,2017,15,18804,3457,22261
1,24,5,2,2017,16,18839,3468,22307
1,24,5,2,2017,17,18461,3429,21890
1,24,5,2,2017,18,17346,3261,20607
1,24,5,2,2017,19,16465,3121,19586
1,24,5,2,2017,20,16933,3090,20023
1,24,5,2,2017,21,16971,3019,19990
1,24,5,2,2017,22,16732,2920,19652
1,24,5,2,2017,23,16933,2923,19856
1,24,5,2,2017,24,17270,2965,20235
1,26,5,2,2017,1,17330,2855,20185
1,26,5,2,2017,2,17303,2584,19887
1,26,5,2,2017,3,16811,2473,19284
1,26,5,2,2017,4,16642,2385,19027
1,26,5,2,2017,5,16345,2296,18641
1,26,5,2,2017,6,16894,2267,19161
1,26,5,2,2017,7,16997,2263,19260
1,26,5,2,2017,8,17014,2343,19357
1,26,5,2,2017,9,16812,2582,19394
1,26,5,2,2017,10,16522,3063,19585
1,26,5,2,2017,11,16693,3317,20010
1,26,5,2,2017,12,17441,3386,20827
1,26,5,2,2017,13,17590,3393,20983
1,26,5,2,2017,14,17569,3296,20865
1,26,5,2,2017,15,18059,3395,21454
1,26,5,2,2017,16,18233,3442,21675
1,26,5,2,2017,17,17312,3393,20705
1,26,5,2,2017,18,16417,3210,19627
1,26,5,2,2017,19,15159,3054,18213
1,26,5,2,2017,20,16570,3002,19572
1,26,5,2,2017,21,16603,2932,19535
1,26,5,2,2017,22,16421,2878,19299
1,26,5,2,2017,23,16685,2868,19553
1,26,5,2,2017,24,17129,2910,20039
2,27,5,2,2017,1,17463,2816,20279
2,27,5,2,2017,2,17099,2643,19742
2,27,5,2,2017,3,16727,2454,19181
2,27,5,2,2017,4,16762,2353,19115
2,27,5,2,2017,5,16561,2270,18831
2,27,5,2,2017,6,16901,2265,19166
2,27,5,2,2017,7,17265,2208,19473
2,27,5,2,2017,8,17042,2232,19274
2,27,5,2,2017,9,16952,2415,19367
2,27,5,2,2017,10,16543,2632,19175
2,27,5,2,2017,11,16628,2962,19590
2,27,5,2,2017,12,17686,3041,20727
2,27,5,2,2017,13,17614,3083,20697
2,27,5,2,2017,14,17396,3002,20398
2,27,5,2,2017,15,17783,3096,20879
2,27,5,2,2017,16,17731,3105,20836
2,27,5,2,2017,17,17364,3038,20402
2,27,5,2,2017,18,16360,2892,19252
2,27,5,2,2017,19,15635,2795,18430
2,27,5,2,2017,20,15909,2844,18753
2,27,5,2,2017,21,16364,2817,19181
2,27,5,2,2017,22,15914,2771,18685
2,27,5,2,2017,23,16128,2784,18912
2,27,5,2,2017,24,16697,2840,19537
2,28,5,2,2017,1,16796,2794,19590
2,28,5,2,2017,2,16449,2656,19105
2,28,5,2,2017,3,16505,2444,18949
2,28,5,2,2017,4,16048,2347,18395
2,28,5,2,2017,5,16167,2311,18478
2,28,5,2,2017,6,16549,2305,18854
2,28,5,2,2017,7,16728,2210,18938
2,28,5,2,2017,8,16421,2167,18588
2,28,5,2,2017,9,16362,2185,18547
2,28,5,2,2017,10,15606,2284,17890
2,28,5,2,2017,11,16494,2347,18841
2,28,5,2,2017,12,17644,2431,20075
2,28,5,2,2017,13,17237,2524,19761
2,28,5,2,2017,14,17441,2460,19901
2,28,5,2,2017,15,17923,2540,20463
2,28,5,2,2017,16,17650,2602,20252
2,28,5,2,2017,17,17273,2566,19839
2,28,5,2,2017,18,16138,2403,18541
2,28,5,2,2017,19,14333,2391,16724
2,28,5,2,2017,20,14429,2483,16912
2,28,5,2,2017,21,14796,2606,17402
2,28,5,2,2017,22,14767,2674,17441
2,28,5,2,2017,23,15793,2769,18562
2,28,5,2,2017,24,15851,2892,18743
1,29,5,2,2017,1,15950,2864,18814
1,29,5,2,2017,2,16080,2630,18710
1,29,5,2,2017,3,15725,2490,18215
1,29,5,2,2017,4,15760,2359,18119
1,29,5,2,2017,5,15890,2299,18189
1,29,5,2,2017,6,16244,2314,18558
1,29,5,2,2017,7,16307,2270,18577
1,29,5,2,2017,8,16449,2386,18835
1,29,5,2,2017,9,16425,2602,19027
1,29,5,2,2017,10,15929,3066,18995
1,29,5,2,2017,11,16443,3394,19837
1,29,5,2,2017,12,17269,3423,20692
1,29,5,2,2017,13,17140,3450,20590
1,29,5,2,2017,14,17354,3380,20734
1,29,5,2,2017,15,17645,3445,21090
1,29,5,2,2017,16,18077,3521,21598
1,29,5,2,2017,17,17536,3438,20974
1,29,5,2,2017,18,16515,3335,19850
1,29,5,2,2017,19,15630,3062,18692
1,29,5,2,2017,20,15731,3043,18774
1,29,5,2,2017,21,15884,3012,18896
1,29,5,2,2017,22,16015,2918,18933
1,29,5,2,2017,23,16319,2958,19277
1,29,5,2,2017,24,16711,3040,19751
1,30,5,2,2017,1,16613,2896,19509
1,30,5,2,2017,2,16164,2643,18807
1,30,5,2,2017,3,15952,2542,18494
1,30,5,2,2017,4,16251,2402,18653
1,30,5,2,2017,5,15942,2361,18303
1,30,5,2,2017,6,16224,2371,18595
1,30,5,2,2017,7,16288,2307,18595
1,30,5,2,2017,8,16366,2374,18740
1,30,5,2,2017,9,15932,2692,18624
1,30,5,2,2017,10,15858,3118,18976
1,30,5,2,2017,11,16273,3280,19553
1,30,5,2,2017,12,16663,3438,20101
1,30,5,2,2017,13,16318,3448,19766
1,30,5,2,2017,14,16383,3390,19773
1,30,5,2,2017,15,16621,3505,20126
1,30,5,2,2017,16,16490,3507,19997
1,30,5,2,2017,17,16378,3470,19848
1,30,5,2,2017,18,15730,3294,19024
1,30,5,2,2017,19,15178,3126,18304
1,30,5,2,2017,20,15677,3094,18771
1,30,5,2,2017,21,15788,3028,18816
1,30,5,2,2017,22,15461,2983,18444
1,30,5,2,2017,23,16120,2991,19111
1,30,5,2,2017,24,16700,3050,19750
1,31,5,2,2017,1,16431,2936,19367
1,31,5,2,2017,2,16184,2743,18927
1,31,5,2,2017,3,16390,2539,18929
1,31,5,2,2017,4,16017,2417,18434
1,31,5,2,2017,5,16472,2366,18838
1,31,5,2,2017,6,16376,2383,18759
1,31,5,2,2017,7,16974,2306,19280
1,31,5,2,2017,8,16763,2394,19157
1,31,5,2,2017,9,16531,2738,19269
1,31,5,2,2017,10,16123,3188,19311
1,31,5,2,2017,11,17173,3350,20523
1,31,5,2,2017,12,17945,3487,21432
1,31,5,2,2017,13,17700,3484,21184
1,31,5,2,2017,14,17689,3434,21123
1,31,5,2,2017,15,17783,3524,21307
1,31,5,2,2017,16,17800,3561,21361
1,31,5,2,2017,17,17155,3489,20644
1,31,5,2,2017,18,16059,3363,19422
1,31,5,2,2017,19,15392,3099,18491
1,31,5,2,2017,20,15837,3069,18906
1,31,5,2,2017,21,16043,3058,19101
1,31,5,2,2017,22,15602,2988,18590
1,31,5,2,2017,23,16462,3002,19464
1,31,5,2,2017,24,16408,3077,19485
1,1,6,2,2017,1,16176,2983,19159
1,1,6,2,2017,2,15993,2750,18743
1,1,6,2,2017,3,15809,2569,18378
1,1,6,2,2017,4,15971,2434,18405
1,1,6,2,2017,5,15701,2373,18074
1,1,6,2,2017,6,16271,2378,18649
1,1,6,2,2017,7,16822,2311,19133
1,1,6,2,2017,8,16661,2378,19039
1,1,6,2,2017,9,16757,2784,19541
1,1,6,2,2017,10,16670,2986,19656
1,1,6,2,2017,11,16969,3320,20289
1,1,6,2,2017,12,17647,3426,21073
1,1,6,2,2017,13,17478,3444,20922
1,1,6,2,2017,14,17418,3427,20845
1,1,6,2,2017,15,17354,3577,20931
1,1,6,2,2017,16,17480,3592,21072
1,1,6,2,2017,17,16377,3538,19915
1,1,6,2,2017,18,15194,3335,18529
1,1,6,2,2017,19,14491,3182,17673
1,1,6,2,2017,20,14644,3071,17715
1,1,6,2,2017,21,14896,3038,17934
1,1,6,2,2017,22,15246,2995,18241
1,1,6,2,2017,23,14984,3046,18030
1,1,6,2,2017,24,15337,3007,18344
1,2,6,2,2017,1,15661,2831,18492
1,2,6,2,2017,2,15346,2671,18017
1,2,6,2,2017,3,15361,2470,17831
1,2,6,2,2017,4,15358,2358,17716
1,2,6,2,2017,5,15310,2316,17626
1,2,6,2,2017,6,15822,2319,18141
1,2,6,2,2017,7,16115,2265,18380
1,2,6,2,2017,8,16048,2379,18427
1,2,6,2,2017,9,16006,2636,18642
1,2,6,2,2017,10,15596,3099,18695
1,2,6,2,2017,11,15776,3318,19094
1,2,6,2,2017,12,16228,3443,19671
1,2,6,2,2017,13,16238,3445,19683
1,2,6,2,2017,14,16449,3379,19828
1,2,6,2,2017,15,16694,3484,20178
1,2,6,2,2017,16,16486,3549,20035
1,2,6,2,2017,17,15519,3423,18942
1,2,6,2,2017,18,14876,3293,18169
1,2,6,2,2017,19,14211,3148,17359
1,2,6,2,2017,20,14989,3072,18061
1,2,6,2,2017,21,15432,3029,18461
1,2,6,2,2017,22,15418,2960,18378
1,2,6,2,2017,23,15820,2964,18784
1,2,6,2,2017,24,15794,2999,18793
2,3,6,2,2017,1,15938,2899,18837
2,3,6,2,2017,2,15559,2707,18266
2,3,6,2,2017,3,15586,2542,18128
2,3,6,2,2017,4,15866,2402,18268
2,3,6,2,2017,5,15188,2333,17521
2,3,6,2,2017,6,16164,2342,18506
2,3,6,2,2017,7,16008,2265,18273
2,3,6,2,2017,8,15811,2297,18108
2,3,6,2,2017,9,15770,2476,18246
2,3,6,2,2017,10,16028,2819,18847
2,3,6,2,2017,11,16475,3158,19633
2,3,6,2,2017,12,16611,3223,19834
2,3,6,2,2017,13,16771,3245,20016
2,3,6,2,2017,14,16943,3172,20115
2,3,6,2,2017,15,16952,3239,20191
2,3,6,2,2017,16,16800,3261,20061
2,3,6,2,2017,17,15135,3132,18267
2,3,6,2,2017,18,14367,3028,17395
2,3,6,2,2017,19,13397,2901,16298
2,3,6,2,2017,20,13519,2885,16404
2,3,6,2,2017,21,13591,2837,16428
2,3,6,2,2017,22,13292,2799,16091
2,3,6,2,2017,23,13836,2738,16574
2,3,6,2,2017,24,13868,2732,16600
2,4,6,2,2017,1,13636,2767,16403
2,4,6,2,2017,2,13882,2595,16477
2,4,6,2,2017,3,13616,2451,16067
2,4,6,2,2017,4,13810,2333,16143
2,4,6,2,2017,5,13477,2271,15748
2,4,6,2,2017,6,13780,2270,16050
2,4,6,2,2017,7,13825,2179,16004
2,4,6,2,2017,8,13321,2157,15478
2,4,6,2,2017,9,13636,2195,15831
2,4,6,2,2017,10,13688,2272,15960
2,4,6,2,2017,11,14229,2341,16570
2,4,6,2,2017,12,14636,2427,17063
2,4,6,2,2017,13,14767,2474,17241
2,4,6,2,2017,14,15295,2482,17777
2,4,6,2,2017,15,15635,2535,18170
2,4,6,2,2017,16,15749,2615,18364
2,4,6,2,2017,17,14984,2554,17538
2,4,6,2,2017,18,14358,2508,16866
2,4,6,2,2017,19,14053,2410,16463
2,4,6,2,2017,20,14176,2503,16679
2,4,6,2,2017,21,14200,2611,16811
2,4,6,2,2017,22,14615,2697,17312
2,4,6,2,2017,23,15269,2780,18049
2,4,6,2,2017,24,15364,2898,18262
1,5,6,2,2017,1,15376,2834,18210
1,5,6,2,2017,2,15070,2693,17763
1,5,6,2,2017,3,14836,2470,17306
1,5,6,2,2017,4,14773,2340,17113
1,5,6,2,2017,5,14692,2303,16995
1,5,6,2,2017,6,15321,2313,17634
1,5,6,2,2017,7,15538,2266,17804
1,5,6,2,2017,8,15547,2328,17875
1,5,6,2,2017,9,15580,2708,18288
1,5,6,2,2017,10,15112,3104,18216
1,5,6,2,2017,11,15742,3309,19051
1,5,6,2,2017,12,16387,3449,19836
1,5,6,2,2017,13,16350,3451,19801
1,5,6,2,2017,14,16482,3390,19872
1,5,6,2,2017,15,16874,3510,20384
1,5,6,2,2017,16,16808,3518,20326
1,5,6,2,2017,17,16174,3492,19666
1,5,6,2,2017,18,15723,3271,18994
1,5,6,2,2017,19,14881,3062,17943
1,5,6,2,2017,20,14944,3001,17945
1,5,6,2,2017,21,14998,2950,17948
1,5,6,2,2017,22,15088,2916,18004
1,5,6,2,2017,23,15466,2943,18409
1,5,6,2,2017,24,15088,3020,18108
1,6,6,2,2017,1,15018,2895,17913
1,6,6,2,2017,2,14669,2619,17288
1,6,6,2,2017,3,14320,2492,16812
1,6,6,2,2017,4,13980,2375,16355
1,6,6,2,2017,5,14147,2326,16473
1,6,6,2,2017,6,14452,2340,16792
1,6,6,2,2017,7,14809,2296,17105
1,6,6,2,2017,8,14852,2448,17300
1,6,6,2,2017,9,15294,2641,17935
1,6,6,2,2017,10,15183,3100,18283
1,6,6,2,2017,11,15470,3436,18906
1,6,6,2,2017,12,15857,3479,19336
1,6,6,2,2017,13,15997,3480,19477
1,6,6,2,2017,14,16070,3422,19492
1,6,6,2,2017,15,16797,3490,20287
1,6,6,2,2017,16,16468,3516,19984
1,6,6,2,2017,17,16147,3437,19584
1,6,6,2,2017,18,15096,3344,18440
1,6,6,2,2017,19,14766,3066,17832
1,6,6,2,2017,20,15080,3032,18112
1,6,6,2,2017,21,15288,3021,18309
1,6,6,2,2017,22,15324,2963,18287
1,6,6,2,2017,23,15686,2989,18675
1,6,6,2,2017,24,15374,3054,18428
1,7,6,2,2017,1,14976,2953,17929
1,7,6,2,2017,2,14890,2681,17571
1,7,6,2,2017,3,14340,2539,16879
1,7,6,2,2017,4,14234,2397,16631
1,7,6,2,2017,5,14108,2334,16442
1,7,6,2,2017,6,14179,2346,16525
1,7,6,2,2017,7,14406,2293,16699
1,7,6,2,2017,8,14379,2399,16778
1,7,6,2,2017,9,14342,2663,17005
1,7,6,2,2017,10,14597,2969,17566
1,7,6,2,2017,11,15191,3301,18492
1,7,6,2,2017,12,15529,3372,18901
1,7,6,2,2017,13,15282,3291,18573
1,7,6,2,2017,14,15430,3281,18711
1,7,6,2,2017,15,15622,3411,19033
1,7,6,2,2017,16,15692,3387,19079
1,7,6,2,2017,17,15175,3194,18369
1,7,6,2,2017,18,14332,3062,17394
1,7,6,2,2017,19,13846,2942,16788
1,7,6,2,2017,20,14568,2895,17463
1,7,6,2,2017,21,14462,2855,17317
1,7,6,2,2017,22,14482,2703,17185
1,7,6,2,2017,23,14410,2675,17085
1,7,6,2,2017,24,14088,2658,16746
1,8,6,2,2017,1,14144,2527,16671
1,8,6,2,2017,2,13716,2348,16064
1,8,6,2,2017,3,13663,2133,15796
1,8,6,2,2017,4,13372,2064,15436
1,8,6,2,2017,5,13395,2039,15434
1,8,6,2,2017,6,13746,2073,15819
1,8,6,2,2017,7,14069,2082,16151
1,8,6,2,2017,8,14220,2148,16368
1,8,6,2,2017,9,14361,2496,16857
1,8,6,2,2017,10,14107,2911,17018
1,8,6,2,2017,11,14631,3042,17673
1,8,6,2,2017,12,14929,3163,18092
1,8,6,2,2017,13,14745,3156,17901
1,8,6,2,2017,14,14717,3059,17776
1,8,6,2,2017,15,14968,3126,18094
1,8,6,2,2017,16,14846,3183,18029
1,8,6,2,2017,17,14667,3179,17846
1,8,6,2,2017,18,14370,3113,17483
1,8,6,2,2017,19,14397,2895,17292
1,8,6,2,2017,20,14732,2855,17587
1,8,6,2,2017,21,14999,2894,17893
1,8,6,2,2017,22,14914,2705,17619
1,8,6,2,2017,23,15046,2700,17746
1,8,6,2,2017,24,14439,2651,17090
1,9,6,2,2017,1,14156,2431,16587
1,9,6,2,2017,2,14086,2187,16273
1,9,6,2,2017,3,13795,2058,15853
1,9,6,2,2017,4,13691,1985,15676
1,9,6,2,2017,5,13722,1955,15677
1,9,6,2,2017,6,13988,2012,16000
1,9,6,2,2017,7,14898,2019,16917
1,9,6,2,2017,8,14419,2204,16623
1,9,6,2,2017,9,14680,2402,17082
1,9,6,2,2017,10,14266,2831,17097
1,9,6,2,2017,11,14353,3134,17487
1,9,6,2,2017,12,14634,3173,17807
1,9,6,2,2017,13,15262,3169,18431
1,9,6,2,2017,14,14970,3038,18008
1,9,6,2,2017,15,14796,3099,17895
1,9,6,2,2017,16,14698,3137,17835
1,9,6,2,2017,17,14017,3091,17108
1,9,6,2,2017,18,13179,3000,16179
1,9,6,2,2017,19,13330,2843,16173
1,9,6,2,2017,20,13658,2838,16496
1,9,6,2,2017,21,13968,2816,16784
1,9,6,2,2017,22,13955,2728,16683
1,9,6,2,2017,23,14215,2653,16868
1,9,6,2,2017,24,13950,2717,16667
2,10,6,2,2017,1,13466,2604,16070
2,10,6,2,2017,2,13289,2311,15600
2,10,6,2,2017,3,12869,2084,14953
2,10,6,2,2017,4,12905,1970,14875
2,10,6,2,2017,5,12831,1934,14765
2,10,6,2,2017,6,13225,1974,15199
2,10,6,2,2017,7,14159,1961,16120
2,10,6,2,2017,8,13682,2065,15747
2,10,6,2,2017,9,13851,2176,16027
2,10,6,2,2017,10,13990,2522,16512
2,10,6,2,2017,11,14171,2751,16922
2,10,6,2,2017,12,14563,2799,17362
2,10,6,2,2017,13,14558,2773,17331
2,10,6,2,2017,14,14276,2679,16955
2,10,6,2,2017,15,14597,2672,17269
2,10,6,2,2017,16,14437,2659,17096
2,10,6,2,2017,17,14283,2655,16938
2,10,6,2,2017,18,13926,2616,16542
2,10,6,2,2017,19,13863,2575,16438
2,10,6,2,2017,20,14206,2619,16825
2,10,6,2,2017,21,13860,2691,16551
2,10,6,2,2017,22,14049,2568,16617
2,10,6,2,2017,23,14018,2488,16506
2,10,6,2,2017,24,13815,2429,16244
2,11,6,2,2017,1,13776,2344,16120
2,11,6,2,2017,2,13586,2198,15784
2,11,6,2,2017,3,12880,2097,14977
2,11,6,2,2017,4,13137,1971,15108
2,11,6,2,2017,5,13079,1952,15031
2,11,6,2,2017,6,13243,1979,15222
2,11,6,2,2017,7,13683,1929,15612
2,11,6,2,2017,8,13617,1960,15577
2,11,6,2,2017,9,13371,2075,15446
2,11,6,2,2017,10,13612,2142,15754
2,11,6,2,2017,11,13518,2259,15777
2,11,6,2,2017,12,13805,2277,16082
2,11,6,2,2017,13,13776,2243,16019
2,11,6,2,2017,14,13876,2189,16065
2,11,6,2,2017,15,13927,2167,16094
2,11,6,2,2017,16,13680,2154,15834
2,11,6,2,2017,17,13383,2149,15532
2,11,6,2,2017,18,13123,2157,15280
2,11,6,2,2017,19,12985,2188,15173
2,11,6,2,2017,20,13829,2341,16170
2,11,6,2,2017,21,13817,2362,16179
2,11,6,2,2017,22,13858,2411,16269
2,11,6,2,2017,23,13774,2421,16195
2,11,6,2,2017,24,13443,2423,15866
1,12,6,2,2017,1,13499,2302,15801
1,12,6,2,2017,2,13145,2131,15276
1,12,6,2,2017,3,13088,1970,15058
1,12,6,2,2017,4,12796,1889,14685
1,12,6,2,2017,5,12808,1881,14689
1,12,6,2,2017,6,13432,1938,15370
1,12,6,2,2017,7,13866,1971,15837
1,12,6,2,2017,8,13887,2114,16001
1,12,6,2,2017,9,13863,2443,16306
1,12,6,2,2017,10,14145,2922,17067
1,12,6,2,2017,11,14262,3063,17325
1,12,6,2,2017,12,14497,3147,17644
1,12,6,2,2017,13,14648,3139,17787
1,12,6,2,2017,14,13878,3080,16958
1,12,6,2,2017,15,13924,3135,17059
1,12,6,2,2017,16,13747,3132,16879
1,12,6,2,2017,17,13875,3113,16988
1,12,6,2,2017,18,13247,3007,16254
1,12,6,2,2017,19,13757,2900,16657
1,12,6,2,2017,20,14051,2861,16912
1,12,6,2,2017,21,13808,2811,16619
1,12,6,2,2017,22,12969,2651,15620
1,12,6,2,2017,23,12727,2379,15106
1,12,6,2,2017,24,12749,2287,15036
1,13,6,2,2017,1,12821,2139,14960
1,13,6,2,2017,2,12527,1992,14519
1,13,6,2,2017,3,12169,1906,14075
1,13,6,2,2017,4,12250,1824,14074
1,13,6,2,2017,5,12086,1828,13914
1,13,6,2,2017,6,12596,1910,14506
1,13,6,2,2017,7,13119,2007,15126
1,13,6,2,2017,8,13099,2137,15236
1,13,6,2,2017,9,13018,2552,15570
1,13,6,2,2017,10,13535,2752,16287
1,13,6,2,2017,11,13646,3028,16674
1,13,6,2,2017,12,13689,3059,16748
1,13,6,2,2017,13,13626,3057,16683
1,13,6,2,2017,14,13543,3011,16554
1,13,6,2,2017,15,14023,3058,17081
1,13,6,2,2017,16,14072,3056,17128
1,13,6,2,2017,17,13811,3058,16869
1,13,6,2,2017,18,13718,3018,16736
1,13,6,2,2017,19,13931,2876,16807
1,13,6,2,2017,20,14733,2855,17588
1,13,6,2,2017,21,14523,2754,17277
1,13,6,2,2017,22,14310,2748,17058
1,13,6,2,2017,23,14083,2632,16715
1,13,6,2,2017,24,13914,2578,16492
1,14,6,2,2017,1,13470,2449,15919
1,14,6,2,2017,2,13294,2230,15524
1,14,6,2,2017,3,13040,2109,15149
1,14,6,2,2017,4,13038,2014,15052
1,14,6,2,2017,5,13243,2019,15262
1,14,6,2,2017,6,13567,2055,15622
1,14,6,2,2017,7,13410,2111,15521
1,14,6,2,2017,8,13877,2255,16132
1,14,6,2,2017,9,14197,2647,16844
1,14,6,2,2017,10,14123,2861,16984
1,14,6,2,2017,11,14137,3180,17317
1,14,6,2,2017,12,14433,3208,17641
1,14,6,2,2017,13,14355,3204,17559
1,14,6,2,2017,14,14251,3145,17396
1,14,6,2,2017,15,14816,3210,18026
1,14,6,2,2017,16,14530,3210,17740
1,14,6,2,2017,17,14397,3208,17605
1,14,6,2,2017,18,13874,3130,17004
1,14,6,2,2017,19,14071,3044,17115
1,14,6,2,2017,20,14742,2971,17713
1,14,6,2,2017,21,14943,2850,17793
1,14,6,2,2017,22,14837,2850,17687
1,14,6,2,2017,23,14540,2782,17322
1,14,6,2,2017,24,14293,2764,17057
1,15,6,2,2017,1,13751,2459,16210
1,15,6,2,2017,2,13430,2322,15752
1,15,6,2,2017,3,13386,2192,15578
1,15,6,2,2017,4,13062,2118,15180
1,15,6,2,2017,5,13202,2102,15304
1,15,6,2,2017,6,13768,2165,15933
1,15,6,2,2017,7,14163,2199,16362
1,15,6,2,2017,8,14355,2341,16696
1,15,6,2,2017,9,13932,2739,16671
1,15,6,2,2017,10,14130,2953,17083
1,15,6,2,2017,11,14242,3230,17472
1,15,6,2,2017,12,14166,3232,17398
1,15,6,2,2017,13,14092,3232,17324
1,15,6,2,2017,14,13991,3180,17171
1,15,6,2,2017,15,13980,3232,17212
1,15,6,2,2017,16,14105,3231,17336
1,15,6,2,2017,17,13095,3228,16323
1,15,6,2,2017,18,13670,3123,16793
1,15,6,2,2017,19,13237,2983,16220
1,15,6,2,2017,20,13945,2938,16883
1,15,6,2,2017,21,13751,2934,16685
1,15,6,2,2017,22,13681,2842,16523
1,15,6,2,2017,23,13908,2852,16760
1,15,6,2,2017,24,13313,2820,16133
1,16,6,2,2017,1,13119,2615,15734
1,16,6,2,2017,2,12785,2390,15175
1,16,6,2,2017,3,12391,2213,14604
1,16,6,2,2017,4,12516,2137,14653
1,16,6,2,2017,5,12844,2112,14956
1,16,6,2,2017,6,13090,2156,15246
1,16,6,2,2017,7,13389,2218,15607
1,16,6,2,2017,8,13506,2287,15793
1,16,6,2,2017,9,13217,2595,15812
1,16,6,2,2017,10,12925,3107,16032
1,16,6,2,2017,11,13099,3240,16339
1,16,6,2,2017,12,13207,3300,16507
1,16,6,2,2017,13,12982,3310,16292
1,16,6,2,2017,14,13099,3224,16323
1,16,6,2,2017,15,13405,3342,16747
1,16,6,2,2017,16,13387,3345,16732
1,16,6,2,2017,17,13021,3341,16362
1,16,6,2,2017,18,13266,3211,16477
1,16,6,2,2017,19,12931,3071,16002
1,16,6,2,2017,20,13642,3003,16645
1,16,6,2,2017,21,14084,2948,17032
1,16,6,2,2017,22,13862,2900,16762
1,16,6,2,2017,23,13841,2863,16704
1,16,6,2,2017,24,13393,2863,16256
2,17,6,2,2017,1,13112,2719,15831
2,17,6,2,2017,2,12794,2509,15303
2,17,6,2,2017,3,12446,2278,14724
2,17,6,2,2017,4,12596,2173,14769
2,17,6,2,2017,5,12574,2136,14710
2,17,6,2,2017,6,13156,2162,15318
2,17,6,2,2017,7,13771,2149,15920
2,17,6,2,2017,8,13818,2221,16039
2,17,6,2,2017,9,13660,2478,16138
2,17,6,2,2017,10,13581,2895,16476
2,17,6,2,2017,11,13998,3037,17035
2,17,6,2,2017,12,14214,3159,17373
2,17,6,2,2017,13,14102,3172,17274
2,17,6,2,2017,14,14139,3109,17248
2,17,6,2,2017,15,14492,3182,17674
2,17,6,2,2017,16,14779,3174,17953
2,17,6,2,2017,17,14145,3136,17281
2,17,6,2,2017,18,13687,3035,16722
2,17,6,2,2017,19,13423,2893,16316
2,17,6,2,2017,20,14373,2906,17279
2,17,6,2,2017,21,14505,2968,17473
2,17,6,2,2017,22,14509,2881,17390
2,17,6,2,2017,23,14920,2796,17716
2,17,6,2,2017,24,14337,2884,17221
2,18,6,2,2017,1,13984,2786,16770
2,18,6,2,2017,2,13756,2540,16296
2,18,6,2,2017,3,13424,2410,15834
2,18,6,2,2017,4,13253,2284,15537
2,18,6,2,2017,5,13340,2243,15583
2,18,6,2,2017,6,13797,2264,16061
2,18,6,2,2017,7,13982,2176,16158
2,18,6,2,2017,8,14237,2184,16421
2,18,6,2,2017,9,13934,2248,16182
2,18,6,2,2017,10,13614,2328,15942
2,18,6,2,2017,11,13994,2450,16444
2,18,6,2,2017,12,14235,2493,16728
2,18,6,2,2017,13,14058,2502,16560
2,18,6,2,2017,14,14549,2513,17062
2,18,6,2,2017,15,14549,2555,17104
2,18,6,2,2017,16,14885,2592,17477
2,18,6,2,2017,17,14395,2569,16964
2,18,6,2,2017,18,14045,2487,16532
2,18,6,2,2017,19,13666,2458,16124
2,18,6,2,2017,20,14132,2577,16709
2,18,6,2,2017,21,14638,2710,17348
2,18,6,2,2017,22,14384,2742,17126
2,18,6,2,2017,23,14371,2823,17194
2,18,6,2,2017,24,14219,2862,17081
1,19,6,2,2017,1,13893,2765,16658
1,19,6,2,2017,2,13496,2498,15994
1,19,6,2,2017,3,13521,2358,15879
1,19,6,2,2017,4,13264,2248,15512
1,19,6,2,2017,5,13457,2213,15670
1,19,6,2,2017,6,14213,2272,16485
1,19,6,2,2017,7,14268,2290,16558
1,19,6,2,2017,8,14758,2451,17209
1,19,6,2,2017,9,14659,2700,17359
1,19,6,2,2017,10,14322,3141,17463
1,19,6,2,2017,11,14588,3276,17864
1,19,6,2,2017,12,15369,3397,18766
1,19,6,2,2017,13,14859,3393,18252
1,19,6,2,2017,14,15395,3350,18745
1,19,6,2,2017,15,15379,3398,18777
1,19,6,2,2017,16,15710,3403,19113
1,19,6,2,2017,17,15347,3355,18702
1,19,6,2,2017,18,14623,3265,17888
1,19,6,2,2017,19,14188,3046,17234
1,19,6,2,2017,20,14963,3029,17992
1,19,6,2,2017,21,14987,2969,17956
1,19,6,2,2017,22,14943,2937,17880
1,19,6,2,2017,23,15237,2960,18197
1,19,6,2,2017,24,14924,2952,17876
1,20,6,2,2017,1,14547,2795,17342
1,20,6,2,2017,2,14031,2609,16640
1,20,6,2,2017,3,14172,2406,16578
1,20,6,2,2017,4,13958,2291,16249
1,20,6,2,2017,5,13887,2242,16129
1,20,6,2,2017,6,14457,2290,16747
1,20,6,2,2017,7,14990,2294,17284
1,20,6,2,2017,8,15569,2434,18003
1,20,6,2,2017,9,15039,2750,17789
1,20,6,2,2017,10,14706,3055,17761
1,20,6,2,2017,11,14696,3358,18054
1,20,6,2,2017,12,15056,3405,18461
1,20,6,2,2017,13,15253,3393,18646
1,20,6,2,2017,14,15304,3290,18594
1,20,6,2,2017,15,15637,3408,19045
1,20,6,2,2017,16,15675,3424,19099
1,20,6,2,2017,17,15308,3372,18680
1,20,6,2,2017,18,14813,3228,18041
1,20,6,2,2017,19,14275,3082,17357
1,20,6,2,2017,20,14699,3006,17705
1,20,6,2,2017,21,15440,2967,18407
1,20,6,2,2017,22,15154,2913,18067
1,20,6,2,2017,23,15198,2931,18129
1,20,6,2,2017,24,15022,2922,17944
1,21,6,2,2017,1,14732,2779,17511
1,21,6,2,2017,2,14337,2571,16908
1,21,6,2,2017,3,14382,2354,16736
1,21,6,2,2017,4,13711,2262,15973
1,21,6,2,2017,5,14481,2223,16704
1,21,6,2,2017,6,14823,2261,17084
1,21,6,2,2017,7,15551,2294,17845
1,21,6,2,2017,8,15676,2372,18048
1,21,6,2,2017,9,15519,2751,18270
1,21,6,2,2017,10,15159,3053,18212
1,21,6,2,2017,11,14981,3281,18262
1,21,6,2,2017,12,15924,3378,19302
1,21,6,2,2017,13,15682,3341,19023
1,21,6,2,2017,14,15588,3256,18844
1,21,6,2,2017,15,15741,3275,19016
1,21,6,2,2017,16,15654,3291,18945
1,21,6,2,2017,17,15545,3274,18819
1,21,6,2,2017,18,14953,3128,18081
1,21,6,2,2017,19,14628,3010,17638
1,21,6,2,2017,20,14969,2918,17887
1,21,6,2,2017,21,15483,2871,18354
1,21,6,2,2017,22,15045,2789,17834
1,21,6,2,2017,23,15020,2779,17799
1,21,6,2,2017,24,14599,2713,17312
1,22,6,2,2017,1,14675,2591,17266
1,22,6,2,2017,2,14315,2452,16767
1,22,6,2,2017,3,14104,2282,16386
1,22,6,2,2017,4,14082,2184,16266
1,22,6,2,2017,5,13937,2155,16092
1,22,6,2,2017,6,15028,2184,17212
1,22,6,2,2017,7,15376,2235,17611
1,22,6,2,2017,8,15711,2362,18073
1,22,6,2,2017,9,15486,2672,18158
1,22,6,2,2017,10,14775,3117,17892
1,22,6,2,2017,11,15126,3260,18386
1,22,6,2,2017,12,15311,3357,18668
1,22,6,2,2017,13,15113,3326,18439
1,22,6,2,2017,14,15148,3257,18405
1,22,6,2,2017,15,15382,3249,18631
1,22,6,2,2017,16,15470,3152,18622
1,22,6,2,2017,17,14979,3133,18112
1,22,6,2,2017,18,14378,3069,17447
1,22,6,2,2017,19,13781,2976,16757
1,22,6,2,2017,20,14230,2902,17132
1,22,6,2,2017,21,14454,2855,17309
1,22,6,2,2017,22,14401,2730,17131
1,22,6,2,2017,23,14455,2691,17146
1,22,6,2,2017,24,14105,2680,16785
1,23,6,2,2017,1,14185,2543,16728
1,23,6,2,2017,2,13727,2360,16087
1,23,6,2,2017,3,13566,2237,15803
1,23,6,2,2017,4,13590,2141,15731
1,23,6,2,2017,5,13670,2112,15782
1,23,6,2,2017,6,14585,2175,16760
1,23,6,2,2017,7,15038,2215,17253
1,23,6,2,2017,8,15270,2300,17570
1,23,6,2,2017,9,14993,2696,17689
1,23,6,2,2017,10,14352,3010,17362
1,23,6,2,2017,11,14556,3284,17840
1,23,6,2,2017,12,14722,3346,18068
1,23,6,2,2017,13,14684,3345,18029
1,23,6,2,2017,14,14901,3265,18166
1,23,6,2,2017,15,14834,3343,18177
1,23,6,2,2017,16,14817,3344,18161
1,23,6,2,2017,17,14753,3336,18089
1,23,6,2,2017,18,13643,3180,16823
1,23,6,2,2017,19,13640,3060,16700
1,23,6,2,2017,20,14034,2965,16999
1,23,6,2,2017,21,14462,2903,17365
1,23,6,2,2017,22,14554,2836,17390
1,23,6,2,2017,23,14544,2826,17370
1,23,6,2,2017,24,14515,2839,17354
2,24,6,2,2017,1,14414,2704,17118
2,24,6,2,2017,2,13873,2498,16371
2,24,6,2,2017,3,13655,2343,15998
2,24,6,2,2017,4,13640,2241,15881
2,24,6,2,2017,5,13702,2204,15906
2,24,6,2,2017,6,14290,2213,16503
2,24,6,2,2017,7,14945,2170,17115
2,24,6,2,2017,8,14404,2257,16661
2,24,6,2,2017,9,14987,2439,17426
2,24,6,2,2017,10,14407,2679,17086
2,24,6,2,2017,11,14588,2976,17564
2,24,6,2,2017,12,15106,3022,18128
2,24,6,2,2017,13,14853,3040,17893
2,24,6,2,2017,14,14640,2971,17611
2,24,6,2,2017,15,14711,3010,17721
2,24,6,2,2017,16,14633,2943,17576
2,24,6,2,2017,17,14466,2870,17336
2,24,6,2,2017,18,14060,2827,16887
2,24,6,2,2017,19,13634,2763,16397
2,24,6,2,2017,20,14264,2807,17071
2,24,6,2,2017,21,14266,2762,17028
2,24,6,2,2017,22,14296,2676,16972
2,24,6,2,2017,23,14355,2681,17036
2,24,6,2,2017,24,14361,2689,17050
2,25,6,2,2017,1,14007,2621,16628
2,25,6,2,2017,2,13639,2414,16053
2,25,6,2,2017,3,13295,2266,15561
2,25,6,2,2017,4,13186,2159,15345
2,25,6,2,2017,5,13313,2085,15398
2,25,6,2,2017,6,13598,2081,15680
2,25,6,2,2017,7,13862,2009,15871
2,25,6,2,2017,8,14186,1990,16176
2,25,6,2,2017,9,14214,2005,16218
2,25,6,2,2017,10,13546,2087,15633
2,25,6,2,2017,11,13961,2195,16156
2,25,6,2,2017,12,14300,2224,16524
2,25,6,2,2017,13,13955,2241,16196
2,25,6,2,2017,14,13941,2151,16092
2,25,6,2,2017,15,13941,2139,16080
2,25,6,2,2017,16,13916,2101,16018
2,25,6,2,2017,17,13348,2085,15433
2,25,6,2,2017,18,13002,2083,15086
2,25,6,2,2017,19,12950,2163,15114
2,25,6,2,2017,20,13380,2253,15633
2,25,6,2,2017,21,13441,2313,15754
2,25,6,2,2017,22,13508,2309,15817
2,25,6,2,2017,23,13546,2306,15852
2,25,6,2,2017,24,13654,2289,15942
3,26,6,2,2017,1,13286,2182,15468
3,26,6,2,2017,2,13055,2057,15112
3,26,6,2,2017,3,12991,1949,14940
3,26,6,2,2017,4,12800,1877,14677
3,26,6,2,2017,5,13077,1858,14935
3,26,6,2,2017,6,13848,1943,15791
3,26,6,2,2017,7,14261,1963,16224
3,26,6,2,2017,8,14511,2028,16539
3,26,6,2,2017,9,14671,2260,16931
3,26,6,2,2017,10,13973,2460,16433
3,26,6,2,2017,11,13876,2698,16574
3,26,6,2,2017,12,14261,2724,16985
3,26,6,2,2017,13,14001,2710,16711
3,26,6,2,2017,14,13944,2567,16511
3,26,6,2,2017,15,13768,2543,16311
3,26,6,2,2017,16,13545,2533,16078
3,26,6,2,2017,17,13263,2497,15760
3,26,6,2,2017,18,12822,2467,15289
3,26,6,2,2017,19,12807,2445,15252
3,26,6,2,2017,20,13673,2480,16153
3,26,6,2,2017,21,13276,2478,15754
3,26,6,2,2017,22,13240,2415,15655
3,26,6,2,2017,23,13274,2406,15680
3,26,6,2,2017,24,12815,2359,15174
1,27,6,2,2017,1,12560,2263,14823
1,27,6,2,2017,2,12478,2098,14576
1,27,6,2,2017,3,12178,1958,14136
1,27,6,2,2017,4,12177,1903,14080
1,27,6,2,2017,5,12150,1872,14022
1,27,6,2,2017,6,12931,1925,14856
1,27,6,2,2017,7,13759,2023,15782
1,27,6,2,2017,8,13837,2181,16018
1,27,6,2,2017,9,13619,2544,16163
1,27,6,2,2017,10,13410,2705,16115
1,27,6,2,2017,11,13327,2998,16325
1,27,6,2,2017,12,13407,3001,16408
1,27,6,2,2017,13,13199,2955,16154
1,27,6,2,2017,14,13211,2859,16070
1,27,6,2,2017,15,13207,2831,16038
1,27,6,2,2017,16,13056,2852,15908
1,27,6,2,2017,17,13168,2892,16060
1,27,6,2,2017,18,12627,2865,15492
1,27,6,2,2017,19,12788,2722,15510
1,27,6,2,2017,20,13739,2690,16429
1,27,6,2,2017,21,13726,2612,16338
1,27,6,2,2017,22,13324,2473,15797
1,27,6,2,2017,23,12936,2407,15343
1,27,6,2,2017,24,12675,2285,14960
1,28,6,2,2017,1,12472,2128,14600
1,28,6,2,2017,2,12252,1998,14250
1,28,6,2,2017,3,12011,1874,13885
1,28,6,2,2017,4,12133,1824,13957
1,28,6,2,2017,5,12143,1794,13937
1,28,6,2,2017,6,12815,1852,14667
1,28,6,2,2017,7,13767,2011,15778
1,28,6,2,2017,8,13935,2114,16049
1,28,6,2,2017,9,13971,2502,16473
1,28,6,2,2017,10,13365,2772,16137
1,28,6,2,2017,11,13539,2974,16513
1,28,6,2,2017,12,13334,3044,16378
1,28,6,2,2017,13,13111,2984,16095
1,28,6,2,2017,14,12963,2888,15851
1,28,6,2,2017,15,13259,2898,16157
1,28,6,2,2017,16,12920,2855,15775
1,28,6,2,2017,17,12593,2834,15427
1,28,6,2,2017,18,12490,2803,15293
1,28,6,2,2017,19,12656,2772,15428
1,28,6,2,2017,20,13419,2687,16106
1,28,6,2,2017,21,13738,2545,16283
1,28,6,2,2017,22,13274,2432,15706
1,28,6,2,2017,23,12614,2299,14913
1,28,6,2,2017,24,12576,2172,14748
1,29,6,2,2017,1,12743,1989,14732
1,29,6,2,2017,2,12141,1890,14031
1,29,6,2,2017,3,12287,1798,14085
1,29,6,2,2017,4,12204,1749,13953
1,29,6,2,2017,5,12286,1738,14024
1,29,6,2,2017,6,12712,1806,14518
1,29,6,2,2017,7,13944,1997,15941
1,29,6,2,2017,8,13908,2126,16034
1,29,6,2,2017,9,13672,2521,16193
1,29,6,2,2017,10,13399,2819,16218
1,29,6,2,2017,11,13366,3078,16444
1,29,6,2,2017,12,13586,3150,16736
1,29,6,2,2017,13,13209,3097,16306
1,29,6,2,2017,14,13215,2982,16197
1,29,6,2,2017,15,13310,2987,16297
1,29,6,2,2017,16,13312,2982,16294
1,29,6,2,2017,17,12966,2958,15924
1,29,6,2,2017,18,12720,2897,15617
1,29,6,2,2017,19,12741,2845,15586
1,29,6,2,2017,20,13449,2779,16228
1,29,6,2,2017,21,13687,2708,16395
1,29,6,2,2017,22,13200,2564,15764
1,29,6,2,2017,23,13161,2442,15603
1,29,6,2,2017,24,13058,2377,15435
1,30,6,2,2017,1,12733,2137,14870
1,30,6,2,2017,2,12580,2012,14592
1,30,6,2,2017,3,12071,1903,13974
1,30,6,2,2017,4,12114,1840,13954
1,30,6,2,2017,5,12393,1820,14213
1,30,6,2,2017,6,13036,1937,14973
1,30,6,2,2017,7,13811,2039,15850
1,30,6,2,2017,8,14179,2297,16476
1,30,6,2,2017,9,14011,2496,16507
1,30,6,2,2017,10,13425,2903,16328
1,30,6,2,2017,11,13089,3152,16241
1,30,6,2,2017,12,13269,3177,16446
1,30,6,2,2017,13,13064,3098,16162
1,30,6,2,2017,14,13021,3012,16033
1,30,6,2,2017,15,13043,3034,16077
1,30,6,2,2017,16,13094,3039,16133
1,30,6,2,2017,17,12998,3031,16029
1,30,6,2,2017,18,12652,2913,15565
1,30,6,2,2017,19,12575,2869,15444
1,30,6,2,2017,20,13142,2843,15985
1,30,6,2,2017,21,13439,2721,16160
1,30,6,2,2017,22,13291,2633,15924
1,30,6,2,2017,23,13264,2501,15765
1,30,6,2,2017,24,13190,2431,15621
2,1,7,3,2017,1,12753,2226,14979
2,1,7,3,2017,2,12428,2083,14511
2,1,7,3,2017,3,12113,1940,14053
2,1,7,3,2017,4,12058,1870,13928
2,1,7,3,2017,5,12212,1846,14058
2,1,7,3,2017,6,12932,1901,14833
2,1,7,3,2017,7,13990,1954,15944
2,1,7,3,2017,8,14146,2100,16246
2,1,7,3,2017,9,14156,2283,16439
2,1,7,3,2017,10,13651,2661,16312
2,1,7,3,2017,11,13151,2816,15967
2,1,7,3,2017,12,13625,2947,16572
2,1,7,3,2017,13,13213,2939,16152
2,1,7,3,2017,14,13146,2798,15944
2,1,7,3,2017,15,13056,2796,15852
2,1,7,3,2017,16,12866,2768,15634
2,1,7,3,2017,17,12763,2715,15478
2,1,7,3,2017,18,12367,2695,15062
2,1,7,3,2017,19,12707,2637,15344
2,1,7,3,2017,20,13355,2666,16021
2,1,7,3,2017,21,13397,2618,16015
2,1,7,3,2017,22,13014,2497,15511
2,1,7,3,2017,23,12854,2387,15241
2,1,7,3,2017,24,12490,2302,14792
2,2,7,3,2017,1,12221,2121,14342
2,2,7,3,2017,2,12057,1954,14011
2,2,7,3,2017,3,12276,1854,14130
2,2,7,3,2017,4,11907,1798,13705
2,2,7,3,2017,5,12376,1772,14148
2,2,7,3,2017,6,12892,1811,14703
2,2,7,3,2017,7,13547,1831,15378
2,2,7,3,2017,8,13740,1859,15599
2,2,7,3,2017,9,13699,1950,15649
2,2,7,3,2017,10,13351,2111,15462
2,2,7,3,2017,11,13364,2210,15574
2,2,7,3,2017,12,13351,2255,15606
2,2,7,3,2017,13,12905,2267,15172
2,2,7,3,2017,14,12785,2215,15000
2,2,7,3,2017,15,12784,2165,14949
2,2,7,3,2017,16,12497,2080,14577
2,2,7,3,2017,17,12366,2061,14427
2,2,7,3,2017,18,12080,2114,14194
2,2,7,3,2017,19,12259,2158,14417
2,2,7,3,2017,20,12541,2295,14836
2,2,7,3,2017,21,13110,2309,15419
2,2,7,3,2017,22,12610,2302,14912
2,2,7,3,2017,23,12613,2269,14882
2,2,7,3,2017,24,12297,2207,14504
1,3,7,3,2017,1,12372,2046,14418
1,3,7,3,2017,2,12086,1905,13991
1,3,7,3,2017,3,11933,1814,13747
1,3,7,3,2017,4,12056,1751,13807
1,3,7,3,2017,5,12227,1755,13982
1,3,7,3,2017,6,12970,1849,14819
1,3,7,3,2017,7,13885,2027,15912
1,3,7,3,2017,8,14288,2192,16480
1,3,7,3,2017,9,14328,2620,16948
1,3,7,3,2017,10,14158,2831,16989
1,3,7,3,2017,11,13811,3126,16937
1,3,7,3,2017,12,14165,3174,17339
1,3,7,3,2017,13,13800,3165,16965
1,3,7,3,2017,14,13416,3022,16438
1,3,7,3,2017,15,13516,3079,16595
1,3,7,3,2017,16,13598,3092,16690
1,3,7,3,2017,17,13144,3045,16189
1,3,7,3,2017,18,12819,2977,15796
1,3,7,3,2017,19,12746,2828,15574
1,3,7,3,2017,20,13680,2784,16464
1,3,7,3,2017,21,13634,2724,16358
1,3,7,3,2017,22,13398,2641,16039
1,3,7,3,2017,23,13247,2543,15790
1,3,7,3,2017,24,12837,2396,15233
1,4,7,3,2017,1,13211,2260,15471
1,4,7,3,2017,2,12895,2035,14930
1,4,7,3,2017,3,12729,1954,14683
1,4,7,3,2017,4,12734,1873,14607
1,4,7,3,2017,5,12899,1871,14770
1,4,7,3,2017,6,13742,1956,15698
1,4,7,3,2017,7,14512,2083,16595
1,4,7,3,2017,8,14861,2302,17163
1,4,7,3,2017,9,15201,2483,17684
1,4,7,3,2017,10,14517,2918,17435
1,4,7,3,2017,11,14179,3166,17345
1,4,7,3,2017,12,14279,3197,17476
1,4,7,3,2017,13,14124,3136,17260
1,4,7,3,2017,14,13808,3042,16850
1,4,7,3,2017,15,13691,3071,16762
1,4,7,3,2017,16,13848,3054,16902
1,4,7,3,2017,17,13452,3047,16499
1,4,7,3,2017,18,13027,2938,15965
1,4,7,3,2017,19,13164,2849,16013
1,4,7,3,2017,20,13740,2796,16536
1,4,7,3,2017,21,14161,2743,16904
1,4,7,3,2017,22,13665,2608,16273
1,4,7,3,2017,23,13515,2548,16063
1,4,7,3,2017,24,13517,2424,15941
1,5,7,3,2017,1,13378,2281,15659
1,5,7,3,2017,2,13090,2094,15184
1,5,7,3,2017,3,13045,1982,15027
1,5,7,3,2017,4,12895,1911,14806
1,5,7,3,2017,5,13019,1892,14911
1,5,7,3,2017,6,13894,2012,15906
1,5,7,3,2017,7,15015,2123,17138
1,5,7,3,2017,8,15399,2278,17677
1,5,7,3,2017,9,15198,2621,17819
1,5,7,3,2017,10,14536,2962,17498
1,5,7,3,2017,11,14249,3197,17446
1,5,7,3,2017,12,14278,3268,17546
1,5,7,3,2017,13,14112,3229,17341
1,5,7,3,2017,14,14245,3089,17334
1,5,7,3,2017,15,14141,3126,17267
1,5,7,3,2017,16,14178,3112,17290
1,5,7,3,2017,17,13831,3056,16887
1,5,7,3,2017,18,13507,2990,16497
1,5,7,3,2017,19,13777,2906,16683
1,5,7,3,2017,20,14231,2891,17122
1,5,7,3,2017,21,14196,2792,16988
1,5,7,3,2017,22,13925,2713,16638
1,5,7,3,2017,23,13463,2607,16070
1,5,7,3,2017,24,13307,2557,15864
1,6,7,3,2017,1,13532,2340,15872
1,6,7,3,2017,2,13019,2169,15188
1,6,7,3,2017,3,12728,2044,14772
1,6,7,3,2017,4,12936,1961,14897
1,6,7,3,2017,5,12995,1939,14934
1,6,7,3,2017,6,14087,2030,16117
1,6,7,3,2017,7,14684,2130,16814
1,6,7,3,2017,8,15346,2299,17645
1,6,7,3,2017,9,15112,2612,17724
1,6,7,3,2017,10,14464,3017,17481
1,6,7,3,2017,11,14706,3161,17867
1,6,7,3,2017,12,14882,3280,18162
1,6,7,3,2017,13,14764,3256,18020
1,6,7,3,2017,14,14685,3135,17820
1,6,7,3,2017,15,14803,3178,17981
1,6,7,3,2017,16,14815,3193,18008
1,6,7,3,2017,17,14391,3134,17525
1,6,7,3,2017,18,13740,2970,16710
1,6,7,3,2017,19,13480,2883,16363
1,6,7,3,2017,20,14221,2859,17080
1,6,7,3,2017,21,14815,2774,17589
1,6,7,3,2017,22,14038,2685,16723
1,6,7,3,2017,23,14033,2616,16649
1,6,7,3,2017,24,13796,2545,16341
1,7,7,3,2017,1,13774,2346,16120
1,7,7,3,2017,2,13633,2151,15784
1,7,7,3,2017,3,13496,2010,15506
1,7,7,3,2017,4,13341,1919,15260
1,7,7,3,2017,5,13720,1918,15638
1,7,7,3,2017,6,14408,2031,16439
1,7,7,3,2017,7,15198,2119,17317
1,7,7,3,2017,8,15682,2259,17941
1,7,7,3,2017,9,15841,2592,18433
1,7,7,3,2017,10,14915,3033,17948
1,7,7,3,2017,11,14981,3168,18149
1,7,7,3,2017,12,14845,3273,18118
1,7,7,3,2017,13,14975,3241,18216
1,7,7,3,2017,14,15064,3131,18195
1,7,7,3,2017,15,14947,3166,18113
1,7,7,3,2017,16,14901,3184,18085
1,7,7,3,2017,17,14376,3110,17486
1,7,7,3,2017,18,13975,3022,16997
1,7,7,3,2017,19,13476,2874,16350
1,7,7,3,2017,20,13927,2842,16769
1,7,7,3,2017,21,14328,2779,17107
1,7,7,3,2017,22,13895,2680,16575
1,7,7,3,2017,23,13830,2590,16420
1,7,7,3,2017,24,13936,2561,16497
2,8,7,3,2017,1,14303,2366,16669
2,8,7,3,2017,2,14043,2193,16236
2,8,7,3,2017,3,13781,2063,15844
2,8,7,3,2017,4,13759,1978,15737
2,8,7,3,2017,5,14021,1950,15971
2,8,7,3,2017,6,14899,1986,16885
2,8,7,3,2017,7,15634,2027,17661
2,8,7,3,2017,8,15586,2115,17701
2,8,7,3,2017,9,16031,2397,18428
2,8,7,3,2017,10,14932,2586,17518
2,8,7,3,2017,11,15447,2884,18331
2,8,7,3,2017,12,15700,2960,18660
2,8,7,3,2017,13,15942,2959,18901
2,8,7,3,2017,14,15900,2831,18731
2,8,7,3,2017,15,16073,2862,18935
2,8,7,3,2017,16,15971,2867,18838
2,8,7,3,2017,17,15767,2841,18608
2,8,7,3,2017,18,14997,2729,17726
2,8,7,3,2017,19,14585,2646,17231
2,8,7,3,2017,20,14619,2704,17323
2,8,7,3,2017,21,15097,2705,17802
2,8,7,3,2017,22,14668,2647,17315
2,8,7,3,2017,23,14595,2555,17150
2,8,7,3,2017,24,14750,2523,17273
2,9,7,3,2017,1,14965,2369,17334
2,9,7,3,2017,2,14544,2224,16768
2,9,7,3,2017,3,14363,2076,16439
2,9,7,3,2017,4,14492,1991,16483
2,9,7,3,2017,5,14525,1960,16485
2,9,7,3,2017,6,15173,1981,17154
2,9,7,3,2017,7,15699,1970,17669
2,9,7,3,2017,8,16175,2000,18175
2,9,7,3,2017,9,16236,2087,18323
2,9,7,3,2017,10,15929,2212,18141
2,9,7,3,2017,11,15824,2344,18168
2,9,7,3,2017,12,16345,2369,18714
2,9,7,3,2017,13,16783,2360,19143
2,9,7,3,2017,14,16471,2317,18788
2,9,7,3,2017,15,16478,2306,18784
2,9,7,3,2017,16,16262,2278,18540
2,9,7,3,2017,17,15513,2230,17743
2,9,7,3,2017,18,14699,2205,16904
2,9,7,3,2017,19,14128,2252,16380
2,9,7,3,2017,20,14402,2367,16769
2,9,7,3,2017,21,14586,2453,17039
2,9,7,3,2017,22,14308,2480,16788
2,9,7,3,2017,23,14405,2483,16888
2,9,7,3,2017,24,14517,2506,17023
1,10,7,3,2017,1,14513,2378,16891
1,10,7,3,2017,2,14232,2220,16452
1,10,7,3,2017,3,14256,2040,16296
1,10,7,3,2017,4,14192,1950,16142
1,10,7,3,2017,5,14658,1941,16599
1,10,7,3,2017,6,15173,2016,17189
1,10,7,3,2017,7,16127,2118,18245
1,10,7,3,2017,8,16561,2286,18847
1,10,7,3,2017,9,16439,2515,18954
1,10,7,3,2017,10,15954,2971,18925
1,10,7,3,2017,11,15885,3178,19063
1,10,7,3,2017,12,16606,3262,19868
1,10,7,3,2017,13,16659,3222,19881
1,10,7,3,2017,14,16781,3132,19913
1,10,7,3,2017,15,16426,3195,19621
1,10,7,3,2017,16,16463,3201,19664
1,10,7,3,2017,17,15963,3158,19121
1,10,7,3,2017,18,15437,3097,18534
1,10,7,3,2017,19,14744,2906,17650
1,10,7,3,2017,20,15094,2891,17985
1,10,7,3,2017,21,15243,2851,18094
1,10,7,3,2017,22,14802,2728,17530
1,10,7,3,2017,23,14799,2678,17477
1,10,7,3,2017,24,14717,2641,17358
1,11,7,3,2017,1,14849,2455,17304
1,11,7,3,2017,2,14515,2234,16749
1,11,7,3,2017,3,14354,2092,16446
1,11,7,3,2017,4,14593,2009,16602
1,11,7,3,2017,5,14553,1986,16539
1,11,7,3,2017,6,15120,2083,17203
1,11,7,3,2017,7,16417,2149,18566
1,11,7,3,2017,8,16340,2308,18648
1,11,7,3,2017,9,16619,2597,19216
1,11,7,3,2017,10,15876,3014,18890
1,11,7,3,2017,11,15855,3156,19011
1,11,7,3,2017,12,16121,3256,19377
1,11,7,3,2017,13,16219,3208,19427
1,11,7,3,2017,14,16125,3139,19264
1,11,7,3,2017,15,16218,3150,19368
1,11,7,3,2017,16,15956,3183,19139
1,11,7,3,2017,17,15269,3153,18422
1,11,7,3,2017,18,14977,3042,18019
1,11,7,3,2017,19,14280,2929,17209
1,11,7,3,2017,20,14792,2924,17716
1,11,7,3,2017,21,15143,2870,18013
1,11,7,3,2017,22,14632,2705,17337
1,11,7,3,2017,23,14456,2705,17161
1,11,7,3,2017,24,14553,2620,17173
1,12,7,3,2017,1,14685,2444,17129
1,12,7,3,2017,2,14432,2243,16675
1,12,7,3,2017,3,14222,2110,16332
1,12,7,3,2017,4,14083,2016,16099
1,12,7,3,2017,5,14460,1977,16437
1,12,7,3,2017,6,15147,2070,17217
1,12,7,3,2017,7,16145,2182,18327
1,12,7,3,2017,8,16448,2316,18764
1,12,7,3,2017,9,16563,2590,19153
1,12,7,3,2017,10,15631,2978,18609
1,12,7,3,2017,11,15529,3195,18724
1,12,7,3,2017,12,16167,3270,19437
1,12,7,3,2017,13,15865,3203,19068
1,12,7,3,2017,14,15603,3121,18724
1,12,7,3,2017,15,15646,3165,18811
1,12,7,3,2017,16,15592,3144,18736
1,12,7,3,2017,17,15367,3119,18486
1,12,7,3,2017,18,14563,3030,17593
1,12,7,3,2017,19,14674,2965,17639
1,12,7,3,2017,20,14731,2924,17655
1,12,7,3,2017,21,14980,2811,17791
1,12,7,3,2017,22,14365,2722,17087
1,12,7,3,2017,23,14277,2631,16908
1,12,7,3,2017,24,14135,2600,16735
1,14,7,3,2017,1,13149,2282,15431
1,14,7,3,2017,2,12831,2101,14932
1,14,7,3,2017,3,12520,1993,14513
1,14,7,3,2017,4,12725,1924,14649
1,14,7,3,2017,5,12942,1909,14851
1,14,7,3,2017,6,13578,2000,15578
1,14,7,3,2017,7,14062,2119,16181
1,14,7,3,2017,8,14204,2254,16458
1,14,7,3,2017,9,14440,2575,17015
1,14,7,3,2017,10,14068,2875,16943
1,14,7,3,2017,11,14011,3073,17084
1,14,7,3,2017,12,13776,3116,16892
1,14,7,3,2017,13,13377,3077,16454
1,14,7,3,2017,14,13312,2888,16200
1,14,7,3,2017,15,13365,2943,16308
1,14,7,3,2017,16,13111,2964,16075
1,14,7,3,2017,17,12696,2983,15679
1,14,7,3,2017,18,13046,2947,15993
1,14,7,3,2017,19,13041,2814,15855
1,14,7,3,2017,20,13712,2795,16507
1,14,7,3,2017,21,13865,2695,16560
1,14,7,3,2017,22,13251,2485,15736
1,14,7,3,2017,23,12697,2399,15096
1,14,7,3,2017,24,12577,2298,14875
2,15,7,3,2017,1,12430,2160,14590
2,15,7,3,2017,2,12192,2037,14229
2,15,7,3,2017,3,12222,1899,14121
2,15,7,3,2017,4,12139,1832,13971
2,15,7,3,2017,5,12602,1809,14411
2,15,7,3,2017,6,13376,1888,15264
2,15,7,3,2017,7,14377,1973,16350
2,15,7,3,2017,8,14780,2124,16904
2,15,7,3,2017,9,14722,2311,17033
2,15,7,3,2017,10,14085,2611,16696
2,15,7,3,2017,11,13786,2843,16629
2,15,7,3,2017,12,13940,2896,16836
2,15,7,3,2017,13,13878,2864,16742
2,15,7,3,2017,14,13458,2714,16172
2,15,7,3,2017,15,13627,2656,16283
2,15,7,3,2017,16,13547,2645,16192
2,15,7,3,2017,17,13104,2624,15728
2,15,7,3,2017,18,12860,2596,15456
2,15,7,3,2017,19,12412,2560,14972
2,15,7,3,2017,20,13995,2567,16562
2,15,7,3,2017,21,13505,2532,16037
2,15,7,3,2017,22,13402,2403,15805
2,15,7,3,2017,23,13005,2298,15303
2,15,7,3,2017,24,12632,2248,14880
2,16,7,3,2017,1,12440,2096,14536
2,16,7,3,2017,2,12486,1931,14417
2,16,7,3,2017,3,12323,1832,14155
2,16,7,3,2017,4,12325,1771,14096
2,16,7,3,2017,5,12518,1755,14273
2,16,7,3,2017,6,13237,1819,15056
2,16,7,3,2017,7,14137,1820,15957
2,16,7,3,2017,8,14250,1909,16159
2,16,7,3,2017,9,14867,2005,16872
2,16,7,3,2017,10,14260,2131,16391
2,16,7,3,2017,11,14107,2246,16353
2,16,7,3,2017,12,14318,2282,16600
2,16,7,3,2017,13,13694,2264,15958
2,16,7,3,2017,14,13545,2206,15751
2,16,7,3,2017,15,13221,2140,15361
2,16,7,3,2017,16,13033,2101,15134
2,16,7,3,2017,17,12700,2070,14770
2,16,7,3,2017,18,12396,2061,14457
2,16,7,3,2017,19,12577,2101,14678
2,16,7,3,2017,20,13256,2257,15513
2,16,7,3,2017,21,13587,2318,15905
2,16,7,3,2017,22,12881,2308,15189
2,16,7,3,2017,23,12720,2264,14984
2,16,7,3,2017,24,12655,2125,14780
1,17,7,3,2017,1,12221,2022,14243
1,17,7,3,2017,2,12043,1872,13915
1,17,7,3,2017,3,11962,1762,13724
1,17,7,3,2017,4,11987,1686,13673
1,17,7,3,2017,5,12268,1691,13959
1,17,7,3,2017,6,12794,1804,14598
1,17,7,3,2017,7,13770,1923,15693
1,17,7,3,2017,8,14168,2146,16314
1,17,7,3,2017,9,14295,2396,16691
1,17,7,3,2017,10,13769,2813,16582
1,17,7,3,2017,11,13839,2933,16772
1,17,7,3,2017,12,13967,3000,16967
1,17,7,3,2017,13,13766,2949,16715
1,17,7,3,2017,14,13516,2855,16371
1,17,7,3,2017,15,13679,2801,16480
1,17,7,3,2017,16,13548,2798,16346
1,17,7,3,2017,17,13416,2764,16180
1,17,7,3,2017,18,13146,2737,15883
1,17,7,3,2017,19,13278,2663,15941
1,17,7,3,2017,20,13913,2604,16517
1,17,7,3,2017,21,13902,2504,16406
1,17,7,3,2017,22,13097,2346,15443
1,17,7,3,2017,23,12735,2235,14970
1,17,7,3,2017,24,12234,2120,14354
1,18,7,3,2017,1,12100,1887,13987
1,18,7,3,2017,2,12051,1754,13805
1,18,7,3,2017,3,11691,1675,13366
1,18,7,3,2017,4,11722,1634,13356
1,18,7,3,2017,5,12210,1636,13846
1,18,7,3,2017,6,13133,1760,14893
1,18,7,3,2017,7,13946,1970,15916
1,18,7,3,2017,8,14615,2157,16772
1,18,7,3,2017,9,14640,2419,17059
1,18,7,3,2017,10,13925,2743,16668
1,18,7,3,2017,11,13830,2950,16780
1,18,7,3,2017,12,14133,3000,17133
1,18,7,3,2017,13,13564,2880,16444
1,18,7,3,2017,14,13680,2768,16448
1,18,7,3,2017,15,13448,2765,16213
1,18,7,3,2017,16,13357,2744,16101
1,18,7,3,2017,17,13121,2709,15830
1,18,7,3,2017,18,12941,2678,15619
1,18,7,3,2017,19,13328,2639,15967
1,18,7,3,2017,20,13849,2645,16494
1,18,7,3,2017,21,13591,2587,16178
1,18,7,3,2017,22,13264,2417,15681
1,18,7,3,2017,23,12862,2281,15143
1,18,7,3,2017,24,12240,2136,14376
1,19,7,3,2017,1,12057,1903,13960
1,19,7,3,2017,2,11880,1765,13645
1,19,7,3,2017,3,11841,1681,13522
1,19,7,3,2017,4,11779,1632,13411
1,19,7,3,2017,5,11980,1634,13614
1,19,7,3,2017,6,12654,1746,14400
1,19,7,3,2017,7,13860,1890,15750
1,19,7,3,2017,8,14466,2141,16607
1,19,7,3,2017,9,14607,2422,17029
1,19,7,3,2017,10,14124,2781,16905
1,19,7,3,2017,11,13572,3019,16591
1,19,7,3,2017,12,13525,3047,16572
1,19,7,3,2017,13,12973,2963,15936
1,19,7,3,2017,14,13121,2871,15992
1,19,7,3,2017,15,13060,2809,15869
1,19,7,3,2017,16,12603,2768,15371
1,19,7,3,2017,17,12708,2746,15454
1,19,7,3,2017,18,12612,2722,15334
1,19,7,3,2017,19,13457,2672,16129
1,19,7,3,2017,20,13698,2705,16403
1,19,7,3,2017,21,13870,2677,16547
1,19,7,3,2017,22,13377,2459,15836
1,19,7,3,2017,23,12735,2354,15089
1,19,7,3,2017,24,12249,2189,14438
1,20,7,3,2017,1,12136,2000,14136
1,20,7,3,2017,2,11747,1844,13591
1,20,7,3,2017,3,11828,1758,13586
1,20,7,3,2017,4,11509,1706,13215
1,20,7,3,2017,5,12122,1704,13826
1,20,7,3,2017,6,12495,1794,14289
1,20,7,3,2017,7,13568,2000,15568
1,20,7,3,2017,8,13742,2144,15886
1,20,7,3,2017,9,13639,2549,16188
1,20,7,3,2017,10,13482,2809,16291
1,20,7,3,2017,11,13177,3017,16194
1,20,7,3,2017,12,12906,3020,15926
1,20,7,3,2017,13,12512,2963,15475
1,20,7,3,2017,14,12290,2815,15105
1,20,7,3,2017,15,12091,2858,14949
1,20,7,3,2017,16,12385,2828,15213
1,20,7,3,2017,17,12373,2813,15186
1,20,7,3,2017,18,12321,2776,15097
1,20,7,3,2017,19,12859,2719,15578
1,20,7,3,2017,20,13611,2704,16315
1,20,7,3,2017,21,13548,2608,16156
1,20,7,3,2017,22,12807,2498,15305
1,20,7,3,2017,23,12610,2342,14952
1,20,7,3,2017,24,12287,2235,14522
1,21,7,3,2017,1,12287,1978,14265
1,21,7,3,2017,2,11868,1832,13700
1,21,7,3,2017,3,11776,1746,13522
1,21,7,3,2017,4,11603,1690,13293
1,21,7,3,2017,5,11754,1694,13448
1,21,7,3,2017,6,12586,1802,14388
1,21,7,3,2017,7,13378,2010,15388
1,21,7,3,2017,8,13744,2175,15919
1,21,7,3,2017,9,13246,2579,15825
1,21,7,3,2017,10,12874,2788,15662
1,21,7,3,2017,11,12491,3050,15541
1,21,7,3,2017,12,12243,3084,15327
1,21,7,3,2017,13,11950,3025,14975
1,21,7,3,2017,14,11566,2879,14445
1,21,7,3,2017,15,11497,2900,14397
1,21,7,3,2017,16,11647,2884,14531
1,21,7,3,2017,17,11732,2866,14598
1,21,7,3,2017,18,11698,2816,14514
1,21,7,3,2017,19,12378,2764,15142
1,21,7,3,2017,20,13363,2744,16107
1,21,7,3,2017,21,13454,2656,16110
1,21,7,3,2017,22,13116,2414,15530
1,21,7,3,2017,23,12529,2425,14954
1,21,7,3,2017,24,12155,2095,14250
2,22,7,3,2017,1,12047,1978,14025
2,22,7,3,2017,2,11607,1827,13434
2,22,7,3,2017,3,11444,1757,13201
2,22,7,3,2017,4,11466,1691,13157
2,22,7,3,2017,5,11682,1683,13365
2,22,7,3,2017,6,12488,1760,14248
2,22,7,3,2017,7,13177,1836,15013
2,22,7,3,2017,8,13537,1991,15528
2,22,7,3,2017,9,13746,2202,15948
2,22,7,3,2017,10,13158,2545,15703
2,22,7,3,2017,11,13100,2701,15801
2,22,7,3,2017,12,12750,2769,15519
2,22,7,3,2017,13,12573,2750,15323
2,22,7,3,2017,14,12240,2572,14812
2,22,7,3,2017,15,12335,2592,14927
2,22,7,3,2017,16,12255,2594,14849
2,22,7,3,2017,17,12259,2580,14839
2,22,7,3,2017,18,12163,2551,14714
2,22,7,3,2017,19,12735,2533,15268
2,22,7,3,2017,20,13453,2575,16028
2,22,7,3,2017,21,13711,2605,16316
2,22,7,3,2017,22,13125,2384,15509
2,22,7,3,2017,23,12968,2302,15270
2,22,7,3,2017,24,12399,2123,14522
2,23,7,3,2017,1,12147,2026,14173
2,23,7,3,2017,2,11880,1878,13758
2,23,7,3,2017,3,11709,1774,13483
2,23,7,3,2017,4,11864,1707,13571
2,23,7,3,2017,5,12005,1684,13689
2,23,7,3,2017,6,12573,1741,14314
2,23,7,3,2017,7,13163,1777,14940
2,23,7,3,2017,8,13612,1878,15490
2,23,7,3,2017,9,13735,1976,15711
2,23,7,3,2017,10,13406,2106,15512
2,23,7,3,2017,11,13232,2245,15477
2,23,7,3,2017,12,13458,2303,15761
2,23,7,3,2017,13,12810,2269,15079
2,23,7,3,2017,14,12590,2217,14807
2,23,7,3,2017,15,12478,2128,14606
2,23,7,3,2017,16,12122,2108,14230
2,23,7,3,2017,17,12169,2061,14230
2,23,7,3,2017,18,11957,2090,14047
2,23,7,3,2017,19,12425,2146,14571
2,23,7,3,2017,20,13237,2278,15515
2,23,7,3,2017,21,12978,2316,15294
2,23,7,3,2017,22,12829,2297,15126
2,23,7,3,2017,23,12403,2260,14663
2,23,7,3,2017,24,12161,2156,14317
1,24,7,3,2017,1,11922,2007,13929
1,24,7,3,2017,2,11879,1843,13722
1,24,7,3,2017,3,11743,1752,13495
1,24,7,3,2017,4,11805,1703,13508
1,24,7,3,2017,5,12103,1700,13803
1,24,7,3,2017,6,12848,1824,14672
1,24,7,3,2017,7,13834,1988,15822
1,24,7,3,2017,8,13865,2179,16044
1,24,7,3,2017,9,14252,2595,16847
1,24,7,3,2017,10,13860,2833,16693
1,24,7,3,2017,11,13329,3088,16417
1,24,7,3,2017,12,13489,3126,16615
1,24,7,3,2017,13,13048,3055,16103
1,24,7,3,2017,14,12920,2961,15881
1,24,7,3,2017,15,12797,2976,15773
1,24,7,3,2017,16,13083,2948,16031
1,24,7,3,2017,17,12666,2916,15582
1,24,7,3,2017,18,12565,2863,15428
1,24,7,3,2017,19,12809,2769,15578
1,24,7,3,2017,20,13460,2760,16220
1,24,7,3,2017,21,13594,2623,16217
1,24,7,3,2017,22,12988,2539,15527
1,24,7,3,2017,23,12924,2409,15333
1,24,7,3,2017,24,12496,2285,14781
1,25,7,3,2017,1,12364,2089,14453
1,25,7,3,2017,2,12087,1913,14000
1,25,7,3,2017,3,12063,1815,13878
1,25,7,3,2017,4,11839,1758,13597
1,25,7,3,2017,5,12539,1771,14310
1,25,7,3,2017,6,12892,1845,14737
1,25,7,3,2017,7,14418,2072,16490
1,25,7,3,2017,8,14514,2242,16756
1,25,7,3,2017,9,14552,2610,17162
1,25,7,3,2017,10,14006,2843,16849
1,25,7,3,2017,11,13460,3114,16574
1,25,7,3,2017,12,13510,3125,16635
1,25,7,3,2017,13,13354,3024,16378
1,25,7,3,2017,14,13322,2923,16245
1,25,7,3,2017,15,13152,2952,16104
1,25,7,3,2017,16,13337,2959,16296
1,25,7,3,2017,17,13153,2955,16108
1,25,7,3,2017,18,12953,2894,15847
1,25,7,3,2017,19,13575,2786,16361
1,25,7,3,2017,20,14221,2793,17014
1,25,7,3,2017,21,14238,2734,16972
1,25,7,3,2017,22,13535,2562,16097
1,25,7,3,2017,23,13088,2469,15557
1,25,7,3,2017,24,12494,2295,14789
1,26,7,3,2017,1,12870,2115,14985
1,26,7,3,2017,2,12552,1942,14494
1,26,7,3,2017,3,12228,1846,14074
1,26,7,3,2017,4,12354,1793,14147
1,26,7,3,2017,5,12565,1795,14360
1,26,7,3,2017,6,13824,1901,15725
1,26,7,3,2017,7,14811,2060,16871
1,26,7,3,2017,8,15024,2319,17343
1,26,7,3,2017,9,15485,2581,18066
1,26,7,3,2017,10,14498,2918,17416
1,26,7,3,2017,11,14179,3084,17263
1,26,7,3,2017,12,14008,3110,17118
1,26,7,3,2017,13,13895,3086,16981
1,26,7,3,2017,14,13775,2961,16736
1,26,7,3,2017,15,13643,2980,16623
1,26,7,3,2017,16,13570,2986,16556
1,26,7,3,2017,17,13454,2964,16418
1,26,7,3,2017,18,13363,2914,16277
1,26,7,3,2017,19,13510,2818,16328
1,26,7,3,2017,20,14368,2814,17182
1,26,7,3,2017,21,14753,2718,17471
1,26,7,3,2017,22,13525,2589,16114
1,26,7,3,2017,23,13336,2468,15804
1,26,7,3,2017,24,13018,2363,15381
1,27,7,3,2017,1,13084,2141,15225
1,27,7,3,2017,2,12894,1962,14856
1,27,7,3,2017,3,12608,1860,14468
1,27,7,3,2017,4,12749,1793,14542
1,27,7,3,2017,5,12980,1787,14767
1,27,7,3,2017,6,13735,1907,15642
1,27,7,3,2017,7,14513,2049,16562
1,27,7,3,2017,8,14937,2291,17228
1,27,7,3,2017,9,15278,2544,17822
1,27,7,3,2017,10,14804,2930,17734
1,27,7,3,2017,11,14560,3073,17633
1,27,7,3,2017,12,14360,3122,17482
1,27,7,3,2017,13,14146,3068,17214
1,27,7,3,2017,14,13741,2914,16655
1,27,7,3,2017,15,14043,2940,16983
1,27,7,3,2017,16,14024,2952,16976
1,27,7,3,2017,17,13434,2933,16367
1,27,7,3,2017,18,13002,2894,15896
1,27,7,3,2017,19,13053,2813,15866
1,27,7,3,2017,20,13563,2783,16346
1,27,7,3,2017,21,13534,2669,16203
1,27,7,3,2017,22,13242,2574,15816
1,27,7,3,2017,23,12991,2429,15420
1,27,7,3,2017,24,12927,2350,15277
1,28,7,3,2017,1,12928,2136,15064
1,28,7,3,2017,2,12512,1956,14468
1,28,7,3,2017,3,12272,1843,14115
1,28,7,3,2017,4,12475,1786,14261
1,28,7,3,2017,5,12802,1778,14580
1,28,7,3,2017,6,13366,1899,15265
1,28,7,3,2017,7,14715,2071,16786
1,28,7,3,2017,8,15153,2272,17425
1,28,7,3,2017,9,14925,2694,17619
1,28,7,3,2017,10,14523,2919,17442
1,28,7,3,2017,11,14091,3140,17231
1,28,7,3,2017,12,13627,3189,16816
1,28,7,3,2017,13,13519,3120,16639
1,28,7,3,2017,14,13192,2992,16184
1,28,7,3,2017,15,13137,2984,16121
1,28,7,3,2017,16,12913,2943,15856
1,28,7,3,2017,17,12749,2908,15657
1,28,7,3,2017,18,12526,2859,15385
1,28,7,3,2017,19,13035,2807,15842
1,28,7,3,2017,20,13836,2803,16639
1,28,7,3,2017,21,13690,2691,16381
1,28,7,3,2017,22,13361,2566,15927
1,28,7,3,2017,23,13059,2408,15467
1,28,7,3,2017,24,12620,2332,14952
2,29,7,3,2017,1,12874,2130,15004
2,29,7,3,2017,2,12594,1988,14582
2,29,7,3,2017,3,12394,1870,14264
2,29,7,3,2017,4,12359,1809,14168
2,29,7,3,2017,5,12623,1805,14428
2,29,7,3,2017,6,13733,1879,15612
2,29,7,3,2017,7,14598,1981,16579
2,29,7,3,2017,8,14898,2120,17018
2,29,7,3,2017,9,15091,2444,17535
2,29,7,3,2017,10,14636,2683,17319
2,29,7,3,2017,11,14314,2954,17268
2,29,7,3,2017,12,14648,3016,17664
2,29,7,3,2017,13,14228,2979,17207
2,29,7,3,2017,14,13991,2963,16954
2,29,7,3,2017,15,14107,2786,16893
2,29,7,3,2017,16,14087,2806,16893
2,29,7,3,2017,17,14128,2790,16918
2,29,7,3,2017,18,13549,2745,16294
2,29,7,3,2017,19,13614,2686,16300
2,29,7,3,2017,20,14157,2601,16758
2,29,7,3,2017,21,14389,2667,17056
2,29,7,3,2017,22,13724,2599,16323
2,29,7,3,2017,23,13573,2440,16013
2,29,7,3,2017,24,13426,2228,15654
2,30,7,3,2017,1,13251,2181,15432
2,30,7,3,2017,2,12880,2037,14917
2,30,7,3,2017,3,12842,1903,14745
2,30,7,3,2017,4,12990,1817,14807
2,30,7,3,2017,5,13007,1810,14817
2,30,7,3,2017,6,13706,1863,15569
2,30,7,3,2017,7,14478,1890,16368
2,30,7,3,2017,8,15046,1980,17026
2,30,7,3,2017,9,15392,2066,17458
2,30,7,3,2017,10,14765,2245,17010
2,30,7,3,2017,11,14589,2328,16917
2,30,7,3,2017,12,15123,2350,17473
2,30,7,3,2017,13,15023,2317,17340
2,30,7,3,2017,14,14608,2254,16862
2,30,7,3,2017,15,14412,2244,16656
2,30,7,3,2017,16,14756,2176,16932
2,30,7,3,2017,17,13847,2147,15994
2,30,7,3,2017,18,13441,2115,15556
2,30,7,3,2017,19,13462,2147,15609
2,30,7,3,2017,20,13994,2309,16303
2,30,7,3,2017,21,14179,2362,16541
2,30,7,3,2017,22,13968,2325,16293
2,30,7,3,2017,23,13511,2311,15822
2,30,7,3,2017,24,13403,2213,15616
1,31,7,3,2017,1,13409,2104,15513
1,31,7,3,2017,2,13233,1940,15173
1,31,7,3,2017,3,12978,1825,14803
1,31,7,3,2017,4,12892,1754,14646
1,31,7,3,2017,5,13444,1750,15194
1,31,7,3,2017,6,14124,1867,15991
1,31,7,3,2017,7,15382,2016,17398
1,31,7,3,2017,8,15683,2271,17954
1,31,7,3,2017,9,15603,2477,18080
1,31,7,3,2017,10,15387,2920,18307
1,31,7,3,2017,11,15304,3110,18414
1,31,7,3,2017,12,15432,3107,18539
1,31,7,3,2017,13,15494,3057,18551
1,31,7,3,2017,14,15468,2970,18438
1,31,7,3,2017,15,15477,2991,18468
1,31,7,3,2017,16,15423,3009,18432
1,31,7,3,2017,17,15133,2998,18131
1,31,7,3,2017,18,14170,2895,17065
1,31,7,3,2017,19,13678,2778,16456
1,31,7,3,2017,20,14675,2775,17450
1,31,7,3,2017,21,14716,2702,17418
1,31,7,3,2017,22,14239,2557,16796
1,31,7,3,2017,23,14006,2444,16450
1,31,7,3,2017,24,13842,2263,16105
1,1,8,3,2017,1,13741,2120,15861
1,1,8,3,2017,2,13733,1930,15663
1,1,8,3,2017,3,13398,1841,15239
1,1,8,3,2017,4,13425,1779,15204
1,1,8,3,2017,5,13715,1776,15491
1,1,8,3,2017,6,14294,1891,16185
1,1,8,3,2017,7,15551,2047,17598
1,1,8,3,2017,8,15822,2262,18084
1,1,8,3,2017,9,15997,2677,18674
1,1,8,3,2017,10,15621,2855,18476
1,1,8,3,2017,11,15424,3124,18548
1,1,8,3,2017,12,15731,3134,18865
1,1,8,3,2017,13,15518,3082,18600
1,1,8,3,2017,14,15704,2957,18661
1,1,8,3,2017,15,15367,3022,18389
1,1,8,3,2017,16,15372,2983,18355
1,1,8,3,2017,17,15414,2937,18351
1,1,8,3,2017,18,14475,2856,17331
1,1,8,3,2017,19,14202,2807,17009
1,1,8,3,2017,20,14748,2780,17528
1,1,8,3,2017,21,14865,2732,17597
1,1,8,3,2017,22,14369,2642,17011
1,1,8,3,2017,23,14134,2503,16637
1,1,8,3,2017,24,13999,2387,16386
1,2,8,3,2017,1,13948,2152,16100
1,2,8,3,2017,2,13799,1970,15769
1,2,8,3,2017,3,13646,1880,15526
1,2,8,3,2017,4,13643,1798,15441
1,2,8,3,2017,5,13863,1798,15661
1,2,8,3,2017,6,14525,1882,16407
1,2,8,3,2017,7,15612,2093,17705
1,2,8,3,2017,8,16233,2234,18467
1,2,8,3,2017,9,16307,2644,18951
1,2,8,3,2017,10,15851,2901,18752
1,2,8,3,2017,11,15648,3106,18754
1,2,8,3,2017,12,16057,3138,19195
1,2,8,3,2017,13,15799,3131,18930
1,2,8,3,2017,14,15585,2988,18573
1,2,8,3,2017,15,15701,3028,18729
1,2,8,3,2017,16,15561,3030,18591
1,2,8,3,2017,17,15275,3014,18289
1,2,8,3,2017,18,14563,2904,17467
1,2,8,3,2017,19,14570,2850,17420
1,2,8,3,2017,20,14637,2828,17465
1,2,8,3,2017,21,15070,2748,17818
1,2,8,3,2017,22,14396,2602,16998
1,2,8,3,2017,23,14275,2444,16719
1,2,8,3,2017,24,13931,2342,16273
1,4,8,3,2017,1,13850,2176,16026
1,4,8,3,2017,2,13887,2008,15895
1,4,8,3,2017,3,13534,1891,15425
1,4,8,3,2017,4,13518,1825,15343
1,4,8,3,2017,5,13961,1812,15773
1,4,8,3,2017,6,14726,1925,16651
1,4,8,3,2017,7,15735,2073,17808
1,4,8,3,2017,8,16273,2300,18573
1,4,8,3,2017,9,16256,2609,18865
1,4,8,3,2017,10,15533,2946,18479
1,4,8,3,2017,11,15165,3170,18335
1,4,8,3,2017,12,15609,3215,18824
1,4,8,3,2017,13,15097,3196,18293
1,4,8,3,2017,14,15221,3107,18328
1,4,8,3,2017,15,15098,3092,18190
1,4,8,3,2017,16,15247,3096,18343
1,4,8,3,2017,17,14493,3075,17568
1,4,8,3,2017,18,14350,2964,17314
1,4,8,3,2017,19,14090,2891,16981
1,4,8,3,2017,20,14786,2884,17670
1,4,8,3,2017,21,14881,2769,17650
1,4,8,3,2017,22,14499,2648,17147
1,4,8,3,2017,23,14278,2560,16838
1,4,8,3,2017,24,14129,2467,16596
2,5,8,3,2017,1,14452,2215,16667
2,5,8,3,2017,2,14161,2057,16218
2,5,8,3,2017,3,13832,1946,15778
2,5,8,3,2017,4,13950,1880,15830
2,5,8,3,2017,5,14190,1859,16049
2,5,8,3,2017,6,14940,1925,16865
2,5,8,3,2017,7,16042,2047,18089
2,5,8,3,2017,8,16320,2159,18479
2,5,8,3,2017,9,16628,2514,19142
2,5,8,3,2017,10,15969,2711,18680
2,5,8,3,2017,11,15887,3013,18900
2,5,8,3,2017,12,16584,3047,19631
2,5,8,3,2017,13,16433,3042,19475
2,5,8,3,2017,14,16424,2899,19323
2,5,8,3,2017,15,16255,2910,19165
2,5,8,3,2017,16,16527,2918,19445
2,5,8,3,2017,17,16065,2882,18947
2,5,8,3,2017,18,15448,2801,18249
2,5,8,3,2017,19,14919,2696,17615
2,5,8,3,2017,20,15188,2742,17930
2,5,8,3,2017,21,15312,2708,18020
2,5,8,3,2017,22,14800,2557,17357
2,5,8,3,2017,23,14722,2500,17222
2,5,8,3,2017,24,14372,2385,16757
2,6,8,3,2017,1,14906,2308,17214
2,6,8,3,2017,2,14744,2110,16854
2,6,8,3,2017,3,14449,1984,16433
2,6,8,3,2017,4,14577,1907,16484
2,6,8,3,2017,5,14763,1875,16638
2,6,8,3,2017,6,15208,1921,17129
2,6,8,3,2017,7,16092,1946,18038
2,6,8,3,2017,8,16480,2025,18505
2,6,8,3,2017,9,16735,2108,18843
2,6,8,3,2017,10,16221,2292,18513
2,6,8,3,2017,11,16131,2373,18504
2,6,8,3,2017,12,16582,2412,18994
2,6,8,3,2017,13,16743,2383,19126
2,6,8,3,2017,14,16363,2339,18702
2,6,8,3,2017,15,16480,2310,18790
2,6,8,3,2017,16,16214,2313,18527
2,6,8,3,2017,17,15696,2271,17967
2,6,8,3,2017,18,14915,2190,17105
2,6,8,3,2017,19,14368,2175,16543
2,6,8,3,2017,20,14785,2354,17139
2,6,8,3,2017,21,14844,2417,17261
2,6,8,3,2017,22,14366,2392,16758
2,6,8,3,2017,23,14417,2355,16772
2,6,8,3,2017,24,14291,2337,16628
1,7,8,3,2017,1,14548,2252,16800
1,7,8,3,2017,2,14533,2098,16631
1,7,8,3,2017,3,14086,1973,16059
1,7,8,3,2017,4,14160,1899,16059
1,7,8,3,2017,5,14605,1885,16490
1,7,8,3,2017,6,15076,1959,17035
1,7,8,3,2017,7,16128,2031,18159
1,7,8,3,2017,8,16445,2257,18702
1,7,8,3,2017,9,17047,2477,19524
1,7,8,3,2017,10,16123,2763,18886
1,7,8,3,2017,11,15974,2963,18937
1,7,8,3,2017,12,16266,2965,19231
1,7,8,3,2017,13,16388,2936,19324
1,7,8,3,2017,14,16338,2819,19157
1,7,8,3,2017,15,16140,2844,18984
1,7,8,3,2017,16,16172,2803,18975
1,7,8,3,2017,17,15349,2748,18097
1,7,8,3,2017,18,14590,2679,17269
1,7,8,3,2017,19,14086,2551,16637
1,7,8,3,2017,20,14138,2618,16756
1,7,8,3,2017,21,14292,2606,16898
1,7,8,3,2017,22,14272,2532,16804
1,7,8,3,2017,23,14208,2494,16702
1,7,8,3,2017,24,14133,2426,16559
1,8,8,3,2017,1,14445,2245,16690
1,8,8,3,2017,2,14135,2076,16211
1,8,8,3,2017,3,14198,1952,16150
1,8,8,3,2017,4,14122,1879,16001
1,8,8,3,2017,5,14421,1874,16295
1,8,8,3,2017,6,15148,1970,17118
1,8,8,3,2017,7,16284,2120,18404
1,8,8,3,2017,8,16948,2358,19306
1,8,8,3,2017,9,16955,2555,19510
1,8,8,3,2017,10,16345,2970,19315
1,8,8,3,2017,11,16567,3139,19706
1,8,8,3,2017,12,16745,3229,19974
1,8,8,3,2017,13,16424,3213,19637
1,8,8,3,2017,14,16562,3084,19646
1,8,8,3,2017,15,16568,3130,19698
1,8,8,3,2017,16,16801,3139,19940
1,8,8,3,2017,17,16257,3119,19376
1,8,8,3,2017,18,15714,3046,18760
1,8,8,3,2017,19,14877,2945,17822
1,8,8,3,2017,20,15587,2923,18510
1,8,8,3,2017,21,15034,2844,17878
1,8,8,3,2017,22,15062,2679,17741
1,8,8,3,2017,23,14467,2604,17071
1,8,8,3,2017,24,14870,2513,17383
1,9,8,3,2017,1,14757,2350,17107
1,9,8,3,2017,2,14850,2106,16956
1,9,8,3,2017,3,14680,1993,16673
1,9,8,3,2017,4,15103,1906,17009
1,9,8,3,2017,5,15094,1878,16972
1,9,8,3,2017,6,15873,2028,17901
1,9,8,3,2017,7,16765,2118,18883
1,9,8,3,2017,8,17085,2227,19312
1,9,8,3,2017,9,16683,2621,19304
1,9,8,3,2017,10,16481,2948,19429
1,9,8,3,2017,11,16261,3170,19431
1,9,8,3,2017,12,16566,3235,19801
1,9,8,3,2017,13,16622,3191,19813
1,9,8,3,2017,14,16653,3088,19741
1,9,8,3,2017,15,16833,3130,19963
1,9,8,3,2017,16,16656,3118,19774
1,9,8,3,2017,17,16112,3097,19209
1,9,8,3,2017,18,15640,3006,18646
1,9,8,3,2017,19,15009,2880,17889
1,9,8,3,2017,20,14769,2885,17654
1,9,8,3,2017,21,14583,2821,17404
1,9,8,3,2017,22,14538,2711,17249
1,9,8,3,2017,23,14177,2633,16810
1,9,8,3,2017,24,14514,2489,17003
1,10,8,3,2017,1,14585,2277,16862
1,10,8,3,2017,2,14567,2125,16692
1,10,8,3,2017,3,14280,1935,16215
1,10,8,3,2017,4,14361,1866,16227
1,10,8,3,2017,5,14548,1851,16399
1,10,8,3,2017,6,15550,1960,17510
1,10,8,3,2017,7,16482,2136,18618
1,10,8,3,2017,8,16835,2276,19111
1,10,8,3,2017,9,16836,2693,19529
1,10,8,3,2017,10,16650,2898,19548
1,10,8,3,2017,11,16423,3155,19578
1,10,8,3,2017,12,16474,3207,19681
1,10,8,3,2017,13,16465,3172,19637
1,10,8,3,2017,14,16223,3000,19223
1,10,8,3,2017,15,16336,3033,19369
1,10,8,3,2017,16,16764,3080,19844
1,10,8,3,2017,17,16562,3048,19610
1,10,8,3,2017,18,15750,3014,18764
1,10,8,3,2017,19,15340,2873,18213
1,10,8,3,2017,20,15473,2899,18372
1,10,8,3,2017,21,14933,2798,17731
1,10,8,3,2017,22,14824,2694,17518
1,10,8,3,2017,23,14498,2592,17090
1,10,8,3,2017,24,14736,2481,17217
1,11,8,3,2017,1,14788,2299,17087
1,11,8,3,2017,2,14911,2076,16987
1,11,8,3,2017,3,14515,1960,16475
1,11,8,3,2017,4,14755,1895,16650
1,11,8,3,2017,5,14807,1874,16681
1,11,8,3,2017,6,15727,2023,17750
1,11,8,3,2017,7,16628,2135,18763
1,11,8,3,2017,8,17124,2330,19454
1,11,8,3,2017,9,17142,2613,19755
1,11,8,3,2017,10,16153,3018,19171
1,11,8,3,2017,11,16316,3141,19457
1,11,8,3,2017,12,16549,3261,19810
1,11,8,3,2017,13,16972,3180,20152
1,11,8,3,2017,14,16613,3075,19688
1,11,8,3,2017,15,16528,3137,19665
1,11,8,3,2017,16,16707,3134,19841
1,11,8,3,2017,17,15668,3111,18779
1,11,8,3,2017,18,15025,3018,18043
1,11,8,3,2017,19,14546,2897,17443
1,11,8,3,2017,20,15125,2907,18032
1,11,8,3,2017,21,15336,2836,18172
1,11,8,3,2017,22,14646,2655,17301
1,11,8,3,2017,23,14581,2593,17174
1,11,8,3,2017,24,14519,2495,17014
2,12,8,3,2017,1,15181,2370,17551
2,12,8,3,2017,2,14938,2137,17075
2,12,8,3,2017,3,14682,1997,16679
2,12,8,3,2017,4,14914,1923,16837
2,12,8,3,2017,5,15168,1898,17066
2,12,8,3,2017,6,16297,1950,18247
2,12,8,3,2017,7,16205,2007,18212
2,12,8,3,2017,8,16197,2137,18334
2,12,8,3,2017,9,16237,2329,18566
2,12,8,3,2017,10,15604,2600,18204
2,12,8,3,2017,11,16088,2863,18951
2,12,8,3,2017,12,16536,2924,19460
2,12,8,3,2017,13,16848,2915,19763
2,12,8,3,2017,14,16798,2796,19594
2,12,8,3,2017,15,16514,2788,19302
2,12,8,3,2017,16,16823,2801,19624
2,12,8,3,2017,17,16239,2775,19014
2,12,8,3,2017,18,16111,2728,18839
2,12,8,3,2017,19,15180,2679,17859
2,12,8,3,2017,20,15582,2752,18334
2,12,8,3,2017,21,16022,2708,18730
2,12,8,3,2017,22,15372,2541,17913
2,12,8,3,2017,23,15034,2457,17491
2,12,8,3,2017,24,15171,2387,17558
2,13,8,3,2017,1,15281,2483,17764
2,13,8,3,2017,2,15178,2086,17264
2,13,8,3,2017,3,14715,1975,16690
2,13,8,3,2017,4,14840,1918,16758
2,13,8,3,2017,5,15126,1910,17036
2,13,8,3,2017,6,15779,1935,17714
2,13,8,3,2017,7,16610,1910,18520
2,13,8,3,2017,8,16919,1964,18883
2,13,8,3,2017,9,17325,2100,19425
2,13,8,3,2017,10,16608,2232,18840
2,13,8,3,2017,11,16622,2324,18946
2,13,8,3,2017,12,17402,2373,19775
2,13,8,3,2017,13,17133,2374,19507
2,13,8,3,2017,14,16998,2305,19303
2,13,8,3,2017,15,16910,2281,19191
2,13,8,3,2017,16,16725,2243,18968
2,13,8,3,2017,17,16196,2203,18399
2,13,8,3,2017,18,15136,2187,17323
2,13,8,3,2017,19,14981,2257,17238
2,13,8,3,2017,20,15161,2368,17529
2,13,8,3,2017,21,15010,2374,17384
2,13,8,3,2017,22,14750,2361,17111
2,13,8,3,2017,23,14521,2325,16846
2,13,8,3,2017,24,14722,2305,17027
1,14,8,3,2017,1,14940,2154,17094
1,14,8,3,2017,2,14569,1997,16566
1,14,8,3,2017,3,14349,1890,16239
1,14,8,3,2017,4,14524,1812,16336
1,14,8,3,2017,5,14720,1811,16531
1,14,8,3,2017,6,15722,1920,17642
1,14,8,3,2017,7,16733,2049,18782
1,14,8,3,2017,8,16782,2248,19030
1,14,8,3,2017,9,17104,2518,19622
1,14,8,3,2017,10,16358,2901,19259
1,14,8,3,2017,11,16313,3161,19474
1,14,8,3,2017,12,17312,3169,20481
1,14,8,3,2017,13,17420,3053,20473
1,14,8,3,2017,14,16856,2930,19786
1,14,8,3,2017,15,16906,2934,19840
1,14,8,3,2017,16,16733,2899,19632
1,14,8,3,2017,17,16114,2854,18968
1,14,8,3,2017,18,15182,2735,17917
1,14,8,3,2017,19,14777,2717,17494
1,14,8,3,2017,20,14871,2698,17569
1,14,8,3,2017,21,14599,2561,17160
1,14,8,3,2017,22,14210,2500,16710
1,14,8,3,2017,23,14178,2346,16524
1,14,8,3,2017,24,14235,2263,16498
3,15,8,3,2017,1,14418,2080,16498
3,15,8,3,2017,2,14096,1943,16039
3,15,8,3,2017,3,14069,1837,15906
3,15,8,3,2017,4,13757,1754,15511
3,15,8,3,2017,5,14455,1736,16191
3,15,8,3,2017,6,15112,1817,16929
3,15,8,3,2017,7,15796,1861,17657
3,15,8,3,2017,8,15336,1936,17272
3,15,8,3,2017,9,14940,2007,16947
3,15,8,3,2017,10,13813,2142,15955
3,15,8,3,2017,11,13852,2177,16029
3,15,8,3,2017,12,14438,2230,16668
3,15,8,3,2017,13,14355,2223,16578
3,15,8,3,2017,14,14248,2173,16421
3,15,8,3,2017,15,14017,2120,16137
3,15,8,3,2017,16,13943,2092,16035
3,15,8,3,2017,17,13366,2074,15440
3,15,8,3,2017,18,12957,2084,15041
3,15,8,3,2017,19,12752,2105,14857
3,15,8,3,2017,20,12898,2273,15171
3,15,8,3,2017,21,13079,2335,15414
3,15,8,3,2017,22,12872,2311,15183
3,15,8,3,2017,23,12765,2286,15051
3,15,8,3,2017,24,12865,2204,15069
1,16,8,3,2017,1,13212,2074,15286
1,16,8,3,2017,2,12670,1946,14616
1,16,8,3,2017,3,12800,1803,14603
1,16,8,3,2017,4,12789,1741,14530
1,16,8,3,2017,5,13029,1738,14767
1,16,8,3,2017,6,14397,1848,16245
1,16,8,3,2017,7,15385,2003,17388
1,16,8,3,2017,8,16130,2245,18375
1,16,8,3,2017,9,16455,2491,18946
1,16,8,3,2017,10,15940,2935,18875
1,16,8,3,2017,11,16135,3060,19195
1,16,8,3,2017,12,16761,3180,19941
1,16,8,3,2017,13,16848,3150,19998
1,16,8,3,2017,14,16687,3063,19750
1,16,8,3,2017,15,16536,3076,19612
1,16,8,3,2017,16,16723,3077,19800
1,16,8,3,2017,17,16414,3034,19448
1,16,8,3,2017,18,15626,2978,18604
1,16,8,3,2017,19,14875,2849,17724
1,16,8,3,2017,20,15644,2885,18529
1,16,8,3,2017,21,15469,2739,18208
1,16,8,3,2017,22,15103,2602,17705
1,16,8,3,2017,23,14613,2479,17092
1,16,8,3,2017,24,14867,2366,17233
3,17,8,3,2017,1,14933,2209,17142
3,17,8,3,2017,2,14489,2051,16540
3,17,8,3,2017,3,14378,1922,16300
3,17,8,3,2017,4,14351,1840,16191
3,17,8,3,2017,5,14653,1829,16482
3,17,8,3,2017,6,15539,1901,17440
3,17,8,3,2017,7,16413,1989,18402
3,17,8,3,2017,8,16511,2239,18750
3,17,8,3,2017,9,16816,2502,19318
3,17,8,3,2017,10,16497,2893,19390
3,17,8,3,2017,11,16683,3071,19754
3,17,8,3,2017,12,17066,3138,20204
3,17,8,3,2017,13,16958,3121,20079
3,17,8,3,2017,14,16990,2946,19936
3,17,8,3,2017,15,17266,2955,20221
3,17,8,3,2017,16,16845,2937,19782
3,17,8,3,2017,17,16427,2901,19328
3,17,8,3,2017,18,16125,2863,18988
3,17,8,3,2017,19,15754,2789,18543
3,17,8,3,2017,20,15792,2838,18630
3,17,8,3,2017,21,15501,2768,18269
3,17,8,3,2017,22,15309,2637,17946
3,17,8,3,2017,23,14970,2498,17468
3,17,8,3,2017,24,14940,2425,17365
1,18,8,3,2017,1,15178,2213,17391
1,18,8,3,2017,2,14800,2048,16848
1,18,8,3,2017,3,14618,1932,16550
1,18,8,3,2017,4,14613,1867,16480
1,18,8,3,2017,5,14914,1854,16768
1,18,8,3,2017,6,15559,1947,17506
1,18,8,3,2017,7,16890,2118,19008
1,18,8,3,2017,8,17591,2277,19868
1,18,8,3,2017,9,17343,2701,20044
1,18,8,3,2017,10,16594,2899,19493
1,18,8,3,2017,11,16374,3182,19556
1,18,8,3,2017,12,16613,3215,19828
1,18,8,3,2017,13,16545,3191,19736
1,18,8,3,2017,14,16361,3015,19376
1,18,8,3,2017,15,16182,3057,19239
1,18,8,3,2017,16,16216,3074,19290
1,18,8,3,2017,17,15482,3046,18528
1,18,8,3,2017,18,15312,2985,18297
1,18,8,3,2017,19,14963,2896,17859
1,18,8,3,2017,20,15392,2897,18289
1,18,8,3,2017,21,15222,2825,18047
1,18,8,3,2017,22,14599,2609,17208
1,18,8,3,2017,23,14525,2549,17074
1,18,8,3,2017,24,14334,2449,16783
2,19,8,3,2017,1,14363,2300,16663
2,19,8,3,2017,2,14236,2063,16299
2,19,8,3,2017,3,13979,1976,15955
2,19,8,3,2017,4,13584,1892,15476
2,19,8,3,2017,5,13811,1851,15662
2,19,8,3,2017,6,14411,1923,16334
2,19,8,3,2017,7,15173,2041,17214
2,19,8,3,2017,8,16136,2141,18277
2,19,8,3,2017,9,16082,2451,18533
2,19,8,3,2017,10,15594,2759,18353
2,19,8,3,2017,11,15614,2891,18505
2,19,8,3,2017,12,15591,2947,18538
2,19,8,3,2017,13,15520,2892,18412
2,19,8,3,2017,14,15373,2771,18144
2,19,8,3,2017,15,14766,2723,17489
2,19,8,3,2017,16,15193,2727,17920
2,19,8,3,2017,17,14673,2699,17372
2,19,8,3,2017,18,14120,2667,16787
2,19,8,3,2017,19,14285,2639,16924
2,19,8,3,2017,20,14684,2672,17356
2,19,8,3,2017,21,14107,2597,16704
2,19,8,3,2017,22,13678,2482,16160
2,19,8,3,2017,23,13099,2358,15457
2,19,8,3,2017,24,13096,2291,15387
2,20,8,3,2017,1,12777,2153,14930
2,20,8,3,2017,2,12344,1997,14341
2,20,8,3,2017,3,12029,1894,13923
2,20,8,3,2017,4,11987,1825,13812
2,20,8,3,2017,5,12145,1804,13949
2,20,8,3,2017,6,12246,1856,14102
2,20,8,3,2017,7,12635,1881,14516
2,20,8,3,2017,8,12602,1917,14519
2,20,8,3,2017,9,13098,2039,15137
2,20,8,3,2017,10,12653,2193,14846
2,20,8,3,2017,11,12849,2260,15109
2,20,8,3,2017,12,12743,2286,15029
2,20,8,3,2017,13,12206,2277,14483
2,20,8,3,2017,14,12053,2176,14229
2,20,8,3,2017,15,11799,2097,13896
2,20,8,3,2017,16,11902,2019,13921
2,20,8,3,2017,17,11578,1969,13547
2,20,8,3,2017,18,11924,1919,13843
2,20,8,3,2017,19,12356,2053,14409
2,20,8,3,2017,20,12925,2167,15092
2,20,8,3,2017,21,12728,2148,14876
2,20,8,3,2017,22,12198,2115,14313
2,20,8,3,2017,23,11773,2129,13902
2,20,8,3,2017,24,11434,1807,13241
1,21,8,3,2017,1,11186,1784,12970
1,21,8,3,2017,2,11060,1622,12682
1,21,8,3,2017,3,10946,1575,12521
1,21,8,3,2017,4,10981,1528,12509
1,21,8,3,2017,5,11421,1539,12960
1,21,8,3,2017,6,11851,1679,13530
1,21,8,3,2017,7,12923,1855,14778
1,21,8,3,2017,8,13342,2125,15467
1,21,8,3,2017,9,13629,2321,15950
1,21,8,3,2017,10,13257,2703,15960
1,21,8,3,2017,11,13032,2843,15875
1,21,8,3,2017,12,12993,2894,15887
1,21,8,3,2017,13,12552,2855,15407
1,21,8,3,2017,14,12552,2786,15338
1,21,8,3,2017,15,12507,2776,15283
1,21,8,3,2017,16,12399,2747,15146
1,21,8,3,2017,17,11981,2732,14713
1,21,8,3,2017,18,12160,2689,14849
1,21,8,3,2017,19,12681,2678,15359
1,21,8,3,2017,20,13579,2676,16255
1,21,8,3,2017,21,13309,2527,15836
1,21,8,3,2017,22,13090,2428,15518
1,21,8,3,2017,23,12719,2262,14981
1,21,8,3,2017,24,12156,2052,14208
1,22,8,3,2017,1,11864,1902,13766
1,22,8,3,2017,2,11611,1769,13380
1,22,8,3,2017,3,11489,1645,13134
1,22,8,3,2017,4,11423,1594,13017
1,22,8,3,2017,5,11789,1603,13392
1,22,8,3,2017,6,12750,1718,14468
1,22,8,3,2017,7,13540,1952,15492
1,22,8,3,2017,8,13793,2077,15870
1,22,8,3,2017,9,13716,2473,16189
1,22,8,3,2017,10,14107,2757,16864
1,22,8,3,2017,11,13462,2950,16412
1,22,8,3,2017,12,13255,3028,16283
1,22,8,3,2017,13,12946,2964,15910
1,22,8,3,2017,14,12841,2881,15722
1,22,8,3,2017,15,12856,2919,15774
1,22,8,3,2017,16,12802,2930,15732
1,22,8,3,2017,17,12905,2903,15808
1,22,8,3,2017,18,12926,2843,15769
1,22,8,3,2017,19,13517,2713,16230
1,22,8,3,2017,20,14414,2803,17217
1,22,8,3,2017,21,14372,2674,17046
1,22,8,3,2017,22,13951,2554,16505
1,22,8,3,2017,23,13371,2418,15789
1,22,8,3,2017,24,12974,2320,15294
1,23,8,3,2017,1,12554,2051,14605
1,23,8,3,2017,2,12191,1912,14103
1,23,8,3,2017,3,12176,1803,13979
1,23,8,3,2017,4,12013,1751,13764
1,23,8,3,2017,5,12263,1750,14013
1,23,8,3,2017,6,13428,1858,15286
1,23,8,3,2017,7,13962,2010,15972
1,23,8,3,2017,8,14362,2242,16604
1,23,8,3,2017,9,14610,2611,17221
1,23,8,3,2017,10,14160,2833,16993
1,23,8,3,2017,11,14399,3109,17508
1,23,8,3,2017,12,14305,3164,17469
1,23,8,3,2017,13,13987,3132,17119
1,23,8,3,2017,14,13832,2958,16790
1,23,8,3,2017,15,13955,3018,16973
1,23,8,3,2017,16,14340,3029,17369
1,23,8,3,2017,17,13974,2988,16962
1,23,8,3,2017,18,13402,2884,16286
1,23,8,3,2017,19,13700,2834,16534
1,23,8,3,2017,20,15187,2873,18060
1,23,8,3,2017,21,14622,2811,17433
1,23,8,3,2017,22,14724,2651,17375
1,23,8,3,2017,23,13837,2509,16346
1,23,8,3,2017,24,13576,2350,15926
1,24,8,3,2017,1,13341,2205,15546
1,24,8,3,2017,2,13043,2035,15078
1,24,8,3,2017,3,12970,1891,14861
1,24,8,3,2017,4,12756,1820,14576
1,24,8,3,2017,5,13092,1805,14897
1,24,8,3,2017,6,13998,1867,15865
1,24,8,3,2017,7,14778,2069,16847
1,24,8,3,2017,8,15078,2193,17271
1,24,8,3,2017,9,15163,2557,17720
1,24,8,3,2017,10,14530,2926,17456
1,24,8,3,2017,11,14392,3055,17447
1,24,8,3,2017,12,14244,3139,17383
1,24,8,3,2017,13,14294,3079,17373
1,24,8,3,2017,14,14050,2983,17033
1,24,8,3,2017,15,14020,3011,17031
1,24,8,3,2017,16,14003,3019,17022
1,24,8,3,2017,17,13622,2993,16615
1,24,8,3,2017,18,13425,2917,16342
1,24,8,3,2017,19,13880,2802,16682
1,24,8,3,2017,20,14784,2846,17630
1,24,8,3,2017,21,14822,2759,17581
1,24,8,3,2017,22,14178,2594,16772
1,24,8,3,2017,23,13758,2526,16284
1,24,8,3,2017,24,13456,2379,15835
3,25,8,3,2017,1,13122,2271,15393
3,25,8,3,2017,2,13068,2054,15122
3,25,8,3,2017,3,12911,1985,14896
3,25,8,3,2017,4,12702,1907,14609
3,25,8,3,2017,5,12848,1889,14737
3,25,8,3,2017,6,13659,1931,15590
3,25,8,3,2017,7,14299,1975,16274
3,25,8,3,2017,8,14514,2004,16518
3,25,8,3,2017,9,14426,2124,16550
3,25,8,3,2017,10,13559,2233,15792
3,25,8,3,2017,11,12976,2370,15346
3,25,8,3,2017,12,13270,2380,15650
3,25,8,3,2017,13,12997,2359,15356
3,25,8,3,2017,14,12495,2188,14683
3,25,8,3,2017,15,12076,2169,14245
3,25,8,3,2017,16,11825,2109,13934
3,25,8,3,2017,17,11455,2098,13553
3,25,8,3,2017,18,11537,2131,13668
3,25,8,3,2017,19,12249,2251,14500
3,25,8,3,2017,20,13140,2377,15517
3,25,8,3,2017,21,12611,2388,14999
3,25,8,3,2017,22,12460,2312,14772
3,25,8,3,2017,23,12247,2238,14485
3,25,8,3,2017,24,11945,2186,14131
2,26,8,3,2017,1,11705,2068,13773
2,26,8,3,2017,2,11541,1904,13445
2,26,8,3,2017,3,11415,1802,13217
2,26,8,3,2017,4,11452,1748,13200
2,26,8,3,2017,5,11738,1742,13480
2,26,8,3,2017,6,12606,1823,14429
2,26,8,3,2017,7,13316,1885,15201
2,26,8,3,2017,8,14031,2025,16056
2,26,8,3,2017,9,14261,2244,16505
2,26,8,3,2017,10,14180,2468,16648
2,26,8,3,2017,11,14062,2732,16794
2,26,8,3,2017,12,14104,2732,16836
2,26,8,3,2017,13,13609,2701,16310
2,26,8,3,2017,14,13312,2517,15829
2,26,8,3,2017,15,13340,2481,15821
2,26,8,3,2017,16,13510,2458,15968
2,26,8,3,2017,17,13027,2430,15457
2,26,8,3,2017,18,12940,2418,15358
2,26,8,3,2017,19,13629,2439,16068
2,26,8,3,2017,20,14157,2592,16749
2,26,8,3,2017,21,13908,2599,16507
2,26,8,3,2017,22,13811,2450,16261
2,26,8,3,2017,23,13105,2394,15499
2,26,8,3,2017,24,13138,2172,15310
2,27,8,3,2017,1,12480,2098,14578
2,27,8,3,2017,2,12280,1950,14230
2,27,8,3,2017,3,12243,1838,14081
2,27,8,3,2017,4,12105,1775,13880
2,27,8,3,2017,5,12522,1765,14287
2,27,8,3,2017,6,13161,1823,14984
2,27,8,3,2017,7,14066,1827,15893
2,27,8,3,2017,8,14358,1881,16239
2,27,8,3,2017,9,14627,2036,16663
2,27,8,3,2017,10,14110,2142,16252
2,27,8,3,2017,11,14065,2282,16347
2,27,8,3,2017,12,14233,2322,16555
2,27,8,3,2017,13,13915,2306,16221
2,27,8,3,2017,14,13850,2248,16098
2,27,8,3,2017,15,13689,2170,15859
2,27,8,3,2017,16,13339,2146,15485
2,27,8,3,2017,17,13162,2097,15259
2,27,8,3,2017,18,13089,2110,15199
2,27,8,3,2017,19,13697,2215,15912
2,27,8,3,2017,20,14256,2381,16637
2,27,8,3,2017,21,13914,2390,16304
2,27,8,3,2017,22,13539,2351,15890
2,27,8,3,2017,23,13474,2323,15797
2,27,8,3,2017,24,12879,2270,15149
1,28,8,3,2017,1,12567,2135,14702
1,28,8,3,2017,2,12322,1943,14265
1,28,8,3,2017,3,12269,1801,14070
1,28,8,3,2017,4,12271,1735,14006
1,28,8,3,2017,5,12457,1728,14185
1,28,8,3,2017,6,13058,1813,14871
1,28,8,3,2017,7,14104,1923,16027
1,28,8,3,2017,8,14222,2147,16369
1,28,8,3,2017,9,14808,2384,17192
1,28,8,3,2017,10,14235,2827,17062
1,28,8,3,2017,11,14234,3078,17312
1,28,8,3,2017,12,14388,3112,17500
1,28,8,3,2017,13,14013,3005,17018
1,28,8,3,2017,14,13778,2864,16642
1,28,8,3,2017,15,13513,2810,16323
1,28,8,3,2017,16,13460,2797,16257
1,28,8,3,2017,17,13580,2766,16346
1,28,8,3,2017,18,13472,2730,16202
1,28,8,3,2017,19,14208,2755,16963
1,28,8,3,2017,20,14720,2775,17495
1,28,8,3,2017,21,14161,2624,16785
1,28,8,3,2017,22,13519,2519,16038
1,28,8,3,2017,23,12953,2355,15308
1,28,8,3,2017,24,12525,2243,14768
1,29,8,3,2017,1,11956,2050,14006
1,29,8,3,2017,2,11776,1916,13692
1,29,8,3,2017,3,11720,1816,13536
1,29,8,3,2017,4,11672,1745,13417
1,29,8,3,2017,5,11916,1732,13648
1,29,8,3,2017,6,12422,1805,14227
1,29,8,3,2017,7,13417,1870,15287
1,29,8,3,2017,8,14010,2122,16132
1,29,8,3,2017,9,14184,2350,16534
1,29,8,3,2017,10,13957,2753,16710
1,29,8,3,2017,11,13662,2863,16525
1,29,8,3,2017,12,13276,2859,16135
1,29,8,3,2017,13,12643,2786,15429
1,29,8,3,2017,14,12668,2607,15275
1,29,8,3,2017,15,12397,2542,14939
1,29,8,3,2017,16,12592,2432,15024
1,29,8,3,2017,17,12080,2274,14354
1,29,8,3,2017,18,12090,2131,14221
1,29,8,3,2017,19,12838,2099,14937
1,29,8,3,2017,20,13446,2100,15546
1,29,8,3,2017,21,13160,2071,15231
1,29,8,3,2017,22,12738,2047,14785
1,29,8,3,2017,23,12327,2022,14349
1,29,8,3,2017,24,11827,1933,13760
1,30,8,3,2017,1,11245,1862,13107
1,30,8,3,2017,2,11243,1770,13013
1,30,8,3,2017,3,11023,1674,12697
1,30,8,3,2017,4,11191,1620,12811
1,30,8,3,2017,5,11460,1586,13046
1,30,8,3,2017,6,12139,1602,13741
1,30,8,3,2017,7,12847,1662,14509
1,30,8,3,2017,8,13585,1742,15327
1,30,8,3,2017,9,13860,1944,15804
1,30,8,3,2017,10,13647,2176,15823
1,30,8,3,2017,11,13076,2420,15496
1,30,8,3,2017,12,13155,2473,15628
1,30,8,3,2017,13,12721,2570,15291
1,30,8,3,2017,14,12733,2533,15266
1,30,8,3,2017,15,12776,2492,15268
1,30,8,3,2017,16,12704,2448,15152
1,30,8,3,2017,17,12568,2416,14984
1,30,8,3,2017,18,12498,2403,14901
1,30,8,3,2017,19,13098,2383,15481
1,30,8,3,2017,20,14361,2471,16832
1,30,8,3,2017,21,14014,2432,16446
1,30,8,3,2017,22,13608,2419,16027
1,30,8,3,2017,23,13239,2265,15504
1,30,8,3,2017,24,12814,2199,15013
1,31,8,3,2017,1,12278,2041,14319
1,31,8,3,2017,2,12152,1922,14074
1,31,8,3,2017,3,12003,1788,13791
1,31,8,3,2017,4,12097,1697,13794
1,31,8,3,2017,5,12503,1666,14169
1,31,8,3,2017,6,12954,1717,14671
1,31,8,3,2017,7,14065,1871,15936
1,31,8,3,2017,8,14385,1994,16379
1,31,8,3,2017,9,14618,2229,16847
1,31,8,3,2017,10,13975,2544,16519
1,31,8,3,2017,11,13747,2884,16631
1,31,8,3,2017,12,13704,2976,16680
1,31,8,3,2017,13,13293,3006,16299
1,31,8,3,2017,14,13101,2846,15947
1,31,8,3,2017,15,13058,2820,15878
1,31,8,3,2017,16,13207,2850,16057
1,31,8,3,2017,17,13050,2842,15892
1,31,8,3,2017,18,12598,2816,15414
1,31,8,3,2017,19,13284,2695,15979
1,31,8,3,2017,20,14389,2722,17111
1,31,8,3,2017,21,14145,2732,16877
1,31,8,3,2017,22,13767,2566,16333
1,31,8,3,2017,23,13401,2482,15883
1,31,8,3,2017,24,13053,2352,15405
1,1,9,3,2017,1,12693,2084,14777
1,1,9,3,2017,2,12438,1957,14395
1,1,9,3,2017,3,12282,1844,14126
1,1,9,3,2017,4,12035,1782,13817
1,1,9,3,2017,5,12299,1777,14076
1,1,9,3,2017,6,13208,1865,15073
1,1,9,3,2017,7,14045,2018,16063
1,1,9,3,2017,8,14509,2135,16644
1,1,9,3,2017,9,14232,2508,16740
1,1,9,3,2017,10,13674,2767,16441
1,1,9,3,2017,11,13545,3001,16546
1,1,9,3,2017,12,13519,3054,16573
1,1,9,3,2017,13,13215,3036,16251
1,1,9,3,2017,14,13480,2895,16375
1,1,9,3,2017,15,13294,2898,16192
1,1,9,3,2017,16,13436,2871,16307
1,1,9,3,2017,17,13295,2825,16120
1,1,9,3,2017,18,13016,2802,15818
1,1,9,3,2017,19,13198,2770,15968
1,1,9,3,2017,20,14607,2787,17394
1,1,9,3,2017,21,14121,2687,16808
1,1,9,3,2017,22,13708,2518,16226
1,1,9,3,2017,23,13360,2435,15795
1,1,9,3,2017,24,13204,2293,15497
3,2,9,3,2017,1,12760,2136,14896
3,2,9,3,2017,2,12477,1937,14414
3,2,9,3,2017,3,12438,1841,14279
3,2,9,3,2017,4,12215,1774,13989
3,2,9,3,2017,5,12565,1758,14323
3,2,9,3,2017,6,13245,1852,15097
3,2,9,3,2017,7,14276,1951,16227
3,2,9,3,2017,8,14945,2050,16995
3,2,9,3,2017,9,14819,2204,17023
3,2,9,3,2017,10,14316,2533,16849
3,2,9,3,2017,11,14226,2644,16870
3,2,9,3,2017,12,14503,2734,17237
3,2,9,3,2017,13,14369,2694,17063
3,2,9,3,2017,14,14267,2607,16874
3,2,9,3,2017,15,14551,2577,17128
3,2,9,3,2017,16,14418,2567,16985
3,2,9,3,2017,17,14273,2548,16821
3,2,9,3,2017,18,13738,2522,16260
3,2,9,3,2017,19,13915,2512,16427
3,2,9,3,2017,20,14987,2636,17623
3,2,9,3,2017,21,14396,2558,16954
3,2,9,3,2017,22,14143,2490,16633
3,2,9,3,2017,23,13618,2323,15941
3,2,9,3,2017,24,13403,2307,15710
2,3,9,3,2017,1,13243,2126,15369
2,3,9,3,2017,2,12889,1985,14874
2,3,9,3,2017,3,12818,1841,14659
2,3,9,3,2017,4,12785,1787,14572
2,3,9,3,2017,5,13009,1755,14764
2,3,9,3,2017,6,13738,1811,15549
2,3,9,3,2017,7,14493,1825,16318
2,3,9,3,2017,8,14749,1900,16649
2,3,9,3,2017,9,15026,1986,17012
2,3,9,3,2017,10,14240,2141,16381
2,3,9,3,2017,11,14585,2241,16826
2,3,9,3,2017,12,14791,2287,17078
2,3,9,3,2017,13,14556,2283,16839
2,3,9,3,2017,14,14532,2224,16756
2,3,9,3,2017,15,14416,2219,16635
2,3,9,3,2017,16,14313,2179,16492
2,3,9,3,2017,17,13983,2155,16138
2,3,9,3,2017,18,13620,2128,15748
2,3,9,3,2017,19,13851,2147,15998
2,3,9,3,2017,20,14640,2399,17039
2,3,9,3,2017,21,13895,2426,16321
2,3,9,3,2017,22,13830,2351,16181
2,3,9,3,2017,23,13420,2321,15741
2,3,9,3,2017,24,13476,2250,15726
1,4,9,3,2017,1,13191,2120,15311
1,4,9,3,2017,2,13256,1940,15196
1,4,9,3,2017,3,12970,1815,14785
1,4,9,3,2017,4,12755,1757,14512
1,4,9,3,2017,5,13039,1744,14783
1,4,9,3,2017,6,14082,1889,15971
1,4,9,3,2017,7,14952,2013,16965
1,4,9,3,2017,8,15216,2250,17466
1,4,9,3,2017,9,15448,2500,17948
1,4,9,3,2017,10,14967,2908,17875
1,4,9,3,2017,11,15005,3023,18028
1,4,9,3,2017,12,15217,3115,18332
1,4,9,3,2017,13,15228,3080,18308
1,4,9,3,2017,14,15247,2969,18216
1,4,9,3,2017,15,15306,3007,18313
1,4,9,3,2017,16,15502,3009,18511
1,4,9,3,2017,17,14796,2981,17777
1,4,9,3,2017,18,14283,2942,17225
1,4,9,3,2017,19,14536,2829,17365
1,4,9,3,2017,20,15487,2846,18333
1,4,9,3,2017,21,14754,2745,17499
1,4,9,3,2017,22,14503,2563,17066
1,4,9,3,2017,23,14202,2491,16693
1,4,9,3,2017,24,14012,2363,16375
1,5,9,3,2017,1,13820,2262,16082
1,5,9,3,2017,2,13558,2122,15680
1,5,9,3,2017,3,13535,1954,15489
1,5,9,3,2017,4,13259,1885,15144
1,5,9,3,2017,5,13655,1857,15512
1,5,9,3,2017,6,14338,1919,16257
1,5,9,3,2017,7,15325,1987,17312
1,5,9,3,2017,8,15817,2163,17980
1,5,9,3,2017,9,15946,2373,18319
1,5,9,3,2017,10,15318,2775,18093
1,5,9,3,2017,11,15074,2977,18051
1,5,9,3,2017,12,15373,2980,18353
1,5,9,3,2017,13,15600,2942,18542
1,5,9,3,2017,14,15392,2809,18201
1,5,9,3,2017,15,15407,2762,18169
1,5,9,3,2017,16,15020,2687,17707
1,5,9,3,2017,17,14622,2545,17167
1,5,9,3,2017,18,13916,2451,16367
1,5,9,3,2017,19,13688,2345,16033
1,5,9,3,2017,20,14284,2413,16698
1,5,9,3,2017,21,14247,2367,16614
1,5,9,3,2017,22,13853,2355,16208
1,5,9,3,2017,23,13876,2345,16221
1,5,9,3,2017,24,13394,2300,15694
1,6,9,3,2017,1,13493,2190,15683
1,6,9,3,2017,2,13155,2048,15203
1,6,9,3,2017,3,13297,1919,15216
1,6,9,3,2017,4,13073,1855,14928
1,6,9,3,2017,5,13385,1820,15205
1,6,9,3,2017,6,14307,1915,16222
1,6,9,3,2017,7,15337,2075,17412
1,6,9,3,2017,8,15802,2241,18043
1,6,9,3,2017,9,16439,2611,19050
1,6,9,3,2017,10,16181,2846,19027
1,6,9,3,2017,11,15877,3117,18994
1,6,9,3,2017,12,16261,3237,19498
1,6,9,3,2017,13,16357,3129,19486
1,6,9,3,2017,14,16603,3001,19604
1,6,9,3,2017,15,16316,3038,19354
1,6,9,3,2017,16,16629,3065,19694
1,6,9,3,2017,17,16037,3027,19064
1,6,9,3,2017,18,15704,2987,18691
1,6,9,3,2017,19,15595,2876,18471
1,6,9,3,2017,20,16304,2874,19178
1,6,9,3,2017,21,15845,2729,18574
1,6,9,3,2017,22,14835,2604,17439
1,6,9,3,2017,23,14814,2543,17357
1,6,9,3,2017,24,14559,2419,16978
1,7,9,3,2017,1,14429,2265,16694
1,7,9,3,2017,2,14205,2043,16248
1,7,9,3,2017,3,13957,1939,15896
1,7,9,3,2017,4,13984,1869,15853
1,7,9,3,2017,5,14289,1853,16142
1,7,9,3,2017,6,15110,1932,17042
1,7,9,3,2017,7,16093,2108,18201
1,7,9,3,2017,8,16584,2231,18815
1,7,9,3,2017,9,16586,2640,19226
1,7,9,3,2017,10,16273,2907,19180
1,7,9,3,2017,11,16255,3126,19381
1,7,9,3,2017,12,16604,3209,19813
1,7,9,3,2017,13,16658,3166,19824
1,7,9,3,2017,14,16827,3058,19885
1,7,9,3,2017,15,16634,3129,19763
1,7,9,3,2017,16,16912,3157,20069
1,7,9,3,2017,17,16307,3116,19423
1,7,9,3,2017,18,15642,3053,18695
1,7,9,3,2017,19,15357,2937,18294
1,7,9,3,2017,20,15893,2933,18826
1,7,9,3,2017,21,15193,2829,18022
1,7,9,3,2017,22,14560,2673,17233
1,7,9,3,2017,23,14502,2604,17106
1,7,9,3,2017,24,14316,2535,16851
1,8,9,3,2017,1,13694,2369,16063
1,8,9,3,2017,2,13610,2106,15716
1,8,9,3,2017,3,13256,1990,15246
1,8,9,3,2017,4,13177,1915,15092
1,8,9,3,2017,5,13170,1894,15064
1,8,9,3,2017,6,13691,1946,15637
1,8,9,3,2017,7,14348,2146,16494
1,8,9,3,2017,8,14710,2285,16995
1,8,9,3,2017,9,14644,2663,17307
1,8,9,3,2017,10,13932,2918,16850
1,8,9,3,2017,11,14045,3163,17208
1,8,9,3,2017,12,13752,3272,17024
1,8,9,3,2017,13,14409,3258,17667
1,8,9,3,2017,14,14519,3132,17651
1,8,9,3,2017,15,14397,3184,17581
1,8,9,3,2017,16,14413,3177,17590
1,8,9,3,2017,17,14469,3108,17577
1,8,9,3,2017,18,14449,3052,17501
1,8,9,3,2017,19,14751,3016,17767
1,8,9,3,2017,20,15495,2956,18451
1,8,9,3,2017,21,14894,2832,17726
1,8,9,3,2017,22,14633,2715,17348
1,8,9,3,2017,23,14112,2584,16696
1,8,9,3,2017,24,13997,2533,16530
2,9,9,3,2017,1,13405,2323,15728
2,9,9,3,2017,2,13434,2172,15606
2,9,9,3,2017,3,13194,2046,15240
2,9,9,3,2017,4,13237,1968,15205
2,9,9,3,2017,5,13383,1933,15316
2,9,9,3,2017,6,14045,2021,16066
2,9,9,3,2017,7,14808,2073,16881
2,9,9,3,2017,8,15273,2188,17461
2,9,9,3,2017,9,15056,2377,17433
2,9,9,3,2017,10,14439,2732,17171
2,9,9,3,2017,11,14792,2867,17659
2,9,9,3,2017,12,14853,3001,17854
2,9,9,3,2017,13,14889,2951,17840
2,9,9,3,2017,14,14651,2838,17489
2,9,9,3,2017,15,14879,2898,17777
2,9,9,3,2017,16,14907,2863,17770
2,9,9,3,2017,17,14694,2856,17550
2,9,9,3,2017,18,14565,2818,17383
2,9,9,3,2017,19,14941,2794,17735
2,9,9,3,2017,20,14931,2864,17795
2,9,9,3,2017,21,14816,2740,17556
2,9,9,3,2017,22,14605,2688,17293
2,9,9,3,2017,23,14216,2588,16804
2,9,9,3,2017,24,13942,2547,16489
2,10,9,3,2017,1,13733,2367,16100
2,10,9,3,2017,2,13548,2154,15702
2,10,9,3,2017,3,13345,2023,15368
2,10,9,3,2017,4,13313,1969,15282
2,10,9,3,2017,5,13448,1951,15399
2,10,9,3,2017,6,14017,1996,16013
2,10,9,3,2017,7,14555,2013,16568
2,10,9,3,2017,8,14837,2030,16867
2,10,9,3,2017,9,14838,2160,16998
2,10,9,3,2017,10,14445,2256,16701
2,10,9,3,2017,11,14473,2404,16877
2,10,9,3,2017,12,15177,2440,17617
2,10,9,3,2017,13,14903,2470,17373
2,10,9,3,2017,14,14945,2384,17329
2,10,9,3,2017,15,14833,2399,17232
2,10,9,3,2017,16,14873,2358,17231
2,10,9,3,2017,17,14361,2328,16689
2,10,9,3,2017,18,13943,2310,16253
2,10,9,3,2017,19,14539,2311,16850
2,10,9,3,2017,20,14997,2540,17537
2,10,9,3,2017,21,14656,2575,17231
2,10,9,3,2017,22,14336,2595,16931
2,10,9,3,2017,23,13676,2600,16276
2,10,9,3,2017,24,13807,2472,16279
1,11,9,3,2017,1,13481,2310,15791
1,11,9,3,2017,2,13090,2158,15248
1,11,9,3,2017,3,13043,2051,15094
1,11,9,3,2017,4,12840,2000,14840
1,11,9,3,2017,5,13211,1977,15188
1,11,9,3,2017,6,13716,2038,15754
1,11,9,3,2017,7,14509,2215,16724
1,11,9,3,2017,8,14644,2358,17002
1,11,9,3,2017,9,14728,2687,17415
1,11,9,3,2017,10,14656,3011,17667
1,11,9,3,2017,11,14635,3273,17908
1,11,9,3,2017,12,15025,3378,18403
1,11,9,3,2017,13,15210,3366,18576
1,11,9,3,2017,14,15328,3301,18629
1,11,9,3,2017,15,14895,3406,18301
1,11,9,3,2017,16,15194,3465,18659
1,11,9,3,2017,17,14978,3430,18408
1,11,9,3,2017,18,14908,3295,18203
1,11,9,3,2017,19,14690,3226,17916
1,11,9,3,2017,20,14670,3217,17887
1,11,9,3,2017,21,14587,3028,17615
1,11,9,3,2017,22,14532,2926,17458
1,11,9,3,2017,23,14244,2860,17104
1,11,9,3,2017,24,13951,2807,16758
1,12,9,3,2017,1,13556,2557,16113
1,12,9,3,2017,2,13183,2322,15505
1,12,9,3,2017,3,13184,2165,15349
1,12,9,3,2017,4,12964,2076,15040
1,12,9,3,2017,5,13107,2034,15141
1,12,9,3,2017,6,13974,2121,16095
1,12,9,3,2017,7,14857,2221,17078
1,12,9,3,2017,8,14692,2420,17112
1,12,9,3,2017,9,14384,2616,17000
1,12,9,3,2017,10,14576,3095,17671
1,12,9,3,2017,11,14820,3372,18192
1,12,9,3,2017,12,14898,3429,18327
1,12,9,3,2017,13,15012,3410,18422
1,12,9,3,2017,14,15002,3339,18341
1,12,9,3,2017,15,15314,3440,18754
1,12,9,3,2017,16,15273,3481,18754
1,12,9,3,2017,17,15241,3448,18689
1,12,9,3,2017,18,14721,3288,18009
1,12,9,3,2017,19,15051,3177,18228
1,12,9,3,2017,20,15473,3182,18655
1,12,9,3,2017,21,15256,3066,18322
1,12,9,3,2017,22,14925,2992,17917
1,12,9,3,2017,23,14648,2997,17645
1,12,9,3,2017,24,14358,2959,17317
1,13,9,3,2017,1,13520,2693,16213
1,13,9,3,2017,2,13111,2498,15609
1,13,9,3,2017,3,12763,2332,15095
1,13,9,3,2017,4,12609,2076,14685
1,13,9,3,2017,5,12596,1909,14505
1,13,9,3,2017,6,13467,2036,15503
1,13,9,3,2017,7,13919,2168,16087
1,13,9,3,2017,8,14490,2290,16780
1,13,9,3,2017,9,14630,2620,17250
1,13,9,3,2017,10,14426,2966,17392
1,13,9,3,2017,11,14136,3088,17224
1,13,9,3,2017,12,14576,3276,17852
1,13,9,3,2017,13,14458,3250,17708
1,13,9,3,2017,14,14419,3175,17594
1,13,9,3,2017,15,14614,3211,17825
1,13,9,3,2017,16,14825,3231,18056
1,13,9,3,2017,17,14584,3209,17793
1,13,9,3,2017,18,14487,3123,17610
1,13,9,3,2017,19,15028,3028,18056
1,13,9,3,2017,20,15087,3049,18136
1,13,9,3,2017,21,14692,2956,17648
1,13,9,3,2017,22,14674,2817,17491
1,13,9,3,2017,23,14435,2759,17194
1,13,9,3,2017,24,14123,2712,16835
1,14,9,3,2017,1,13560,2517,16077
1,14,9,3,2017,2,13270,2286,15556
1,14,9,3,2017,3,12871,2135,15006
1,14,9,3,2017,4,12974,2053,15027
1,14,9,3,2017,5,13164,2020,15184
1,14,9,3,2017,6,13634,2071,15705
1,14,9,3,2017,7,13655,2227,15882
1,14,9,3,2017,8,13630,2352,15982
1,14,9,3,2017,9,13900,2704,16604
1,14,9,3,2017,10,14034,2927,16961
1,14,9,3,2017,11,14274,3228,17502
1,14,9,3,2017,12,14308,3290,17598
1,14,9,3,2017,13,14133,3277,17410
1,14,9,3,2017,14,13992,3176,17168
1,14,9,3,2017,15,14030,3253,17283
1,14,9,3,2017,16,14277,3297,17574
1,14,9,3,2017,17,14175,3244,17419
1,14,9,3,2017,18,13838,3155,16993
1,14,9,3,2017,19,14101,3102,17203
1,14,9,3,2017,20,14673,2930,17603
1,14,9,3,2017,21,14075,2834,16909
1,14,9,3,2017,22,14094,2716,16810
1,14,9,3,2017,23,13990,2691,16681
1,14,9,3,2017,24,13703,2664,16367
1,15,9,3,2017,1,12811,2515,15326
1,15,9,3,2017,2,12828,2233,15061
1,15,9,3,2017,3,12664,2104,14768
1,15,9,3,2017,4,12681,2022,14703
1,15,9,3,2017,5,12831,1977,14808
1,15,9,3,2017,6,13608,2040,15648
1,15,9,3,2017,7,13283,2128,15411
1,15,9,3,2017,8,13851,2260,16111
1,15,9,3,2017,9,13682,2570,16252
1,15,9,3,2017,10,13780,2905,16685
1,15,9,3,2017,11,13612,3055,16667
1,15,9,3,2017,12,13474,3154,16628
1,15,9,3,2017,13,12999,3129,16128
1,15,9,3,2017,14,13011,3027,16038
1,15,9,3,2017,15,12994,3016,16010
1,15,9,3,2017,16,13229,3083,16312
1,15,9,3,2017,17,13198,3095,16293
1,15,9,3,2017,18,13444,3085,16529
1,15,9,3,2017,19,14017,2990,17007
1,15,9,3,2017,20,14226,2957,17183
1,15,9,3,2017,21,13841,2837,16678
1,15,9,3,2017,22,13867,2766,16633
1,15,9,3,2017,23,13789,2597,16386
1,15,9,3,2017,24,13347,2508,15855
2,16,9,3,2017,1,12832,2399,15231
2,16,9,3,2017,2,12562,2206,14768
2,16,9,3,2017,3,12418,2054,14472
2,16,9,3,2017,4,12375,1967,14342
2,16,9,3,2017,5,12640,1943,14583
2,16,9,3,2017,6,13168,2012,15180
2,16,9,3,2017,7,13286,2107,15393
2,16,9,3,2017,8,13402,2193,15595
2,16,9,3,2017,9,13760,2470,16230
2,16,9,3,2017,10,14032,2693,16725
2,16,9,3,2017,11,13868,2950,16818
2,16,9,3,2017,12,13931,2990,16921
2,16,9,3,2017,13,13694,2906,16600
2,16,9,3,2017,14,13420,2812,16232
2,16,9,3,2017,15,13852,2793,16645
2,16,9,3,2017,16,13892,2853,16745
2,16,9,3,2017,17,13819,2773,16592
2,16,9,3,2017,18,13955,2765,16720
2,16,9,3,2017,19,14243,2718,16961
2,16,9,3,2017,20,14533,2677,17210
2,16,9,3,2017,21,14261,2686,16947
2,16,9,3,2017,22,14054,2629,16683
2,16,9,3,2017,23,13758,2503,16261
2,16,9,3,2017,24,13230,2409,15639
2,17,9,3,2017,1,12822,2300,15122
2,17,9,3,2017,2,12626,2052,14678
2,17,9,3,2017,3,12495,1946,14441
2,17,9,3,2017,4,12686,1872,14558
2,17,9,3,2017,5,12714,1850,14564
2,17,9,3,2017,6,13603,1899,15502
2,17,9,3,2017,7,13025,1926,14951
2,17,9,3,2017,8,13282,1967,15249
2,17,9,3,2017,9,13333,2107,15440
2,17,9,3,2017,10,13079,2172,15251
2,17,9,3,2017,11,13284,2298,15582
2,17,9,3,2017,12,13507,2314,15821
2,17,9,3,2017,13,13252,2326,15578
2,17,9,3,2017,14,12975,2263,15238
2,17,9,3,2017,15,12838,2262,15100
2,17,9,3,2017,16,12968,2220,15188
2,17,9,3,2017,17,12709,2176,14885
2,17,9,3,2017,18,12507,2149,14656
2,17,9,3,2017,19,13697,2160,15857
2,17,9,3,2017,20,14182,2238,16420
2,17,9,3,2017,21,13729,2344,16073
2,17,9,3,2017,22,13158,2366,15524
2,17,9,3,2017,23,12934,2309,15243
2,17,9,3,2017,24,12200,2251,14451
1,18,9,3,2017,1,12173,2069,14242
1,18,9,3,2017,2,11776,1901,13677
1,18,9,3,2017,3,11617,1793,13410
1,18,9,3,2017,4,11743,1726,13469
1,18,9,3,2017,5,12036,1722,13758
1,18,9,3,2017,6,12975,1828,14803
1,18,9,3,2017,7,13449,1987,15436
1,18,9,3,2017,8,13249,2152,15401
1,18,9,3,2017,9,13500,2407,15907
1,18,9,3,2017,10,13263,2812,16075
1,18,9,3,2017,11,13669,3019,16688
1,18,9,3,2017,12,13538,3122,16660
1,18,9,3,2017,13,13186,3059,16245
1,18,9,3,2017,14,13014,2983,15997
1,18,9,3,2017,15,13196,2980,16176
1,18,9,3,2017,16,13179,3040,16219
1,18,9,3,2017,17,13174,3041,16215
1,18,9,3,2017,18,13235,3003,16238
1,18,9,3,2017,19,14136,2917,17053
1,18,9,3,2017,20,14607,2868,17475
1,18,9,3,2017,21,14068,2837,16905
1,18,9,3,2017,22,13519,2745,16264
1,18,9,3,2017,23,12900,2571,15471
1,18,9,3,2017,24,12287,2497,14784
1,19,9,3,2017,1,12278,2226,14504
1,19,9,3,2017,2,12353,2033,14386
1,19,9,3,2017,3,12276,1909,14185
1,19,9,3,2017,4,12117,1836,13953
1,19,9,3,2017,5,12336,1825,14161
1,19,9,3,2017,6,13130,1935,15065
1,19,9,3,2017,7,13710,2076,15786
1,19,9,3,2017,8,13894,2291,16185
1,19,9,3,2017,9,13491,2543,16034
1,19,9,3,2017,10,13197,2985,16182
1,19,9,3,2017,11,13702,3148,16850
1,19,9,3,2017,12,13720,3168,16888
1,19,9,3,2017,13,13027,3124,16151
1,19,9,3,2017,14,13059,2946,16005
1,19,9,3,2017,15,13036,2976,16012
1,19,9,3,2017,16,13047,2883,15930
1,19,9,3,2017,17,12998,2760,15758
1,19,9,3,2017,18,13193,2699,15892
1,19,9,3,2017,19,14065,2600,16665
1,19,9,3,2017,20,14509,2584,17093
1,19,9,3,2017,21,13636,2427,16063
1,19,9,3,2017,22,12878,2299,15177
1,19,9,3,2017,23,12409,2180,14589
1,19,9,3,2017,24,11945,2077,14022
1,20,9,3,2017,1,11339,1863,13202
1,20,9,3,2017,2,11558,1747,13305
1,20,9,3,2017,3,11446,1670,13116
1,20,9,3,2017,4,11676,1621,13297
1,20,9,3,2017,5,11968,1611,13579
1,20,9,3,2017,6,12535,1686,14221
1,20,9,3,2017,7,13259,1800,15059
1,20,9,3,2017,8,13484,1935,15419
1,20,9,3,2017,9,13572,2147,15719
1,20,9,3,2017,10,13422,2562,15984
1,20,9,3,2017,11,13371,2687,16058
1,20,9,3,2017,12,13032,2772,15804
1,20,9,3,2017,13,12672,2732,15404
1,20,9,3,2017,14,12439,2562,15001
1,20,9,3,2017,15,12540,2563,15103
1,20,9,3,2017,16,12294,2500,14794
1,20,9,3,2017,17,12448,2440,14888
1,20,9,3,2017,18,12938,2393,15331
1,20,9,3,2017,19,13595,2387,15982
1,20,9,3,2017,20,13803,2413,16216
1,20,9,3,2017,21,13473,2371,15844
1,20,9,3,2017,22,12903,2248,15151
1,20,9,3,2017,23,12355,2159,14514
1,20,9,3,2017,24,11987,2026,14013
1,21,9,3,2017,1,11679,1859,13538
1,21,9,3,2017,2,11578,1709,13287
1,21,9,3,2017,3,11356,1644,13000
1,21,9,3,2017,4,11279,1594,12873
1,21,9,3,2017,5,11656,1594,13250
1,21,9,3,2017,6,12344,1723,14067
1,21,9,3,2017,7,13046,1877,14923
1,21,9,3,2017,8,13319,2141,15460
1,21,9,3,2017,9,13450,2382,15832
1,21,9,3,2017,10,13170,2747,15917
1,21,9,3,2017,11,13289,2887,16176
1,21,9,3,2017,12,13170,2970,16140
1,21,9,3,2017,13,12969,2941,15910
1,21,9,3,2017,14,12509,2818,15327
1,21,9,3,2017,15,12692,2845,15537
1,21,9,3,2017,16,12553,2842,15395
1,21,9,3,2017,17,12461,2830,15291
1,21,9,3,2017,18,12779,2805,15584
1,21,9,3,2017,19,13542,2832,16374
1,21,9,3,2017,20,13884,2844,16728
1,21,9,3,2017,21,13577,2662,16239
1,21,9,3,2017,22,13005,2514,15519
1,21,9,3,2017,23,12410,2323,14733
1,21,9,3,2017,24,12135,2199,14334
1,22,9,3,2017,1,11650,1939,13589
1,22,9,3,2017,2,11508,1790,13298
1,22,9,3,2017,3,11420,1690,13110
1,22,9,3,2017,4,11526,1640,13166
1,22,9,3,2017,5,11505,1634,13139
1,22,9,3,2017,6,12373,1718,14091
1,22,9,3,2017,7,13009,1931,14940
1,22,9,3,2017,8,13138,2081,15219
1,22,9,3,2017,9,12820,2490,15310
1,22,9,3,2017,10,12799,2688,15487
1,22,9,3,2017,11,12493,2957,15450
1,22,9,3,2017,12,12587,2997,15584
1,22,9,3,2017,13,12300,2971,15271
1,22,9,3,2017,14,12216,2834,15050
1,22,9,3,2017,15,12320,2897,15217
1,22,9,3,2017,16,12232,2909,15141
1,22,9,3,2017,17,12414,2887,15301
1,22,9,3,2017,18,12670,2805,15475
1,22,9,3,2017,19,13726,2806,16532
1,22,9,3,2017,20,14504,2844,17348
1,22,9,3,2017,21,13835,2678,16513
1,22,9,3,2017,22,13447,2563,16010
1,22,9,3,2017,23,12918,2375,15293
1,22,9,3,2017,24,12231,2297,14528
2,23,9,3,2017,1,12164,2045,14209
2,23,9,3,2017,2,11991,1885,13876
2,23,9,3,2017,3,11926,1777,13703
2,23,9,3,2017,4,11794,1715,13509
2,23,9,3,2017,5,12053,1711,13764
2,23,9,3,2017,6,12804,1794,14598
2,23,9,3,2017,7,13265,1904,15169
2,23,9,3,2017,8,13675,2056,15731
2,23,9,3,2017,9,13354,2222,15576
2,23,9,3,2017,10,13327,2597,15924
2,23,9,3,2017,11,13831,2768,16599
2,23,9,3,2017,12,13776,2851,16627
2,23,9,3,2017,13,13566,2806,16372
2,23,9,3,2017,14,13410,2671,16081
2,23,9,3,2017,15,13542,2690,16232
2,23,9,3,2017,16,13472,2686,16158
2,23,9,3,2017,17,13257,2676,15933
2,23,9,3,2017,18,13616,2620,16236
2,23,9,3,2017,19,14140,2721,16861
2,23,9,3,2017,20,15407,2799,18206
2,23,9,3,2017,21,14963,2689,17652
2,23,9,3,2017,22,14001,2587,16588
2,23,9,3,2017,23,13765,2400,16165
2,23,9,3,2017,24,13128,2324,15452
2,24,9,3,2017,1,12863,2175,15038
2,24,9,3,2017,2,12640,1982,14622
2,24,9,3,2017,3,12538,1876,14414
2,24,9,3,2017,4,12633,1774,14407
2,24,9,3,2017,5,12654,1750,14404
2,24,9,3,2017,6,13109,1815,14924
2,24,9,3,2017,7,13905,1832,15737
2,24,9,3,2017,8,13812,1897,15709
2,24,9,3,2017,9,13612,2050,15662
2,24,9,3,2017,10,13734,2185,15919
2,24,9,3,2017,11,13686,2308,15994
2,24,9,3,2017,12,14105,2333,16438
2,24,9,3,2017,13,13608,2322,15930
2,24,9,3,2017,14,13480,2262,15742
2,24,9,3,2017,15,13601,2251,15852
2,24,9,3,2017,16,13537,2213,15750
2,24,9,3,2017,17,13357,2153,15510
2,24,9,3,2017,18,13120,2127,15247
2,24,9,3,2017,19,14003,2265,16268
2,24,9,3,2017,20,14870,2407,17277
2,24,9,3,2017,21,14380,2404,16784
2,24,9,3,2017,22,13948,2371,16319
2,24,9,3,2017,23,13506,2318,15824
2,24,9,3,2017,24,12718,2282,15000
1,25,9,3,2017,1,13020,2151,15171
1,25,9,3,2017,2,12698,1947,14645
1,25,9,3,2017,3,12697,1820,14517
1,25,9,3,2017,4,12535,1747,14282
1,25,9,3,2017,5,12815,1733,14548
1,25,9,3,2017,6,13449,1819,15268
1,25,9,3,2017,7,14147,2019,16166
1,25,9,3,2017,8,14585,2152,16737
1,25,9,3,2017,9,14052,2570,16622
1,25,9,3,2017,10,14032,2841,16873
1,25,9,3,2017,11,14472,3066,17538
1,25,9,3,2017,12,14677,3112,17789
1,25,9,3,2017,13,14621,3068,17689
1,25,9,3,2017,14,14463,2953,17416
1,25,9,3,2017,15,14614,3014,17628
1,25,9,3,2017,16,14718,3023,17741
1,25,9,3,2017,17,14352,3009,17361
1,25,9,3,2017,18,14086,2913,16999
1,25,9,3,2017,19,15135,2895,18030
1,25,9,3,2017,20,15675,2900,18575
1,25,9,3,2017,21,15196,2731,17927
1,25,9,3,2017,22,14677,2612,17289
1,25,9,3,2017,23,13917,2464,16381
1,25,9,3,2017,24,13704,2398,16102
1,26,9,3,2017,1,13291,2216,15507
1,26,9,3,2017,2,13233,2009,15242
1,26,9,3,2017,3,13030,1873,14903
1,26,9,3,2017,4,13104,1809,14913
1,26,9,3,2017,5,13228,1776,15004
1,26,9,3,2017,6,13890,1891,15781
1,26,9,3,2017,7,15211,2027,17238
1,26,9,3,2017,8,14721,2240,16961
1,26,9,3,2017,9,14510,2443,16953
1,26,9,3,2017,10,14570,2870,17440
1,26,9,3,2017,11,15086,3084,18170
1,26,9,3,2017,12,15396,3148,18544
1,26,9,3,2017,13,15191,3082,18273
1,26,9,3,2017,14,15217,3008,18225
1,26,9,3,2017,15,15355,3068,18423
1,26,9,3,2017,16,15584,3079,18663
1,26,9,3,2017,17,14591,3072,17663
1,26,9,3,2017,18,14546,2977,17523
1,26,9,3,2017,19,15094,2956,18050
1,26,9,3,2017,20,16035,2975,19010
1,26,9,3,2017,21,15426,2791,18217
1,26,9,3,2017,22,14915,2690,17605
1,26,9,3,2017,23,14354,2539,16893
1,26,9,3,2017,24,13825,2479,16304
1,27,9,3,2017,1,13485,2301,15786
1,27,9,3,2017,2,13395,2120,15515
1,27,9,3,2017,3,13364,1936,15300
1,27,9,3,2017,4,13368,1873,15241
1,27,9,3,2017,5,13699,1851,15550
1,27,9,3,2017,6,14596,1931,16527
1,27,9,3,2017,7,15049,2112,17161
1,27,9,3,2017,8,15698,2252,17950
1,27,9,3,2017,9,14880,2647,17527
1,27,9,3,2017,10,15064,2899,17963
1,27,9,3,2017,11,15893,3155,19048
1,27,9,3,2017,12,16018,3215,19233
1,27,9,3,2017,13,15667,3198,18865
1,27,9,3,2017,14,15951,3079,19030
1,27,9,3,2017,15,15548,3136,18684
1,27,9,3,2017,16,15870,3143,19013
1,27,9,3,2017,17,14811,3145,17956
1,27,9,3,2017,18,14481,3097,17578
1,27,9,3,2017,19,15529,3075,18604
1,27,9,3,2017,20,15370,3092,18462
1,27,9,3,2017,21,15294,2978,18272
1,27,9,3,2017,22,14922,2802,17724
1,27,9,3,2017,23,14445,2680,17125
1,27,9,3,2017,24,13862,2699,16561
1,28,9,3,2017,1,13694,2518,16212
1,28,9,3,2017,2,13633,2214,15847
1,28,9,3,2017,3,13614,2051,15665
1,28,9,3,2017,4,13643,1976,15619
1,28,9,3,2017,5,14037,1963,16000
1,28,9,3,2017,6,14706,2038,16744
1,28,9,3,2017,7,15521,2165,17686
1,28,9,3,2017,8,15412,2324,17736
1,28,9,3,2017,9,14776,2745,17521
1,28,9,3,2017,10,15237,2931,18168
1,28,9,3,2017,11,15529,3227,18756
1,28,9,3,2017,12,16045,3292,19337
1,28,9,3,2017,13,15697,3281,18978
1,28,9,3,2017,14,15567,3156,18723
1,28,9,3,2017,15,15813,3241,19054
1,28,9,3,2017,16,15835,3249,19084
1,28,9,3,2017,17,15292,3217,18509
1,28,9,3,2017,18,14753,3153,17906
1,28,9,3,2017,19,15367,3111,18478
1,28,9,3,2017,20,15287,3066,18353
1,28,9,3,2017,21,14927,2962,17889
1,28,9,3,2017,22,14532,2745,17277
1,28,9,3,2017,23,14268,2686,16954
1,28,9,3,2017,24,13611,2633,16244
1,29,9,3,2017,1,13621,2528,16149
1,29,9,3,2017,2,13449,2248,15697
1,29,9,3,2017,3,13625,2111,15736
1,29,9,3,2017,4,13570,2016,15586
1,29,9,3,2017,5,14030,1990,16020
1,29,9,3,2017,6,14888,2052,16940
1,29,9,3,2017,7,15691,2188,17879
1,29,9,3,2017,8,15374,2305,17679
1,29,9,3,2017,9,15186,2658,17844
1,29,9,3,2017,10,14942,3028,17970
1,29,9,3,2017,11,15034,3130,18164
1,29,9,3,2017,12,16311,3253,19564
1,29,9,3,2017,13,15755,3202,18957
1,29,9,3,2017,14,15341,3076,18417
1,29,9,3,2017,15,14504,3150,17654
1,29,9,3,2017,16,14778,3160,17938
1,29,9,3,2017,17,13983,3110,17093
1,29,9,3,2017,18,14048,3015,17064
1,29,9,3,2017,19,14613,3012,17625
1,29,9,3,2017,20,14873,2957,17830
1,29,9,3,2017,21,14543,2747,17290
1,29,9,3,2017,22,13875,2653,16528
1,29,9,3,2017,23,13390,2499,15889
1,29,9,3,2017,24,13249,2432,15681
3,30,9,3,2017,1,13147,2326,15473
3,30,9,3,2017,2,13121,2181,15302
3,30,9,3,2017,3,13228,2010,15238
3,30,9,3,2017,4,13159,1946,15105
3,30,9,3,2017,5,13161,1909,15070
3,30,9,3,2017,6,13742,1965,15707
3,30,9,3,2017,7,14432,1977,16409
3,30,9,3,2017,8,14228,2030,16258
3,30,9,3,2017,9,13227,2175,15402
3,30,9,3,2017,10,12924,2255,15179
3,30,9,3,2017,11,13192,2436,15628
3,30,9,3,2017,12,13656,2500,16156
3,30,9,3,2017,13,13464,2520,15984
3,30,9,3,2017,14,13777,2468,16245
3,30,9,3,2017,15,13620,2492,16112
3,30,9,3,2017,16,13654,2484,16138
3,30,9,3,2017,17,12840,2447,15287
3,30,9,3,2017,18,12396,2358,14754
3,30,9,3,2017,19,12725,2412,15137
3,30,9,3,2017,20,12994,2603,15597
3,30,9,3,2017,21,12611,2548,15159
3,30,9,3,2017,22,12312,2530,14842
3,30,9,3,2017,23,12121,2450,14571
3,30,9,3,2017,24,12019,2359,14378
2,1,10,1,2017,1,12003,2374,14377
2,1,10,1,2017,2,11910,2156,14066
2,1,10,1,2017,3,12121,2061,14182
2,1,10,1,2017,4,12042,1976,14018
2,1,10,1,2017,5,12389,1938,14327
2,1,10,1,2017,6,13013,1981,14994
2,1,10,1,2017,7,13819,1964,15783
2,1,10,1,2017,8,13993,1984,15977
2,1,10,1,2017,9,13906,2053,15959
2,1,10,1,2017,10,13948,2217,16165
2,1,10,1,2017,11,14608,2344,16952
2,1,10,1,2017,12,15182,2419,17601
2,1,10,1,2017,13,15118,2436,17554
2,1,10,1,2017,14,15247,2424,17671
2,1,10,1,2017,15,15444,2464,17908
2,1,10,1,2017,16,15110,2437,17547
2,1,10,1,2017,17,14603,2344,16947
2,1,10,1,2017,18,14104,2292,16396
2,1,10,1,2017,19,14618,2411,17029
2,1,10,1,2017,20,14980,2517,17497
2,1,10,1,2017,21,14613,2530,17143
2,1,10,1,2017,22,13910,2544,16454
2,1,10,1,2017,23,13667,2533,16200
2,1,10,1,2017,24,13382,2542,15924
3,2,10,1,2017,1,13339,2385,15724
3,2,10,1,2017,2,13612,2237,15849
3,2,10,1,2017,3,13480,2094,15574
3,2,10,1,2017,4,13594,2004,15598
3,2,10,1,2017,5,13940,1968,15908
3,2,10,1,2017,6,14443,2026,16469
3,2,10,1,2017,7,14941,2036,16977
3,2,10,1,2017,8,15247,2075,17322
3,2,10,1,2017,9,15011,2184,17195
3,2,10,1,2017,10,15057,2486,17543
3,2,10,1,2017,11,15377,2685,18062
3,2,10,1,2017,12,15827,2836,18663
3,2,10,1,2017,13,15553,2807,18360
3,2,10,1,2017,14,15746,2752,18498
3,2,10,1,2017,15,15834,2818,18652
3,2,10,1,2017,16,15913,2823,18736
3,2,10,1,2017,17,15083,2743,17826
3,2,10,1,2017,18,14913,2668,17581
3,2,10,1,2017,19,15226,2731,17957
3,2,10,1,2017,20,15679,2769,18448
3,2,10,1,2017,21,14743,2712,17455
3,2,10,1,2017,22,14534,2644,17178
3,2,10,1,2017,23,14408,2609,17017
3,2,10,1,2017,24,13649,2594,16243
1,3,10,1,2017,1,13780,2461,16241
1,3,10,1,2017,2,13974,2218,16192
1,3,10,1,2017,3,14031,2080,16111
1,3,10,1,2017,4,13859,1988,15847
1,3,10,1,2017,5,14138,1971,16109
1,3,10,1,2017,6,15145,2053,17198
1,3,10,1,2017,7,15862,2167,18029
1,3,10,1,2017,8,16256,2360,18616
1,3,10,1,2017,9,15832,2600,18432
1,3,10,1,2017,10,15984,3085,19069
1,3,10,1,2017,11,16590,3245,19835
1,3,10,1,2017,12,17222,3402,20624
1,3,10,1,2017,13,16923,3378,20301
1,3,10,1,2017,14,16699,3306,20005
1,3,10,1,2017,15,17217,3381,20598
1,3,10,1,2017,16,17132,3382,20514
1,3,10,1,2017,17,16067,3343,19410
1,3,10,1,2017,18,15688,3189,18877
1,3,10,1,2017,19,15897,3134,19031
1,3,10,1,2017,20,15967,3094,19061
1,3,10,1,2017,21,15623,2915,18538
1,3,10,1,2017,22,15262,2822,18084
1,3,10,1,2017,23,14984,2767,17751
1,3,10,1,2017,24,14322,2723,17045
1,4,10,1,2017,1,14159,2472,16631
1,4,10,1,2017,2,14652,2301,16953
1,4,10,1,2017,3,14484,2157,16641
1,4,10,1,2017,4,14742,2074,16816
1,4,10,1,2017,5,14987,2033,17020
1,4,10,1,2017,6,15232,2123,17355
1,4,10,1,2017,7,15586,2202,17788
1,4,10,1,2017,8,15841,2380,18221
1,4,10,1,2017,9,15820,2653,18473
1,4,10,1,2017,10,16354,3102,19456
1,4,10,1,2017,11,17120,3253,20373
1,4,10,1,2017,12,17411,3393,20804
1,4,10,1,2017,13,16787,3359,20146
1,4,10,1,2017,14,16866,3249,20115
1,4,10,1,2017,15,16873,3369,20242
1,4,10,1,2017,16,17194,3397,20591
1,4,10,1,2017,17,16414,3379,19793
1,4,10,1,2017,18,16078,3242,19320
1,4,10,1,2017,19,15877,3164,19041
1,4,10,1,2017,20,16062,3142,19204
1,4,10,1,2017,21,15948,2974,18922
1,4,10,1,2017,22,15629,2839,18468
1,4,10,1,2017,23,15199,2891,18090
1,4,10,1,2017,24,14673,2872,17545
1,5,10,1,2017,1,14192,2652,16844
1,5,10,1,2017,2,14750,2396,17146
1,5,10,1,2017,3,14957,2240,17197
1,5,10,1,2017,4,14884,2141,17025
1,5,10,1,2017,5,15019,2108,17127
1,5,10,1,2017,6,15771,2137,17908
1,5,10,1,2017,7,15198,2221,17419
1,5,10,1,2017,8,16098,2364,18462
1,5,10,1,2017,9,16338,2590,18928
1,5,10,1,2017,10,16508,3058,19566
1,5,10,1,2017,11,17119,3315,20434
1,5,10,1,2017,12,17419,3404,20823
1,5,10,1,2017,13,15953,3385,19338
1,5,10,1,2017,14,16460,3289,19749
1,5,10,1,2017,15,17581,3388,20969
1,5,10,1,2017,16,17851,3406,21257
1,5,10,1,2017,17,16622,3396,20018
1,5,10,1,2017,18,16145,3284,19429
1,5,10,1,2017,19,15747,3226,18973
1,5,10,1,2017,20,16411,3164,19575
1,5,10,1,2017,21,15304,3061,18365
1,5,10,1,2017,22,15148,2980,18128
1,5,10,1,2017,23,15003,2882,17885
1,5,10,1,2017,24,14772,2842,17614
1,6,10,1,2017,1,14465,2667,17132
1,6,10,1,2017,2,14688,2417,17105
1,6,10,1,2017,3,14998,2261,17259
1,6,10,1,2017,4,14859,2162,17021
1,6,10,1,2017,5,15592,2129,17721
1,6,10,1,2017,6,16109,2158,18267
1,6,10,1,2017,7,16051,2242,18293
1,6,10,1,2017,8,15785,2385,18170
1,6,10,1,2017,9,15806,2612,18418
1,6,10,1,2017,10,16146,3079,19225
1,6,10,1,2017,11,16749,3323,20072
1,6,10,1,2017,12,17444,3445,20889
1,6,10,1,2017,13,16926,3423,20349
1,6,10,1,2017,14,16646,3324,19970
1,6,10,1,2017,15,16228,3422,19650
1,6,10,1,2017,16,15825,3404,19229
1,6,10,1,2017,17,15452,3262,18714
1,6,10,1,2017,18,15295,3188,18483
1,6,10,1,2017,19,15246,3113,18359
1,6,10,1,2017,20,15042,2974,18016
1,6,10,1,2017,21,14553,2863,17416
1,6,10,1,2017,22,14553,2690,17243
1,6,10,1,2017,23,14023,2652,16675
1,6,10,1,2017,24,13848,2624,16472
2,7,10,1,2017,1,13600,2453,16053
2,7,10,1,2017,2,13917,2243,16160
2,7,10,1,2017,3,13956,2099,16055
2,7,10,1,2017,4,14023,2009,16032
2,7,10,1,2017,5,14376,1971,16347
2,7,10,1,2017,6,15199,2034,17233
2,7,10,1,2017,7,15593,2095,17688
2,7,10,1,2017,8,15281,2219,17500
2,7,10,1,2017,9,15608,2423,18031
2,7,10,1,2017,10,15085,2697,17782
2,7,10,1,2017,11,15756,3015,18771
2,7,10,1,2017,12,16558,3137,19695
2,7,10,1,2017,13,16881,3153,20034
2,7,10,1,2017,14,16555,3069,19624
2,7,10,1,2017,15,16106,3115,19221
2,7,10,1,2017,16,15691,3071,18762
2,7,10,1,2017,17,14934,2990,17924
2,7,10,1,2017,18,14853,2945,17798
2,7,10,1,2017,19,14553,2914,17467
2,7,10,1,2017,20,14404,2831,17235
2,7,10,1,2017,21,13788,2733,16521
2,7,10,1,2017,22,13450,2522,15972
2,7,10,1,2017,23,13118,2505,15623
2,7,10,1,2017,24,12978,2337,15315
2,8,10,1,2017,1,12836,2237,15073
2,8,10,1,2017,2,12760,2137,14897
2,8,10,1,2017,3,13019,2013,15032
2,8,10,1,2017,4,12987,1972,14959
2,8,10,1,2017,5,13488,1954,15442
2,8,10,1,2017,6,14072,1963,16035
2,8,10,1,2017,7,14321,1947,16268
2,8,10,1,2017,8,14241,1966,16207
2,8,10,1,2017,9,14038,2059,16097
2,8,10,1,2017,10,13904,2134,16038
2,8,10,1,2017,11,14434,2225,16659
2,8,10,1,2017,12,14909,2260,17169
2,8,10,1,2017,13,14728,2326,17054
2,8,10,1,2017,14,14456,2314,16770
2,8,10,1,2017,15,14351,2353,16704
2,8,10,1,2017,16,14069,2326,16395
2,8,10,1,2017,17,13928,2233,16161
2,8,10,1,2017,18,13753,2181,15934
2,8,10,1,2017,19,13942,2300,16242
2,8,10,1,2017,20,13707,2411,16118
2,8,10,1,2017,21,13407,2271,15678
2,8,10,1,2017,22,13012,2236,15248
2,8,10,1,2017,23,12765,2204,14969
2,8,10,1,2017,24,12795,2173,14968
1,9,10,1,2017,1,12500,2208,14708
1,9,10,1,2017,2,12436,2038,14474
1,9,10,1,2017,3,12625,1893,14518
1,9,10,1,2017,4,12684,1810,14494
1,9,10,1,2017,5,12878,1770,14648
1,9,10,1,2017,6,13665,1860,15525
1,9,10,1,2017,7,14437,1939,16376
1,9,10,1,2017,8,14339,2116,16455
1,9,10,1,2017,9,14227,2389,16616
1,9,10,1,2017,10,13980,2837,16817
1,9,10,1,2017,11,14287,2987,17274
1,9,10,1,2017,12,14332,3222,17554
1,9,10,1,2017,13,14017,3210,17227
1,9,10,1,2017,14,13803,3130,16933
1,9,10,1,2017,15,13971,3164,17135
1,9,10,1,2017,16,13882,3177,17059
1,9,10,1,2017,17,13830,3140,16970
1,9,10,1,2017,18,14043,3048,17091
1,9,10,1,2017,19,14401,3027,17428
1,9,10,1,2017,20,14396,2963,17359
1,9,10,1,2017,21,13940,2825,16765
1,9,10,1,2017,22,13538,2765,16303
1,9,10,1,2017,23,13176,2654,15830
1,9,10,1,2017,24,12686,2491,15177
1,10,10,1,2017,1,12546,2372,14918
1,10,10,1,2017,2,12583,2171,14754
1,10,10,1,2017,3,12608,2006,14614
1,10,10,1,2017,4,12431,1938,14369
1,10,10,1,2017,5,12990,1931,14921
1,10,10,1,2017,6,13746,2010,15756
1,10,10,1,2017,7,14297,2122,16419
1,10,10,1,2017,8,14132,2350,16482
1,10,10,1,2017,9,14008,2593,16601
1,10,10,1,2017,10,13936,2994,16930
1,10,10,1,2017,11,14170,3142,17312
1,10,10,1,2017,12,14229,3219,17448
1,10,10,1,2017,13,13728,3198,16926
1,10,10,1,2017,14,13437,3072,16509
1,10,10,1,2017,15,13702,3096,16798
1,10,10,1,2017,16,13655,3094,16749
1,10,10,1,2017,17,13786,3086,16872
1,10,10,1,2017,18,14077,3063,17140
1,10,10,1,2017,19,14826,3036,17862
1,10,10,1,2017,20,14567,2972,17539
1,10,10,1,2017,21,14104,2781,16885
1,10,10,1,2017,22,13604,2629,16233
1,10,10,1,2017,23,13157,2494,15651
1,10,10,1,2017,24,12851,2400,15251
1,11,10,1,2017,1,12624,2276,14900
1,11,10,1,2017,2,12016,2039,14055
1,11,10,1,2017,3,12219,1926,14145
1,11,10,1,2017,4,12199,1847,14046
1,11,10,1,2017,5,12602,1828,14430
1,11,10,1,2017,6,13073,1930,15003
1,11,10,1,2017,7,13975,2072,16047
1,11,10,1,2017,8,13768,2232,16000
1,11,10,1,2017,9,13608,2539,16147
1,11,10,1,2017,10,13628,2842,16470
1,11,10,1,2017,11,13547,3125,16672
1,11,10,1,2017,12,13462,3174,16636
1,11,10,1,2017,13,13257,3122,16379
1,11,10,1,2017,14,13036,2999,16035
1,11,10,1,2017,15,13037,3021,16058
1,11,10,1,2017,16,13142,3041,16183
1,11,10,1,2017,17,13360,2983,16343
1,11,10,1,2017,18,13535,2943,16478
1,11,10,1,2017,19,14469,2965,17434
1,11,10,1,2017,20,14621,2943,17564
1,11,10,1,2017,21,14409,2783,17192
1,11,10,1,2017,22,13801,2626,16427
1,11,10,1,2017,23,13362,2492,15854
1,11,10,1,2017,24,12966,2420,15386
1,12,10,1,2017,1,12624,2231,14855
1,12,10,1,2017,2,12313,2063,14376
1,12,10,1,2017,3,12407,1927,14334
1,12,10,1,2017,4,12374,1844,14218
1,12,10,1,2017,5,12748,1830,14578
1,12,10,1,2017,6,13466,1921,15387
1,12,10,1,2017,7,13883,2046,15929
1,12,10,1,2017,8,13954,2192,16146
1,12,10,1,2017,9,13681,2568,16249
1,12,10,1,2017,10,14034,2884,16918
1,12,10,1,2017,11,14030,3188,17218
1,12,10,1,2017,12,13783,3262,17045
1,12,10,1,2017,13,13347,3208,16555
1,12,10,1,2017,14,13081,3115,16196
1,12,10,1,2017,15,13457,3154,16611
1,12,10,1,2017,16,13095,3176,16271
1,12,10,1,2017,17,13568,3159,16727
1,12,10,1,2017,18,13481,3071,16552
1,12,10,1,2017,19,14856,3053,17909
1,12,10,1,2017,20,15163,3041,18204
1,12,10,1,2017,21,14685,2867,17552
1,12,10,1,2017,22,14352,2754,17106
1,12,10,1,2017,23,13809,2660,16469
1,12,10,1,2017,24,13135,2565,15700
1,13,10,1,2017,1,12811,2384,15195
1,13,10,1,2017,2,12867,2127,14994
1,13,10,1,2017,3,12853,2026,14879
1,13,10,1,2017,4,12797,1938,14735
1,13,10,1,2017,5,13113,1922,15035
1,13,10,1,2017,6,13503,2010,15513
1,13,10,1,2017,7,14258,2125,16383
1,13,10,1,2017,8,13999,2338,16337
1,13,10,1,2017,9,14003,2573,16576
1,13,10,1,2017,10,13526,3046,16572
1,13,10,1,2017,11,13616,3243,16859
1,13,10,1,2017,12,13447,3298,16745
1,13,10,1,2017,13,13103,3261,16364
1,13,10,1,2017,14,12986,3082,16068
1,13,10,1,2017,15,12968,3131,16099
1,13,10,1,2017,16,12585,3158,15743
1,13,10,1,2017,17,12562,3117,15679
1,13,10,1,2017,18,13213,3132,16345
1,13,10,1,2017,19,14419,3117,17536
1,13,10,1,2017,20,14562,3036,17598
1,13,10,1,2017,21,14205,2815,17020
1,13,10,1,2017,22,13705,2690,16395
1,13,10,1,2017,23,13448,2554,16002
1,13,10,1,2017,24,12901,2496,15397
2,14,10,1,2017,1,12499,2301,14800
2,14,10,1,2017,2,12476,2156,14632
2,14,10,1,2017,3,12278,2012,14290
2,14,10,1,2017,4,12626,1936,14562
2,14,10,1,2017,5,12795,1898,14693
2,14,10,1,2017,6,13468,1971,15439
2,14,10,1,2017,7,13917,2042,15959
2,14,10,1,2017,8,13850,2194,16044
2,14,10,1,2017,9,13990,2316,16306
2,14,10,1,2017,10,13891,2673,16564
2,14,10,1,2017,11,14107,2848,16955
2,14,10,1,2017,12,13971,2964,16935
2,14,10,1,2017,13,13719,2952,16671
2,14,10,1,2017,14,13590,2874,16464
2,14,10,1,2017,15,13687,2898,16585
2,14,10,1,2017,16,13234,2884,16118
2,14,10,1,2017,17,13052,2873,15925
2,14,10,1,2017,18,13487,2827,16314
2,14,10,1,2017,19,14867,2856,17723
2,14,10,1,2017,20,15062,2823,17885
2,14,10,1,2017,21,14500,2664,17164
2,14,10,1,2017,22,13960,2597,16557
2,14,10,1,2017,23,13623,2491,16114
2,14,10,1,2017,24,12867,2274,15141
2,15,10,1,2017,1,12708,2279,14987
2,15,10,1,2017,2,12670,2072,14742
2,15,10,1,2017,3,12614,1947,14561
2,15,10,1,2017,4,12625,1872,14497
2,15,10,1,2017,5,12996,1855,14851
2,15,10,1,2017,6,13495,1903,15398
2,15,10,1,2017,7,13853,1914,15767
2,15,10,1,2017,8,13995,1955,15950
2,15,10,1,2017,9,13888,2050,15938
2,15,10,1,2017,10,13809,2212,16021
2,15,10,1,2017,11,13887,2351,16238
2,15,10,1,2017,12,14137,2417,16554
2,15,10,1,2017,13,13829,2436,16265
2,15,10,1,2017,14,13449,2378,15827
2,15,10,1,2017,15,13484,2394,15878
2,15,10,1,2017,16,13596,2386,15982
2,15,10,1,2017,17,13074,2327,15401
2,15,10,1,2017,18,13297,2320,15617
2,15,10,1,2017,19,14572,2408,16980
2,15,10,1,2017,20,14801,2458,17259
2,15,10,1,2017,21,14308,2443,16751
2,15,10,1,2017,22,14045,2439,16484
2,15,10,1,2017,23,13537,2405,15942
2,15,10,1,2017,24,12933,2291,15224
1,16,10,1,2017,1,12859,2223,15082
1,16,10,1,2017,2,12716,2052,14768
1,16,10,1,2017,3,12585,1936,14521
1,16,10,1,2017,4,12650,1860,14510
1,16,10,1,2017,5,12786,1837,14623
1,16,10,1,2017,6,13792,1895,15687
1,16,10,1,2017,7,14255,2015,16270
1,16,10,1,2017,8,14290,2225,16515
1,16,10,1,2017,9,14133,2631,16764
1,16,10,1,2017,10,14162,2906,17068
1,16,10,1,2017,11,14356,3237,17593
1,16,10,1,2017,12,14475,3267,17742
1,16,10,1,2017,13,14378,3237,17615
1,16,10,1,2017,14,14100,3151,17251
1,16,10,1,2017,15,14202,3173,17375
1,16,10,1,2017,16,14333,3193,17526
1,16,10,1,2017,17,14298,3159,17457
1,16,10,1,2017,18,13985,3098,17083
1,16,10,1,2017,19,15157,3094,18251
1,16,10,1,2017,20,15792,3055,18847
1,16,10,1,2017,21,15039,2882,17921
1,16,10,1,2017,22,14647,2770,17417
1,16,10,1,2017,23,13997,2583,16580
1,16,10,1,2017,24,13509,2357,15866
1,17,10,1,2017,1,13214,2268,15482
1,17,10,1,2017,2,13083,2109,15192
1,17,10,1,2017,3,13000,1988,14988
1,17,10,1,2017,4,12901,1907,14808
1,17,10,1,2017,5,13332,1884,15216
1,17,10,1,2017,6,14087,1948,16035
1,17,10,1,2017,7,14350,2071,16421
1,17,10,1,2017,8,14851,2193,17044
1,17,10,1,2017,9,14302,2639,16941
1,17,10,1,2017,10,14172,2950,17122
1,17,10,1,2017,11,14331,3243,17574
1,17,10,1,2017,12,14619,3302,17921
1,17,10,1,2017,13,14396,3299,17695
1,17,10,1,2017,14,14277,3218,17495
1,17,10,1,2017,15,14189,3270,17459
1,17,10,1,2017,16,13989,3289,17278
1,17,10,1,2017,17,14090,3254,17344
1,17,10,1,2017,18,13847,3153,17000
1,17,10,1,2017,19,15040,3148,18188
1,17,10,1,2017,20,15266,3115,18381
1,17,10,1,2017,21,14675,3009,17684
1,17,10,1,2017,22,14250,2822,17072
1,17,10,1,2017,23,13971,2777,16748
1,17,10,1,2017,24,13165,2672,15837
1,18,10,1,2017,1,12878,2492,15370
1,18,10,1,2017,2,13220,2249,15469
1,18,10,1,2017,3,12808,2084,14892
1,18,10,1,2017,4,12923,1988,14911
1,18,10,1,2017,5,13470,1950,15420
1,18,10,1,2017,6,14206,2037,16243
1,18,10,1,2017,7,14505,2125,16630
1,18,10,1,2017,8,14352,2276,16628
1,18,10,1,2017,9,13772,2532,16304
1,18,10,1,2017,10,13568,2903,16471
1,18,10,1,2017,11,13636,3088,16724
1,18,10,1,2017,12,14208,3178,17386
1,18,10,1,2017,13,13888,3176,17064
1,18,10,1,2017,14,13886,3110,16996
1,18,10,1,2017,15,13840,3151,16991
1,18,10,1,2017,16,13727,3144,16871
1,18,10,1,2017,17,13353,3087,16440
1,18,10,1,2017,18,13351,2928,16279
1,18,10,1,2017,19,14282,2934,17216
1,18,10,1,2017,20,14466,2968,17434
1,18,10,1,2017,21,13973,2881,16854
1,18,10,1,2017,22,13497,2776,16273
1,18,10,1,2017,23,13021,2708,15729
1,18,10,1,2017,24,12444,2614,15058
3,19,10,1,2017,1,11878,2446,14324
3,19,10,1,2017,2,11730,2228,13958
3,19,10,1,2017,3,11814,2078,13892
3,19,10,1,2017,4,11934,1980,13914
3,19,10,1,2017,5,12258,1939,14197
3,19,10,1,2017,6,13233,1972,15205
3,19,10,1,2017,7,13443,1992,15435
3,19,10,1,2017,8,13246,2020,15266
3,19,10,1,2017,9,12478,2100,14578
3,19,10,1,2017,10,11849,2183,14032
3,19,10,1,2017,11,11895,2344,14239
3,19,10,1,2017,12,12190,2417,14607
3,19,10,1,2017,13,12364,2393,14757
3,19,10,1,2017,14,12085,2368,14453
3,19,10,1,2017,15,12055,2387,14442
3,19,10,1,2017,16,11963,2377,14340
3,19,10,1,2017,17,11660,2319,13979
3,19,10,1,2017,18,11588,2325,13913
3,19,10,1,2017,19,12474,2556,15030
3,19,10,1,2017,20,12444,2667,15111
3,19,10,1,2017,21,11950,2622,14572
3,19,10,1,2017,22,11796,2566,14362
3,19,10,1,2017,23,11399,2537,13936
3,19,10,1,2017,24,10960,2482,13442
3,20,10,1,2017,1,10670,2328,12998
3,20,10,1,2017,2,10778,2137,12915
3,20,10,1,2017,3,10803,1991,12794
3,20,10,1,2017,4,10895,1903,12798
3,20,10,1,2017,5,11240,1872,13112
3,20,10,1,2017,6,11997,1930,13927
3,20,10,1,2017,7,12626,1942,14568
3,20,10,1,2017,8,12654,1972,14626
3,20,10,1,2017,9,12233,2074,14307
3,20,10,1,2017,10,11898,2246,14144
3,20,10,1,2017,11,12035,2346,14381
3,20,10,1,2017,12,12487,2399,14886
3,20,10,1,2017,13,12374,2398,14772
3,20,10,1,2017,14,12227,2336,14563
3,20,10,1,2017,15,12140,2348,14488
3,20,10,1,2017,16,11865,2313,14178
3,20,10,1,2017,17,11814,2270,14084
3,20,10,1,2017,18,11488,2251,13739
3,20,10,1,2017,19,12473,2426,14899
3,20,10,1,2017,20,12587,2515,15102
3,20,10,1,2017,21,12256,2539,14795
3,20,10,1,2017,22,11809,2496,14305
3,20,10,1,2017,23,11583,2450,14033
3,20,10,1,2017,24,11178,2419,13597
2,21,10,1,2017,1,11067,2296,13363
2,21,10,1,2017,2,10960,2114,13074
2,21,10,1,2017,3,10879,1981,12860
2,21,10,1,2017,4,11059,1895,12954
2,21,10,1,2017,5,11504,1864,13368
2,21,10,1,2017,6,12127,1912,14039
2,21,10,1,2017,7,12888,1920,14808
2,21,10,1,2017,8,12990,1970,14960
2,21,10,1,2017,9,12629,2087,14716
2,21,10,1,2017,10,12481,2243,14724
2,21,10,1,2017,11,12577,2436,15013
2,21,10,1,2017,12,12909,2471,15380
2,21,10,1,2017,13,12883,2460,15343
2,21,10,1,2017,14,12941,2411,15352
2,21,10,1,2017,15,12553,2397,14950
2,21,10,1,2017,16,12708,2374,15082
2,21,10,1,2017,17,12139,2335,14474
2,21,10,1,2017,18,11929,2304,14233
2,21,10,1,2017,19,12882,2451,15333
2,21,10,1,2017,20,13103,2535,15638
2,21,10,1,2017,21,12844,2371,15215
2,21,10,1,2017,22,12345,2377,14722
2,21,10,1,2017,23,11821,2407,14228
2,21,10,1,2017,24,11540,2344,13884
2,22,10,1,2017,1,11198,2259,13457
2,22,10,1,2017,2,11358,2131,13489
2,22,10,1,2017,3,11413,1998,13411
2,22,10,1,2017,4,11525,1919,13444
2,22,10,1,2017,5,11770,1885,13655
2,22,10,1,2017,6,12759,1923,14682
2,22,10,1,2017,7,13156,1916,15072
2,22,10,1,2017,8,13552,1935,15487
2,22,10,1,2017,9,13209,2011,15220
2,22,10,1,2017,10,12912,2107,15019
2,22,10,1,2017,11,13409,2195,15604
2,22,10,1,2017,12,14055,2273,16328
2,22,10,1,2017,13,13995,2264,16259
2,22,10,1,2017,14,13959,2230,16189
2,22,10,1,2017,15,13852,2253,16105
2,22,10,1,2017,16,13904,2245,16149
2,22,10,1,2017,17,13621,2207,15828
2,22,10,1,2017,18,13021,2203,15224
2,22,10,1,2017,19,13637,2450,16087
2,22,10,1,2017,20,13809,2491,16300
2,22,10,1,2017,21,13049,2542,15591
2,22,10,1,2017,22,12721,2429,15150
2,22,10,1,2017,23,12489,2489,14978
2,22,10,1,2017,24,12476,2351,14827
1,23,10,1,2017,1,12252,2317,14569
1,23,10,1,2017,2,12537,2143,14680
1,23,10,1,2017,3,12295,2019,14314
1,23,10,1,2017,4,12414,1940,14354
1,23,10,1,2017,5,12743,1901,14644
1,23,10,1,2017,6,13493,1955,15448
1,23,10,1,2017,7,13667,2020,15687
1,23,10,1,2017,8,14396,2149,16545
1,23,10,1,2017,9,14227,2566,16793
1,23,10,1,2017,10,14428,2827,17255
1,23,10,1,2017,11,14736,3137,17873
1,23,10,1,2017,12,15368,3166,18534
1,23,10,1,2017,13,15325,3156,18481
1,23,10,1,2017,14,15295,3087,18382
1,23,10,1,2017,15,15363,3120,18483
1,23,10,1,2017,16,15381,3128,18509
1,23,10,1,2017,17,15219,3069,18288
1,23,10,1,2017,18,14576,2960,17536
1,23,10,1,2017,19,14894,2965,17859
1,23,10,1,2017,20,15065,2875,17940
1,23,10,1,2017,21,14370,2763,17133
1,23,10,1,2017,22,13904,2580,16484
1,23,10,1,2017,23,13605,2529,16134
1,23,10,1,2017,24,12982,2424,15406
1,24,10,1,2017,1,12550,2318,14868
1,24,10,1,2017,2,12638,2205,14843
1,24,10,1,2017,3,12659,2085,14744
1,24,10,1,2017,4,12738,2000,14738
1,24,10,1,2017,5,13240,1911,15151
1,24,10,1,2017,6,13738,1901,15639
1,24,10,1,2017,7,14767,1964,16731
1,24,10,1,2017,8,14822,2105,16927
1,24,10,1,2017,9,14799,2422,17221
1,24,10,1,2017,10,14830,2714,17544
1,24,10,1,2017,11,15113,2981,18094
1,24,10,1,2017,12,15904,3050,18954
1,24,10,1,2017,13,15831,3033,18864
1,24,10,1,2017,14,15798,2906,18704
1,24,10,1,2017,15,15827,2947,18774
1,24,10,1,2017,16,15850,2986,18836
1,24,10,1,2017,17,15450,2978,18428
1,24,10,1,2017,18,14962,2929,17891
1,24,10,1,2017,19,15278,2946,18224
1,24,10,1,2017,20,15330,2843,18173
1,24,10,1,2017,21,14383,2740,17123
1,24,10,1,2017,22,13982,2577,16559
1,24,10,1,2017,23,13507,2500,16007
1,24,10,1,2017,24,12785,2395,15180
1,25,10,1,2017,1,12700,2233,14933
1,25,10,1,2017,2,12786,2008,14794
1,25,10,1,2017,3,12917,1932,14849
1,25,10,1,2017,4,13008,1848,14856
1,25,10,1,2017,5,13484,1813,15297
1,25,10,1,2017,6,14060,1872,15932
1,25,10,1,2017,7,14865,1952,16817
1,25,10,1,2017,8,15282,2081,17363
1,25,10,1,2017,9,15057,2336,17393
1,25,10,1,2017,10,14933,2736,17669
1,25,10,1,2017,11,15648,2992,18640
1,25,10,1,2017,12,16184,3047,19231
1,25,10,1,2017,13,16044,3020,19064
1,25,10,1,2017,14,15988,2948,18936
1,25,10,1,2017,15,15841,3018,18859
1,25,10,1,2017,16,16175,3025,19200
1,25,10,1,2017,17,15874,3022,18896
1,25,10,1,2017,18,15114,2989,18103
1,25,10,1,2017,19,15254,3003,18257
1,25,10,1,2017,20,15268,2917,18185
1,25,10,1,2017,21,14446,2802,17248
1,25,10,1,2017,22,13875,2608,16483
1,25,10,1,2017,23,13401,2541,15942
1,25,10,1,2017,24,13194,2424,15618
1,26,10,1,2017,1,12920,2270,15190
1,26,10,1,2017,2,12926,2092,15018
1,26,10,1,2017,3,13132,1947,15079
1,26,10,1,2017,4,13232,1857,15089
1,26,10,1,2017,5,13439,1828,15267
1,26,10,1,2017,6,14180,1884,16064
1,26,10,1,2017,7,15156,1954,17110
1,26,10,1,2017,8,15374,2086,17460
1,26,10,1,2017,9,15466,2372,17838
1,26,10,1,2017,10,15121,2743,17864
1,26,10,1,2017,11,15954,3045,18999
1,26,10,1,2017,12,16489,3079,19568
1,26,10,1,2017,13,16499,3031,19530
1,26,10,1,2017,14,16227,2943,19170
1,26,10,1,2017,15,16389,3014,19403
1,26,10,1,2017,16,16174,3046,19220
1,26,10,1,2017,17,15662,3013,18675
1,26,10,1,2017,18,15404,2925,18329
1,26,10,1,2017,19,15308,2933,18241
1,26,10,1,2017,20,15172,2881,18053
1,26,10,1,2017,21,14739,2707,17446
1,26,10,1,2017,22,14070,2651,16721
1,26,10,1,2017,23,13682,2524,16206
1,26,10,1,2017,24,13306,2491,15797
1,27,10,1,2017,1,13181,2315,15496
1,27,10,1,2017,2,13234,2124,15358
1,27,10,1,2017,3,13529,1999,15528
1,27,10,1,2017,4,13465,1909,15374
1,27,10,1,2017,5,13859,1869,15728
1,27,10,1,2017,6,14744,1905,16649
1,27,10,1,2017,7,15209,2000,17209
1,27,10,1,2017,8,15784,2172,17956
1,27,10,1,2017,9,15735,2462,18197
1,27,10,1,2017,10,15413,2790,18203
1,27,10,1,2017,11,15946,3040,18986
1,27,10,1,2017,12,16556,3165,19721
1,27,10,1,2017,13,16112,3134,19246
1,27,10,1,2017,14,16130,3024,19154
1,27,10,1,2017,15,16173,3082,19255
1,27,10,1,2017,16,15779,3117,18896
1,27,10,1,2017,17,15526,3084,18610
1,27,10,1,2017,18,14854,3006,17860
1,27,10,1,2017,19,15275,3015,18290
1,27,10,1,2017,20,15181,2920,18101
1,27,10,1,2017,21,14311,2777,17088
1,27,10,1,2017,22,13935,2669,16604
1,27,10,1,2017,23,13687,2544,16231
1,27,10,1,2017,24,13314,2380,15694
2,28,10,1,2017,1,13089,2325,15414
2,28,10,1,2017,2,13420,2141,15561
2,28,10,1,2017,3,13595,2013,15608
2,28,10,1,2017,4,13533,1929,15462
2,28,10,1,2017,5,13771,1889,15660
2,28,10,1,2017,6,14337,1930,16267
2,28,10,1,2017,7,15207,1971,17178
2,28,10,1,2017,8,15737,2061,17798
2,28,10,1,2017,9,15573,2204,17777
2,28,10,1,2017,10,15550,2567,18117
2,28,10,1,2017,11,16146,2785,18931
2,28,10,1,2017,12,16783,2880,19663
2,28,10,1,2017,13,16768,2871,19639
2,28,10,1,2017,14,16407,2747,19154
2,28,10,1,2017,15,16354,2779,19133
2,28,10,1,2017,16,16444,2772,19216
2,28,10,1,2017,17,16123,2734,18857
2,28,10,1,2017,18,15384,2668,18052
2,28,10,1,2017,19,15644,2755,18399
2,28,10,1,2017,20,15411,2778,18189
2,28,10,1,2017,21,14761,2575,17336
2,28,10,1,2017,22,14157,2551,16708
2,28,10,1,2017,23,13739,2457,16196
2,28,10,1,2017,24,13503,2322,15825
2,29,10,1,2017,1,13232,2243,15475
2,29,10,1,2017,2,13509,2077,15586
2,29,10,1,2017,3,13537,1958,15495
2,29,10,1,2017,4,13797,1879,15676
2,29,10,1,2017,5,13957,1839,15796
2,29,10,1,2017,6,14677,1866,16543
2,29,10,1,2017,7,15484,1882,17366
2,29,10,1,2017,8,15415,1900,17315
2,29,10,1,2017,9,15438,1985,17423
2,29,10,1,2017,10,15116,2134,17250
2,29,10,1,2017,11,16005,2218,18223
2,29,10,1,2017,12,16716,2293,19009
2,29,10,1,2017,13,16351,2300,18651
2,29,10,1,2017,14,16093,2256,18349
2,29,10,1,2017,15,16278,2265,18543
2,29,10,1,2017,16,16346,2263,18609
2,29,10,1,2017,17,15914,2245,18159
2,29,10,1,2017,18,14967,2216,17183
2,29,10,1,2017,19,15189,2398,17587
2,29,10,1,2017,20,14999,2443,17442
2,29,10,1,2017,21,14007,2456,16463
2,29,10,1,2017,22,13660,2392,16052
2,29,10,1,2017,23,13418,2401,15819
2,29,10,1,2017,24,12943,2332,15275
1,30,10,1,2017,1,12991,2189,15180
1,30,10,1,2017,2,13075,2034,15109
1,30,10,1,2017,3,13282,1903,15185
1,30,10,1,2017,4,13380,1817,15197
1,30,10,1,2017,5,13898,1790,15688
1,30,10,1,2017,6,14636,1850,16486
1,30,10,1,2017,7,15459,1959,17418
1,30,10,1,2017,8,15714,2128,17842
1,30,10,1,2017,9,15789,2411,18200
1,30,10,1,2017,10,15326,2849,18175
1,30,10,1,2017,11,16280,2986,19266
1,30,10,1,2017,12,16844,3081,19925
1,30,10,1,2017,13,16735,3054,19789
1,30,10,1,2017,14,16394,2964,19358
1,30,10,1,2017,15,16103,2987,19090
1,30,10,1,2017,16,16431,3011,19442
1,30,10,1,2017,17,16100,2972,19072
1,30,10,1,2017,18,15255,2935,18190
1,30,10,1,2017,19,15633,2968,18601
1,30,10,1,2017,20,15306,2914,18220
1,30,10,1,2017,21,14490,2730,17220
1,30,10,1,2017,22,14005,2603,16608
1,30,10,1,2017,23,13369,2492,15861
1,30,10,1,2017,24,13153,2432,15585
1,31,10,1,2017,1,13045,2276,15321
1,31,10,1,2017,2,13333,2052,15385
1,31,10,1,2017,3,13668,1959,15627
1,31,10,1,2017,4,13735,1878,15613
1,31,10,1,2017,5,14211,1856,16067
1,31,10,1,2017,6,14960,1925,16885
1,31,10,1,2017,7,15640,2033,17673
1,31,10,1,2017,8,16107,2224,18331
1,31,10,1,2017,9,15712,2453,18165
1,31,10,1,2017,10,15703,2872,18575
1,31,10,1,2017,11,16590,2990,19580
1,31,10,1,2017,12,16532,3076,19608
1,31,10,1,2017,13,16712,3015,19727
1,31,10,1,2017,14,16369,2923,19292
1,31,10,1,2017,15,16364,2954,19318
1,31,10,1,2017,16,16269,2968,19237
1,31,10,1,2017,17,16202,2936,19138
1,31,10,1,2017,18,15476,2921,18397
1,31,10,1,2017,19,15674,2971,18645
1,31,10,1,2017,20,15423,2867,18290
1,31,10,1,2017,21,14448,2741,17189
1,31,10,1,2017,22,13651,2540,16191
1,31,10,1,2017,23,13290,2438,15728
1,31,10,1,2017,24,13199,2362,15561
1,1,11,1,2017,1,12914,2197,15111
1,1,11,1,2017,2,13285,2029,15314
1,1,11,1,2017,3,13323,1908,15231
1,1,11,1,2017,4,13590,1826,15416
1,1,11,1,2017,5,13857,1793,15650
1,1,11,1,2017,6,14805,1873,16678
1,1,11,1,2017,7,15458,1984,17442
1,1,11,1,2017,8,16034,2120,18154
1,1,11,1,2017,9,15883,2390,18273
1,1,11,1,2017,10,15389,2755,18144
1,1,11,1,2017,11,15788,2944,18732
1,1,11,1,2017,12,16878,3041,19919
1,1,11,1,2017,13,16285,3024,19309
1,1,11,1,2017,14,16128,2899,19027
1,1,11,1,2017,15,16286,2934,19220
1,1,11,1,2017,16,16305,2966,19271
1,1,11,1,2017,17,16074,2944,19018
1,1,11,1,2017,18,15430,2877,18307
1,1,11,1,2017,19,15751,2931,18682
1,1,11,1,2017,20,14829,2878,17707
1,1,11,1,2017,21,14174,2719,16893
1,1,11,1,2017,22,13678,2616,16294
1,1,11,1,2017,23,13252,2481,15733
1,1,11,1,2017,24,12786,2397,15183
1,2,11,1,2017,1,12690,2153,14843
1,2,11,1,2017,2,12941,2013,14954
1,2,11,1,2017,3,13197,1885,15082
1,2,11,1,2017,4,13545,1797,15342
1,2,11,1,2017,5,13795,1768,15563
1,2,11,1,2017,6,14949,1848,16797
1,2,11,1,2017,7,15427,1966,17393
1,2,11,1,2017,8,16131,2101,18232
1,2,11,1,2017,9,15702,2431,18133
1,2,11,1,2017,10,15642,2661,18303
1,2,11,1,2017,11,16554,2941,19495
1,2,11,1,2017,12,16868,2966,19834
1,2,11,1,2017,13,16408,2955,19363
1,2,11,1,2017,14,16438,2867,19305
1,2,11,1,2017,15,16429,2912,19341
1,2,11,1,2017,16,16368,2945,19313
1,2,11,1,2017,17,16224,2904,19128
1,2,11,1,2017,18,15843,2845,18688
1,2,11,1,2017,19,15680,2869,18549
1,2,11,1,2017,20,14860,2889,17749
1,2,11,1,2017,21,14044,2772,16816
1,2,11,1,2017,22,13709,2516,16225
1,2,11,1,2017,23,13172,2439,15611
1,2,11,1,2017,24,12832,2348,15180
1,3,11,1,2017,1,12639,2157,14796
1,3,11,1,2017,2,13221,1994,15215
1,3,11,1,2017,3,13404,1872,15276
1,3,11,1,2017,4,13846,1796,15642
1,3,11,1,2017,5,14222,1765,15987
1,3,11,1,2017,6,15163,1855,17018
1,3,11,1,2017,7,15899,1952,17851
1,3,11,1,2017,8,16243,2089,18332
1,3,11,1,2017,9,15920,2291,18211
1,3,11,1,2017,10,15562,2695,18257
1,3,11,1,2017,11,16114,2922,19036
1,3,11,1,2017,12,16208,2970,19178
1,3,11,1,2017,13,15993,2946,18939
1,3,11,1,2017,14,15638,2850,18488
1,3,11,1,2017,15,15707,2824,18531
1,3,11,1,2017,16,15800,2891,18691
1,3,11,1,2017,17,15434,2866,18300
1,3,11,1,2017,18,15129,2840,17969
1,3,11,1,2017,19,15203,2911,18114
1,3,11,1,2017,20,14194,2839,17033
1,3,11,1,2017,21,13666,2664,16330
1,3,11,1,2017,22,13179,2542,15721
1,3,11,1,2017,23,12699,2395,15094
1,3,11,1,2017,24,12305,2308,14613
3,4,11,1,2017,1,12451,2108,14559
3,4,11,1,2017,2,12819,1957,14776
3,4,11,1,2017,3,13380,1835,15215
3,4,11,1,2017,4,13496,1759,15255
3,4,11,1,2017,5,13827,1735,15562
3,4,11,1,2017,6,14737,1804,16541
3,4,11,1,2017,7,15660,1847,17507
3,4,11,1,2017,8,15601,1928,17529
3,4,11,1,2017,9,16050,2117,18166
3,4,11,1,2017,10,15713,2411,18124
3,4,11,1,2017,11,16267,2655,18922
3,4,11,1,2017,12,16993,2704,19697
3,4,11,1,2017,13,16733,2683,19416
3,4,11,1,2017,14,16633,2584,19217
3,4,11,1,2017,15,16779,2592,19371
3,4,11,1,2017,16,16733,2605,19338
3,4,11,1,2017,17,16413,2578,18991
3,4,11,1,2017,18,15619,2602,18221
3,4,11,1,2017,19,15517,2692,18209
3,4,11,1,2017,20,14669,2670,17339
3,4,11,1,2017,21,13834,2579,16413
3,4,11,1,2017,22,13117,2403,15520
3,4,11,1,2017,23,12691,2294,14985
3,4,11,1,2017,24,12519,2188,14707
2,5,11,1,2017,1,12565,2065,14630
2,5,11,1,2017,2,13011,1915,14926
2,5,11,1,2017,3,13249,1803,15052
2,5,11,1,2017,4,13596,1732,15328
2,5,11,1,2017,5,13997,1707,15704
2,5,11,1,2017,6,14868,1755,16623
2,5,11,1,2017,7,15448,1760,17208
2,5,11,1,2017,8,15877,1775,17652
2,5,11,1,2017,9,15684,1911,17595
2,5,11,1,2017,10,15552,2012,17564
2,5,11,1,2017,11,16181,2145,18326
2,5,11,1,2017,12,17019,2172,19191
2,5,11,1,2017,13,16735,2168,18903
2,5,11,1,2017,14,16637,2123,18760
2,5,11,1,2017,15,16887,2138,19025
2,5,11,1,2017,16,16669,2128,18797
2,5,11,1,2017,17,16346,2122,18468
2,5,11,1,2017,18,15465,2125,17590
2,5,11,1,2017,19,15150,2264,17414
2,5,11,1,2017,20,14202,2317,16519
2,5,11,1,2017,21,13291,2324,15615
2,5,11,1,2017,22,12916,2286,15202
2,5,11,1,2017,23,12471,2250,14721
2,5,11,1,2017,24,12112,2222,14334
1,6,11,1,2017,1,12562,2056,14618
1,6,11,1,2017,2,12991,1898,14889
1,6,11,1,2017,3,13273,1798,15071
1,6,11,1,2017,4,13473,1729,15202
1,6,11,1,2017,5,13715,1724,15439
1,6,11,1,2017,6,14694,1824,16518
1,6,11,1,2017,7,15533,1964,17497
1,6,11,1,2017,8,16069,2144,18213
1,6,11,1,2017,9,15792,2366,18158
1,6,11,1,2017,10,15684,2724,18408
1,6,11,1,2017,11,16667,3012,19679
1,6,11,1,2017,12,17967,3065,21032
1,6,11,1,2017,13,17637,3084,20721
1,6,11,1,2017,14,17574,2983,20557
1,6,11,1,2017,15,17733,3070,20803
1,6,11,1,2017,16,17608,3064,20672
1,6,11,1,2017,17,17417,3016,20433
1,6,11,1,2017,18,16488,3018,19506
1,6,11,1,2017,19,16179,2924,19103
1,6,11,1,2017,20,15529,2722,18251
1,6,11,1,2017,21,14462,2722,17184
1,6,11,1,2017,22,13992,2629,16621
1,6,11,1,2017,23,13739,2519,16258
1,6,11,1,2017,24,13211,2440,15651
1,7,11,1,2017,1,13424,2268,15692
1,7,11,1,2017,2,13792,2045,15837
1,7,11,1,2017,3,14412,1928,16340
1,7,11,1,2017,4,14476,1850,16326
1,7,11,1,2017,5,14817,1824,16641
1,7,11,1,2017,6,15849,1923,17772
1,7,11,1,2017,7,16730,2053,18783
1,7,11,1,2017,8,17077,2205,19282
1,7,11,1,2017,9,16972,2413,19385
1,7,11,1,2017,10,16275,2793,19068
1,7,11,1,2017,11,17264,3017,20281
1,7,11,1,2017,12,18080,3082,21162
1,7,11,1,2017,13,18200,3039,21239
1,7,11,1,2017,14,17774,2953,20727
1,7,11,1,2017,15,18208,3022,21230
1,7,11,1,2017,16,18036,3040,21076
1,7,11,1,2017,17,17555,3009,20564
1,7,11,1,2017,18,16683,2945,19628
1,7,11,1,2017,19,16123,3003,19126
1,7,11,1,2017,20,15110,2919,18029
1,7,11,1,2017,21,14400,2756,17156
1,7,11,1,2017,22,13974,2635,16609
1,7,11,1,2017,23,13617,2542,16159
1,7,11,1,2017,24,13456,2478,15934
1,8,11,1,2017,1,13395,2230,15625
1,8,11,1,2017,2,13789,2056,15845
1,8,11,1,2017,3,14220,1929,16149
1,8,11,1,2017,4,14610,1845,16455
1,8,11,1,2017,5,15062,1816,16878
1,8,11,1,2017,6,15852,1917,17769
1,8,11,1,2017,7,16978,2061,19039
1,8,11,1,2017,8,17080,2201,19281
1,8,11,1,2017,9,16842,2570,19412
1,8,11,1,2017,10,16668,2739,19407
1,8,11,1,2017,11,17220,3026,20246
1,8,11,1,2017,12,18136,3088,21224
1,8,11,1,2017,13,18161,3058,21219
1,8,11,1,2017,14,17936,2938,20874
1,8,11,1,2017,15,17961,2995,20956
1,8,11,1,2017,16,18090,3024,21114
1,8,11,1,2017,17,17536,3010,20546
1,8,11,1,2017,18,16575,2972,19547
1,8,11,1,2017,19,16165,3002,19167
1,8,11,1,2017,20,15331,2904,18235
1,8,11,1,2017,21,14629,2765,17394
1,8,11,1,2017,22,14124,2612,16736
1,8,11,1,2017,23,13571,2506,16077
1,8,11,1,2017,24,13348,2392,15740
1,9,11,1,2017,1,13290,2205,15495
1,9,11,1,2017,2,13814,2010,15824
1,9,11,1,2017,3,14310,1890,16200
1,9,11,1,2017,4,14560,1810,16370
1,9,11,1,2017,5,14977,1796,16773
1,9,11,1,2017,6,15991,1902,17893
1,9,11,1,2017,7,17044,2024,19068
1,9,11,1,2017,8,17146,2175,19321
1,9,11,1,2017,9,16584,2455,19039
1,9,11,1,2017,10,16677,2782,19459
1,9,11,1,2017,11,17584,3008,20592
1,9,11,1,2017,12,18401,3065,21466
1,9,11,1,2017,13,18073,3021,21094
1,9,11,1,2017,14,18227,2906,21133
1,9,11,1,2017,15,18046,2960,21006
1,9,11,1,2017,16,18008,2987,20995
1,9,11,1,2017,17,17540,2958,20498
1,9,11,1,2017,18,16446,2911,19357
1,9,11,1,2017,19,16121,2935,19056
1,9,11,1,2017,20,15302,2799,18101
1,9,11,1,2017,21,14232,2687,16919
1,9,11,1,2017,22,13659,2555,16214
1,9,11,1,2017,23,13306,2439,15745
1,9,11,1,2017,24,12994,2326,15320
1,10,11,1,2017,1,13164,2129,15293
1,10,11,1,2017,2,13588,1948,15536
1,10,11,1,2017,3,14200,1833,16033
1,10,11,1,2017,4,14434,1772,16206
1,10,11,1,2017,5,14944,1764,16708
1,10,11,1,2017,6,15700,1871,17571
1,10,11,1,2017,7,16802,2018,18820
1,10,11,1,2017,8,16856,2171,19027
1,10,11,1,2017,9,16418,2448,18866
1,10,11,1,2017,10,16252,2771,19023
1,10,11,1,2017,11,16903,2993,19896
1,10,11,1,2017,12,17501,3041,20542
1,10,11,1,2017,13,17572,2977,20549
1,10,11,1,2017,14,17416,2846,20262
1,10,11,1,2017,15,17585,2905,20490
1,10,11,1,2017,16,17345,2933,20278
1,10,11,1,2017,17,16810,2929,19739
1,10,11,1,2017,18,16105,2894,18999
1,10,11,1,2017,19,15452,2941,18393
1,10,11,1,2017,20,14720,2860,17580
1,10,11,1,2017,21,13945,2712,16657
1,10,11,1,2017,22,13516,2563,16079
1,10,11,1,2017,23,13064,2444,15508
1,10,11,1,2017,24,12576,2329,14905
2,11,11,1,2017,1,12840,2180,15020
2,11,11,1,2017,2,13551,1979,15530
2,11,11,1,2017,3,14042,1851,15893
2,11,11,1,2017,4,14189,1777,15966
2,11,11,1,2017,5,14513,1777,16290
2,11,11,1,2017,6,15225,1863,17088
2,11,11,1,2017,7,16188,1935,18123
2,11,11,1,2017,8,16545,2018,18563
2,11,11,1,2017,9,16460,2202,18662
2,11,11,1,2017,10,16266,2470,18736
2,11,11,1,2017,11,16955,2689,19644
2,11,11,1,2017,12,17582,2756,20338
2,11,11,1,2017,13,17702,2717,20419
2,11,11,1,2017,14,17127,2590,19717
2,11,11,1,2017,15,17742,2601,20343
2,11,11,1,2017,16,17509,2601,20110
2,11,11,1,2017,17,17164,2594,19758
2,11,11,1,2017,18,16217,2603,18820
2,11,11,1,2017,19,15979,2729,18708
2,11,11,1,2017,20,14889,2666,17555
2,11,11,1,2017,21,14018,2569,16587
2,11,11,1,2017,22,13462,2449,15911
2,11,11,1,2017,23,12811,2348,15159
2,11,11,1,2017,24,12386,2248,14634
2,12,11,1,2017,1,12538,2115,14653
2,12,11,1,2017,2,13103,1952,15055
2,12,11,1,2017,3,13674,1839,15513
2,12,11,1,2017,4,14023,1761,15784
2,12,11,1,2017,5,14486,1735,16221
2,12,11,1,2017,6,15031,1795,16826
2,12,11,1,2017,7,15759,1808,17567
2,12,11,1,2017,8,15978,1836,17814
2,12,11,1,2017,9,16202,1927,18129
2,12,11,1,2017,10,16083,2041,18124
2,12,11,1,2017,11,16825,2146,18971
2,12,11,1,2017,12,17638,2171,19809
2,12,11,1,2017,13,17636,2115,19751
2,12,11,1,2017,14,17330,2060,19390
2,12,11,1,2017,15,17470,2067,19537
2,12,11,1,2017,16,17161,2031,19192
2,12,11,1,2017,17,16590,2026,18616
2,12,11,1,2017,18,15567,2065,17632
2,12,11,1,2017,19,15351,2219,17570
2,12,11,1,2017,20,14008,2217,16225
2,12,11,1,2017,21,13495,2223,15718
2,12,11,1,2017,22,12732,2194,14926
2,12,11,1,2017,23,12373,2133,14506
2,12,11,1,2017,24,12171,2047,14218
1,13,11,1,2017,1,12423,1923,14346
1,13,11,1,2017,2,12965,1773,14738
1,13,11,1,2017,3,13460,1674,15134
1,13,11,1,2017,4,13653,1622,15275
1,13,11,1,2017,5,14292,1610,15902
1,13,11,1,2017,6,15114,1721,16835
1,13,11,1,2017,7,16224,1891,18116
1,13,11,1,2017,8,16944,2028,18972
1,13,11,1,2017,9,16546,2316,18862
1,13,11,1,2017,10,16216,2616,18832
1,13,11,1,2017,11,17059,2839,19898
1,13,11,1,2017,12,18097,2880,20977
1,13,11,1,2017,13,17565,2829,20394
1,13,11,1,2017,14,17861,2737,20598
1,13,11,1,2017,15,17612,2763,20375
1,13,11,1,2017,16,17270,2771,20041
1,13,11,1,2017,17,16992,2761,19753
1,13,11,1,2017,18,16247,2741,18988
1,13,11,1,2017,19,15973,2773,18746
1,13,11,1,2017,20,14746,2704,17450
1,13,11,1,2017,21,13937,2554,16491
1,13,11,1,2017,22,13228,2430,15658
1,13,11,1,2017,23,12677,2255,14932
1,13,11,1,2017,24,12348,2128,14476
1,14,11,1,2017,1,12578,1969,14547
1,14,11,1,2017,2,13186,1803,14989
1,14,11,1,2017,3,14039,1697,15736
1,14,11,1,2017,4,14211,1631,15842
1,14,11,1,2017,5,14641,1638,16279
1,14,11,1,2017,6,15424,1739,17163
1,14,11,1,2017,7,16315,1910,18225
1,14,11,1,2017,8,17088,2061,19149
1,14,11,1,2017,9,16566,2329,18895
1,14,11,1,2017,10,16436,2625,19061
1,14,11,1,2017,11,17597,2858,20455
1,14,11,1,2017,12,17855,2891,20746
1,14,11,1,2017,13,17924,2839,20763
1,14,11,1,2017,14,17447,2719,20166
1,14,11,1,2017,15,17563,2759,20322
1,14,11,1,2017,16,17637,2791,20428
1,14,11,1,2017,17,17017,2795,19812
1,14,11,1,2017,18,16278,2767,19045
1,14,11,1,2017,19,15996,2797,18793
1,14,11,1,2017,20,14969,2662,17631
1,14,11,1,2017,21,13922,2545,16467
1,14,11,1,2017,22,12954,2345,15299
1,14,11,1,2017,23,12593,2205,14798
1,14,11,1,2017,24,12244,2058,14302
1,15,11,1,2017,1,12668,1871,14539
1,15,11,1,2017,2,13175,1730,14905
1,15,11,1,2017,3,13805,1639,15444
1,15,11,1,2017,4,14172,1589,15761
1,15,11,1,2017,5,14903,1584,16487
1,15,11,1,2017,6,15853,1706,17559
1,15,11,1,2017,7,16650,1869,18519
1,15,11,1,2017,8,17239,2029,19268
1,15,11,1,2017,9,16765,2290,19055
1,15,11,1,2017,10,16630,2600,19230
1,15,11,1,2017,11,17297,2828,20125
1,15,11,1,2017,12,17992,2891,20883
1,15,11,1,2017,13,17862,2874,20736
1,15,11,1,2017,14,17553,2755,20308
1,15,11,1,2017,15,17686,2798,20484
1,15,11,1,2017,16,17601,2841,20442
1,15,11,1,2017,17,17392,2829,20221
1,15,11,1,2017,18,16161,2802,18963
1,15,11,1,2017,19,15948,2829,18777
1,15,11,1,2017,20,15016,2697,17713
1,15,11,1,2017,21,14049,2561,16610
1,15,11,1,2017,22,13326,2361,15687
1,15,11,1,2017,23,12957,2221,15178
1,15,11,1,2017,24,12525,2075,14600
1,16,11,1,2017,1,12636,1969,14605
1,16,11,1,2017,2,13277,1803,15080
1,16,11,1,2017,3,13864,1697,15561
1,16,11,1,2017,4,14041,1630,15671
1,16,11,1,2017,5,14624,1638,16262
1,16,11,1,2017,6,15709,1739,17448
1,16,11,1,2017,7,16331,1910,18241
1,16,11,1,2017,8,17037,2061,19098
1,16,11,1,2017,9,16914,2329,19243
1,16,11,1,2017,10,16667,2624,19291
1,16,11,1,2017,11,17021,2858,19879
1,16,11,1,2017,12,17924,2891,20815
1,16,11,1,2017,13,17758,2867,20625
1,16,11,1,2017,14,17242,2747,19989
1,16,11,1,2017,15,17580,2787,20367
1,16,11,1,2017,16,17356,2819,20175
1,16,11,1,2017,17,16996,2823,19819
1,16,11,1,2017,18,16155,2795,18950
1,16,11,1,2017,19,16058,2825,18883
1,16,11,1,2017,20,15006,2690,17696
1,16,11,1,2017,21,14089,2528,16617
1,16,11,1,2017,22,13609,2328,15937
1,16,11,1,2017,23,12807,2188,14995
1,16,11,1,2017,24,12616,2042,14658
1,17,11,1,2017,1,12731,1808,14539
1,17,11,1,2017,2,13460,1669,15129
1,17,11,1,2017,3,13825,1580,15405
1,17,11,1,2017,4,14103,1529,15632
1,17,11,1,2017,5,14668,1532,16200
1,17,11,1,2017,6,15707,1655,17362
1,17,11,1,2017,7,16433,1831,18264
1,17,11,1,2017,8,17060,1996,19056
1,17,11,1,2017,9,16613,2219,18832
1,17,11,1,2017,10,16262,2533,18795
1,17,11,1,2017,11,16767,2758,19525
1,17,11,1,2017,12,17596,2859,20455
1,17,11,1,2017,13,17247,2801,20048
1,17,11,1,2017,14,17565,2675,20240
1,17,11,1,2017,15,17195,2706,19901
1,17,11,1,2017,16,17059,2742,19801
1,17,11,1,2017,17,16356,2841,19197
1,17,11,1,2017,18,16142,2827,18969
1,17,11,1,2017,19,15606,2875,18481
1,17,11,1,2017,20,14875,2687,17562
1,17,11,1,2017,21,13729,2532,16261
1,17,11,1,2017,22,13448,2329,15777
1,17,11,1,2017,23,12924,2178,15102
1,17,11,1,2017,24,12622,2092,14714
2,18,11,1,2017,1,12713,1774,14487
2,18,11,1,2017,2,13583,1678,15261
2,18,11,1,2017,3,13834,1652,15486
2,18,11,1,2017,4,14002,1618,15620
2,18,11,1,2017,5,14667,1625,16292
2,18,11,1,2017,6,15654,1683,17337
2,18,11,1,2017,7,16273,1842,18115
2,18,11,1,2017,8,16811,2040,18851
2,18,11,1,2017,9,16581,2129,18710
2,18,11,1,2017,10,16446,2375,18821
2,18,11,1,2017,11,17341,2623,19964
2,18,11,1,2017,12,18147,2759,20906
2,18,11,1,2017,13,17818,2706,20524
2,18,11,1,2017,14,17765,2606,20371
2,18,11,1,2017,15,17537,2618,20155
2,18,11,1,2017,16,17632,2599,20231
2,18,11,1,2017,17,17258,2573,19831
2,18,11,1,2017,18,16233,2565,18798
2,18,11,1,2017,19,15946,2624,18570
2,18,11,1,2017,20,15066,2516,17582
2,18,11,1,2017,21,14023,2424,16447
2,18,11,1,2017,22,13446,2317,15763
2,18,11,1,2017,23,12989,2129,15118
2,18,11,1,2017,24,12668,2012,14680
2,19,11,1,2017,1,12860,1851,14711
2,19,11,1,2017,2,13336,1726,15062
2,19,11,1,2017,3,13999,1650,15649
2,19,11,1,2017,4,14261,1571,15832
2,19,11,1,2017,5,14712,1563,16275
2,19,11,1,2017,6,15469,1631,17100
2,19,11,1,2017,7,16227,1681,17908
2,19,11,1,2017,8,16649,1786,18435
2,19,11,1,2017,9,16606,1885,18491
2,19,11,1,2017,10,16479,1995,18474
2,19,11,1,2017,11,17116,2109,19225
2,19,11,1,2017,12,18063,2135,20198
2,19,11,1,2017,13,17953,2151,20104
2,19,11,1,2017,14,17687,2097,19784
2,19,11,1,2017,15,17381,2077,19458
2,19,11,1,2017,16,17170,2039,19209
2,19,11,1,2017,17,16850,2023,18873
2,19,11,1,2017,18,15831,2060,17891
2,19,11,1,2017,19,15433,2220,17653
2,19,11,1,2017,20,14602,2224,16826
2,19,11,1,2017,21,13609,2235,15844
2,19,11,1,2017,22,13229,2186,15415
2,19,11,1,2017,23,12802,2109,14911
2,19,11,1,2017,24,12533,1959,14492
1,20,11,1,2017,1,12812,1843,14655
1,20,11,1,2017,2,13205,1719,14924
1,20,11,1,2017,3,13547,1643,15190
1,20,11,1,2017,4,13816,1590,15406
1,20,11,1,2017,5,14288,1598,15886
1,20,11,1,2017,6,15022,1721,16743
1,20,11,1,2017,7,15827,1940,17767
1,20,11,1,2017,8,16599,2087,18686
1,20,11,1,2017,9,16567,2339,18906
1,20,11,1,2017,10,16139,2636,18775
1,20,11,1,2017,11,16893,2836,19729
1,20,11,1,2017,12,17730,2860,20590
1,20,11,1,2017,13,17767,2825,20592
1,20,11,1,2017,14,17561,2746,20307
1,20,11,1,2017,15,17903,2793,20696
1,20,11,1,2017,16,17682,2821,20503
1,20,11,1,2017,17,17522,2809,20331
1,20,11,1,2017,18,16309,2786,19095
1,20,11,1,2017,19,16298,2851,19149
1,20,11,1,2017,20,15128,2739,17867
1,20,11,1,2017,21,14310,2588,16898
1,20,11,1,2017,22,13796,2432,16228
1,20,11,1,2017,23,13347,2308,15655
1,20,11,1,2017,24,12847,2163,15010
1,21,11,1,2017,1,12814,2003,14817
1,21,11,1,2017,2,13453,1840,15293
1,21,11,1,2017,3,13937,1738,15675
1,21,11,1,2017,4,14047,1669,15716
1,21,11,1,2017,5,14622,1670,16292
1,21,11,1,2017,6,15604,1791,17395
1,21,11,1,2017,7,16381,1954,18335
1,21,11,1,2017,8,16951,2133,19084
1,21,11,1,2017,9,16853,2423,19276
1,21,11,1,2017,10,16399,2739,19138
1,21,11,1,2017,11,17182,2972,20154
1,21,11,1,2017,12,18093,3048,21141
1,21,11,1,2017,13,17978,2989,20966
1,21,11,1,2017,14,17774,2884,20658
1,21,11,1,2017,15,17850,2922,20772
1,21,11,1,2017,16,18066,2927,20994
1,21,11,1,2017,17,17530,2919,20449
1,21,11,1,2017,18,16755,2868,19623
1,21,11,1,2017,19,16177,2893,19070
1,21,11,1,2017,20,15408,2785,18193
1,21,11,1,2017,21,14426,2654,17080
1,21,11,1,2017,22,13998,2486,16484
1,21,11,1,2017,23,13580,2362,15942
1,21,11,1,2017,24,13154,2226,15380
1,22,11,1,2017,1,13420,2044,15464
1,22,11,1,2017,2,13771,1880,15651
1,22,11,1,2017,3,14098,1784,15882
1,22,11,1,2017,4,14378,1708,16086
1,22,11,1,2017,5,14836,1704,16540
1,22,11,1,2017,6,15308,1830,17138
1,22,11,1,2017,7,16227,2000,18227
1,22,11,1,2017,8,17010,2161,19171
1,22,11,1,2017,9,16925,2411,19336
1,22,11,1,2017,10,16815,2775,19590
1,22,11,1,2017,11,16990,3004,19994
1,22,11,1,2017,12,18076,3084,21160
1,22,11,1,2017,13,17817,3043,20860
1,22,11,1,2017,14,17777,2934,20711
1,22,11,1,2017,15,18093,2962,21055
1,22,11,1,2017,16,16993,2961,19954
1,22,11,1,2017,17,16979,2904,19883
1,22,11,1,2017,18,16156,2843,18999
1,22,11,1,2017,19,15942,2870,18812
1,22,11,1,2017,20,15330,2769,18098
1,22,11,1,2017,21,14589,2595,17184
1,22,11,1,2017,22,13981,2442,16423
1,22,11,1,2017,23,13545,2306,15851
1,22,11,1,2017,24,13029,2185,15214
1,23,11,1,2017,1,13154,2005,15159
1,23,11,1,2017,2,13515,1850,15365
1,23,11,1,2017,3,13846,1749,15595
1,23,11,1,2017,4,14063,1673,15736
1,23,11,1,2017,5,14568,1672,16240
1,23,11,1,2017,6,15271,1771,17042
1,23,11,1,2017,7,16284,1938,18222
1,23,11,1,2017,8,16700,2078,18778
1,23,11,1,2017,9,16536,2368,18904
1,23,11,1,2017,10,16422,2660,19082
1,23,11,1,2017,11,16989,2866,19855
1,23,11,1,2017,12,17816,2959,20775
1,23,11,1,2017,13,17556,2901,20457
1,23,11,1,2017,14,17533,2804,20337
1,23,11,1,2017,15,17633,2840,20473
1,23,11,1,2017,16,17415,2854,20269
1,23,11,1,2017,17,17135,2836,19971
1,23,11,1,2017,18,16201,2787,18988
1,23,11,1,2017,19,16161,2814,18975
1,23,11,1,2017,20,15355,2674,18029
1,23,11,1,2017,21,14448,2503,16951
1,23,11,1,2017,22,13991,2336,16327
1,23,11,1,2017,23,13378,2206,15584
1,23,11,1,2017,24,12933,2067,15000
1,24,11,1,2017,1,13039,1901,14940
1,24,11,1,2017,2,13485,1754,15239
1,24,11,1,2017,3,13850,1654,15504
1,24,11,1,2017,4,13883,1600,15483
1,24,11,1,2017,5,14336,1597,15933
1,24,11,1,2017,6,15371,1715,17086
1,24,11,1,2017,7,16202,1875,18077
1,24,11,1,2017,8,16813,2024,18837
1,24,11,1,2017,9,16449,2295,18744
1,24,11,1,2017,10,16099,2600,18699
1,24,11,1,2017,11,16704,2841,19545
1,24,11,1,2017,12,17350,2898,20248
1,24,11,1,2017,13,17510,2851,20361
1,24,11,1,2017,14,17045,2721,19766
1,24,11,1,2017,15,17121,2748,19869
1,24,11,1,2017,16,16748,2759,19507
1,24,11,1,2017,17,16534,2748,19282
1,24,11,1,2017,18,15637,2716,18353
1,24,11,1,2017,19,15376,2762,18138
1,24,11,1,2017,20,14534,2663,17197
1,24,11,1,2017,21,13855,2518,16373
1,24,11,1,2017,22,13353,2350,15703
1,24,11,1,2017,23,12838,2203,15041
1,24,11,1,2017,24,12567,2071,14638
2,25,11,1,2017,1,12491,1902,14393
2,25,11,1,2017,2,13065,1753,14818
2,25,11,1,2017,3,13476,1654,15130
2,25,11,1,2017,4,13636,1593,15229
2,25,11,1,2017,5,14129,1591,15720
2,25,11,1,2017,6,15077,1669,16746
2,25,11,1,2017,7,16026,1772,17798
2,25,11,1,2017,8,16296,1886,18182
2,25,11,1,2017,9,16118,2082,18200
2,25,11,1,2017,10,15941,2341,18282
2,25,11,1,2017,11,16817,2547,19364
2,25,11,1,2017,12,17546,2651,20197
2,25,11,1,2017,13,17603,2645,20248
2,25,11,1,2017,14,17372,2521,19893
2,25,11,1,2017,15,17284,2528,19812
2,25,11,1,2017,16,17135,2517,19652
2,25,11,1,2017,17,17058,2496,19554
2,25,11,1,2017,18,16052,2498,18550
2,25,11,1,2017,19,15963,2606,18569
2,25,11,1,2017,20,14823,2570,17393
2,25,11,1,2017,21,13797,2468,16265
2,25,11,1,2017,22,13188,2311,15499
2,25,11,1,2017,23,12827,2162,14989
2,25,11,1,2017,24,12559,2042,14601
2,26,11,1,2017,1,12543,1915,14458
2,26,11,1,2017,2,12982,1775,14757
2,26,11,1,2017,3,13464,1672,15136
2,26,11,1,2017,4,13710,1613,15323
2,26,11,1,2017,5,14012,1604,15616
2,26,11,1,2017,6,14688,1654,16342
2,26,11,1,2017,7,15659,1682,17341
2,26,11,1,2017,8,16041,1727,17768
2,26,11,1,2017,9,16167,1846,18013
2,26,11,1,2017,10,16230,1992,18222
2,26,11,1,2017,11,16867,2098,18965
2,26,11,1,2017,12,17751,2153,19904
2,26,11,1,2017,13,17623,2126,19749
2,26,11,1,2017,14,17469,2057,19526
2,26,11,1,2017,15,17257,2022,19279
2,26,11,1,2017,16,17059,2003,19062
2,26,11,1,2017,17,16673,1999,18672
2,26,11,1,2017,18,15508,2039,17547
2,26,11,1,2017,19,15192,2222,17414
2,26,11,1,2017,20,14208,2245,16453
2,26,11,1,2017,21,13411,2221,15632
2,26,11,1,2017,22,12967,2177,15144
2,26,11,1,2017,23,12525,2116,14641
2,26,11,1,2017,24,12128,2029,14157
1,27,11,1,2017,1,12299,1889,14188
1,27,11,1,2017,2,12708,1741,14449
1,27,11,1,2017,3,13114,1646,14760
1,27,11,1,2017,4,13331,1587,14918
1,27,11,1,2017,5,13865,1586,15451
1,27,11,1,2017,6,14982,1713,16695
1,27,11,1,2017,7,15941,1886,17827
1,27,11,1,2017,8,16385,2036,18421
1,27,11,1,2017,9,16598,2311,18909
1,27,11,1,2017,10,16358,2616,18974
1,27,11,1,2017,11,17145,2831,19976
1,27,11,1,2017,12,17846,2899,20745
1,27,11,1,2017,13,17967,2839,20806
1,27,11,1,2017,14,17388,2727,20115
1,27,11,1,2017,15,17587,2764,20351
1,27,11,1,2017,16,17495,2770,20265
1,27,11,1,2017,17,17101,2753,19854
1,27,11,1,2017,18,16245,2731,18976
1,27,11,1,2017,19,15928,2761,18689
1,27,11,1,2017,20,14925,2641,17566
1,27,11,1,2017,21,13836,2511,16347
1,27,11,1,2017,22,13523,2353,15876
1,27,11,1,2017,23,12712,2228,14940
1,27,11,1,2017,24,12473,2094,14567
1,28,11,1,2017,1,12686,1910,14596
1,28,11,1,2017,2,13064,1765,14829
1,28,11,1,2017,3,13678,1655,15333
1,28,11,1,2017,4,13816,1587,15403
1,28,11,1,2017,5,14096,1601,15697
1,28,11,1,2017,6,14835,1734,16569
1,28,11,1,2017,7,16204,1886,18090
1,28,11,1,2017,8,16761,2046,18807
1,28,11,1,2017,9,16707,2305,19012
1,28,11,1,2017,10,16522,2605,19127
1,28,11,1,2017,11,17216,2800,20016
1,28,11,1,2017,12,17910,2884,20794
1,28,11,1,2017,13,17724,2837,20561
1,28,11,1,2017,14,17620,2731,20351
1,28,11,1,2017,15,17350,2764,20114
1,28,11,1,2017,16,16869,2759,19628
1,28,11,1,2017,17,16961,2727,19688
1,28,11,1,2017,18,15847,2715,18562
1,28,11,1,2017,19,16160,2788,18948
1,28,11,1,2017,20,14909,2703,17612
1,28,11,1,2017,21,13991,2562,16553
1,28,11,1,2017,22,13361,2315,15676
1,28,11,1,2017,23,12727,2183,14910
1,28,11,1,2017,24,12343,2058,14401
1,29,11,1,2017,1,12485,1876,14361
1,29,11,1,2017,2,12873,1728,14601
1,29,11,1,2017,3,13704,1633,15337
1,29,11,1,2017,4,13833,1575,15408
1,29,11,1,2017,5,14043,1600,15643
1,29,11,1,2017,6,14831,1717,16548
1,29,11,1,2017,7,16252,1887,18139
1,29,11,1,2017,8,16852,2025,18877
1,29,11,1,2017,9,16551,2276,18827
1,29,11,1,2017,10,16615,2589,19204
1,29,11,1,2017,11,17089,2800,19889
1,29,11,1,2017,12,17854,2852,20706
1,29,11,1,2017,13,17908,2805,20713
1,29,11,1,2017,14,17305,2699,20004
1,29,11,1,2017,15,17649,2738,20387
1,29,11,1,2017,16,17223,2725,19948
1,29,11,1,2017,17,16752,2728,19480
1,29,11,1,2017,18,16004,2721,18725
1,29,11,1,2017,19,15893,2796,18689
1,29,11,1,2017,20,15152,2695,17847
1,29,11,1,2017,21,14051,2536,16587
1,29,11,1,2017,22,13194,2352,15546
1,29,11,1,2017,23,12672,2200,14872
1,29,11,1,2017,24,12328,2035,14363
1,30,11,1,2017,1,12415,1875,14290
1,30,11,1,2017,2,12921,1729,14650
1,30,11,1,2017,3,13576,1630,15206
1,30,11,1,2017,4,13734,1574,15308
1,30,11,1,2017,5,14170,1571,15741
1,30,11,1,2017,6,15060,1697,16757
1,30,11,1,2017,7,16155,1863,18018
1,30,11,1,2017,8,16825,2018,18843
1,30,11,1,2017,9,16724,2277,19001
1,30,11,1,2017,10,16580,2568,19148
1,30,11,1,2017,11,17312,2765,20077
1,30,11,1,2017,12,17990,2821,20811
1,30,11,1,2017,13,17745,2791,20536
1,30,11,1,2017,14,17431,2685,20116
1,30,11,1,2017,15,17384,2714,20098
1,30,11,1,2017,16,17197,2724,19921
1,30,11,1,2017,17,17199,2725,19924
1,30,11,1,2017,18,16117,2720,18837
1,30,11,1,2017,19,15666,2771,18437
1,30,11,1,2017,20,14981,2662,17643
1,30,11,1,2017,21,14144,2501,16645
1,30,11,1,2017,22,13023,2313,15336
1,30,11,1,2017,23,12615,2159,14774
1,30,11,1,2017,24,12221,2016,14237
3,1,12,1,2017,1,12404,1860,14264
3,1,12,1,2017,2,13155,1712,14867
3,1,12,1,2017,3,13725,1616,15341
3,1,12,1,2017,4,13674,1571,15245
3,1,12,1,2017,5,13950,1572,15522
3,1,12,1,2017,6,14849,1667,16516
3,1,12,1,2017,7,15820,1787,17607
3,1,12,1,2017,8,16583,1957,18540
3,1,12,1,2017,9,16402,2204,18606
3,1,12,1,2017,10,16438,2476,18914
3,1,12,1,2017,11,16894,2676,19570
3,1,12,1,2017,12,17523,2731,20254
3,1,12,1,2017,13,17398,2698,20096
3,1,12,1,2017,14,16960,2552,19512
3,1,12,1,2017,15,16853,2580,19433
3,1,12,1,2017,16,16383,2592,18975
3,1,12,1,2017,17,16555,2606,19161
3,1,12,1,2017,18,15567,2616,18183
3,1,12,1,2017,19,15138,2703,17841
3,1,12,1,2017,20,14313,2595,16908
3,1,12,1,2017,21,13438,2479,15917
3,1,12,1,2017,22,12844,2310,15154
3,1,12,1,2017,23,12137,2160,14297
3,1,12,1,2017,24,11971,2029,14000
2,2,12,1,2017,1,11991,1883,13874
2,2,12,1,2017,2,12461,1738,14199
2,2,12,1,2017,3,13202,1645,14847
2,2,12,1,2017,4,13360,1587,14947
2,2,12,1,2017,5,13637,1590,15227
2,2,12,1,2017,6,14752,1681,16433
2,2,12,1,2017,7,15673,1786,17459
2,2,12,1,2017,8,16136,1898,18034
2,2,12,1,2017,9,16300,2118,18418
2,2,12,1,2017,10,16380,2388,18768
2,2,12,1,2017,11,16794,2577,19371
2,2,12,1,2017,12,17479,2648,20127
2,2,12,1,2017,13,17040,2621,19661
2,2,12,1,2017,14,17048,2532,19580
2,2,12,1,2017,15,16865,2532,19397
2,2,12,1,2017,16,17048,2520,19568
2,2,12,1,2017,17,16570,2496,19066
2,2,12,1,2017,18,16033,2506,18539
2,2,12,1,2017,19,15414,2605,18019
2,2,12,1,2017,20,14451,2531,16982
2,2,12,1,2017,21,13406,2416,15822
2,2,12,1,2017,22,12981,2256,15237
2,2,12,1,2017,23,12342,2131,14473
2,2,12,1,2017,24,11978,2059,14037
2,3,12,1,2017,1,12240,1885,14125
2,3,12,1,2017,2,12745,1739,14484
2,3,12,1,2017,3,13241,1647,14888
2,3,12,1,2017,4,13551,1588,15139
2,3,12,1,2017,5,14074,1592,15666
2,3,12,1,2017,6,14627,1683,16310
2,3,12,1,2017,7,15183,1788,16971
2,3,12,1,2017,8,15830,1900,17730
2,3,12,1,2017,9,15958,2009,17967
2,3,12,1,2017,10,16172,1990,18162
2,3,12,1,2017,11,16793,2090,18883
2,3,12,1,2017,12,17567,2145,19712
2,3,12,1,2017,13,17167,2127,19294
2,3,12,1,2017,14,17000,2065,19065
2,3,12,1,2017,15,16843,2015,18858
2,3,12,1,2017,16,16861,1991,18852
2,3,12,1,2017,17,16404,1987,18391
2,3,12,1,2017,18,15263,2034,17297
2,3,12,1,2017,19,14862,2223,17085
2,3,12,1,2017,20,14160,2227,16387
2,3,12,1,2017,21,13289,2209,15498
2,3,12,1,2017,22,12917,2172,15089
2,3,12,1,2017,23,12302,2125,14427
2,3,12,1,2017,24,11880,2053,13933
1,4,12,1,2017,1,12089,1914,14003
1,4,12,1,2017,2,12321,1768,14089
1,4,12,1,2017,3,13012,1668,14680
1,4,12,1,2017,4,13193,1616,14809
1,4,12,1,2017,5,13782,1615,15397
1,4,12,1,2017,6,14411,1734,16145
1,4,12,1,2017,7,15624,1906,17530
1,4,12,1,2017,8,16416,2075,18491
1,4,12,1,2017,9,16385,2370,18755
1,4,12,1,2017,10,16289,2666,18955
1,4,12,1,2017,11,16908,2872,19780
1,4,12,1,2017,12,17426,2927,20353
1,4,12,1,2017,13,17257,2875,20132
1,4,12,1,2017,14,17283,2778,20061
1,4,12,1,2017,15,17120,2806,19926
1,4,12,1,2017,16,17180,2800,19980
1,4,12,1,2017,17,16586,2773,19359
1,4,12,1,2017,18,16025,2784,18809
1,4,12,1,2017,19,15242,2813,18055
1,4,12,1,2017,20,14244,2647,16891
1,4,12,1,2017,21,13236,2466,15702
1,4,12,1,2017,22,12828,2289,15117
1,4,12,1,2017,23,11975,2145,14120
1,4,12,1,2017,24,11631,1995,13626
1,5,12,1,2017,1,12159,1816,13975
1,5,12,1,2017,2,12603,1681,14284
1,5,12,1,2017,3,12797,1617,14414
1,5,12,1,2017,4,12956,1562,14518
1,5,12,1,2017,5,13522,1560,15082
1,5,12,1,2017,6,14470,1653,16123
1,5,12,1,2017,7,15481,1765,17246
1,5,12,1,2017,8,15666,1919,17585
1,5,12,1,2017,9,15847,2219,18066
1,5,12,1,2017,10,15767,2514,18281
1,5,12,1,2017,11,15622,2678,18300
1,5,12,1,2017,12,16133,2690,18823
1,5,12,1,2017,13,15669,2635,18304
1,5,12,1,2017,14,15600,2474,18074
1,5,12,1,2017,15,14779,2418,17197
1,5,12,1,2017,16,15249,2404,17653
1,5,12,1,2017,17,15178,2412,17590
1,5,12,1,2017,18,14981,2467,17448
1,5,12,1,2017,19,15302,2501,17803
1,5,12,1,2017,20,14184,2440,16624
1,5,12,1,2017,21,13151,2299,15450
1,5,12,1,2017,22,12296,2140,14436
1,5,12,1,2017,23,12008,1986,13994
1,5,12,1,2017,24,11665,1823,13488
1,6,12,1,2017,1,11208,1667,12875
1,6,12,1,2017,2,11649,1551,13200
1,6,12,1,2017,3,12054,1492,13546
1,6,12,1,2017,4,12302,1452,13754
1,6,12,1,2017,5,12705,1480,14185
1,6,12,1,2017,6,13702,1608,15310
1,6,12,1,2017,7,15131,1817,16948
1,6,12,1,2017,8,15925,2011,17936
1,6,12,1,2017,9,15945,2318,18263
1,6,12,1,2017,10,15992,2605,18597
1,6,12,1,2017,11,16655,2780,19435
1,6,12,1,2017,12,16479,2783,19262
1,6,12,1,2017,13,16159,2720,18879
1,6,12,1,2017,14,15864,2572,18436
1,6,12,1,2017,15,15992,2562,18554
1,6,12,1,2017,16,15935,2531,18466
1,6,12,1,2017,17,15913,2518,18431
1,6,12,1,2017,18,15423,2511,17934
1,6,12,1,2017,19,15474,2583,18057
1,6,12,1,2017,20,14831,2497,17328
1,6,12,1,2017,21,13740,2342,16082
1,6,12,1,2017,22,13087,2161,15248
1,6,12,1,2017,23,12576,1986,14562
1,6,12,1,2017,24,12062,1807,13869
1,7,12,1,2017,1,12070,1640,13710
1,7,12,1,2017,2,12446,1518,13964
1,7,12,1,2017,3,12676,1434,14110
1,7,12,1,2017,4,12866,1394,14260
1,7,12,1,2017,5,13612,1419,15031
1,7,12,1,2017,6,14552,1547,16099
1,7,12,1,2017,7,15590,1748,17338
1,7,12,1,2017,8,16560,1924,18484
1,7,12,1,2017,9,16191,2186,18377
1,7,12,1,2017,10,15939,2453,18392
1,7,12,1,2017,11,16807,2621,19428
1,7,12,1,2017,12,16825,2643,19468
1,7,12,1,2017,13,16552,2580,19132
1,7,12,1,2017,14,16432,2451,18883
1,7,12,1,2017,15,16483,2445,18928
1,7,12,1,2017,16,16178,2443,18621
1,7,12,1,2017,17,16087,2452,18539
1,7,12,1,2017,18,15444,2466,17910
1,7,12,1,2017,19,15199,2546,17745
1,7,12,1,2017,20,14633,2447,17080
1,7,12,1,2017,21,13684,2320,16004
1,7,12,1,2017,22,13060,2102,15162
1,7,12,1,2017,23,12520,1938,14458
1,7,12,1,2017,24,12059,1780,13839
1,8,12,1,2017,1,12091,1596,13687
1,8,12,1,2017,2,12380,1470,13850
1,8,12,1,2017,3,12830,1403,14233
1,8,12,1,2017,4,12865,1356,14221
1,8,12,1,2017,5,13148,1371,14519
1,8,12,1,2017,6,14132,1522,15654
1,8,12,1,2017,7,15542,1728,17270
1,8,12,1,2017,8,16136,1912,18048
1,8,12,1,2017,9,15898,2189,18087
1,8,12,1,2017,10,15441,2460,17901
1,8,12,1,2017,11,16072,2655,18727
1,8,12,1,2017,12,16597,2690,19287
1,8,12,1,2017,13,16138,2665,18803
1,8,12,1,2017,14,15945,2529,18474
1,8,12,1,2017,15,16263,2523,18786
1,8,12,1,2017,16,16158,2526,18684
1,8,12,1,2017,17,15871,2524,18395
1,8,12,1,2017,18,15165,2553,17718
1,8,12,1,2017,19,15114,2622,17736
1,8,12,1,2017,20,14606,2555,17161
1,8,12,1,2017,21,13414,2407,15821
1,8,12,1,2017,22,13116,2229,15345
1,8,12,1,2017,23,12528,2069,14597
1,8,12,1,2017,24,12286,1892,14178
2,9,12,1,2017,1,12513,1728,14241
2,9,12,1,2017,2,12885,1588,14473
2,9,12,1,2017,3,12809,1501,14310
2,9,12,1,2017,4,12887,1476,14363
2,9,12,1,2017,5,13306,1473,14779
2,9,12,1,2017,6,14748,1574,16322
2,9,12,1,2017,7,15905,1711,17616
2,9,12,1,2017,8,16503,1829,18332
2,9,12,1,2017,9,16388,2049,18437
2,9,12,1,2017,10,16136,2307,18443
2,9,12,1,2017,11,16710,2526,19236
2,9,12,1,2017,12,17184,2623,19807
2,9,12,1,2017,13,17194,2576,19770
2,9,12,1,2017,14,17482,2457,19939
2,9,12,1,2017,15,16380,2464,18844
2,9,12,1,2017,16,16622,2388,19010
2,9,12,1,2017,17,16552,2361,18913
2,9,12,1,2017,18,15830,2391,18221
2,9,12,1,2017,19,15860,2504,18364
2,9,12,1,2017,20,14508,2457,16965
2,9,12,1,2017,21,13699,2367,16066
2,9,12,1,2017,22,13271,2215,15486
2,9,12,1,2017,23,13271,2058,15329
2,9,12,1,2017,24,12938,1896,14834
2,10,12,1,2017,1,13277,1746,15023
2,10,12,1,2017,2,13017,1615,14632
2,10,12,1,2017,3,13158,1530,14688
2,10,12,1,2017,4,13312,1487,14799
2,10,12,1,2017,5,13934,1488,15422
2,10,12,1,2017,6,14768,1558,16326
2,10,12,1,2017,7,15620,1617,17237
2,10,12,1,2017,8,16318,1690,18008
2,10,12,1,2017,9,16460,1821,18281
2,10,12,1,2017,10,16317,1977,18294
2,10,12,1,2017,11,16748,2095,18843
2,10,12,1,2017,12,17409,2147,19556
2,10,12,1,2017,13,17207,2134,19341
2,10,12,1,2017,14,16764,2058,18822
2,10,12,1,2017,15,16678,1989,18667
2,10,12,1,2017,16,16452,1929,18381
2,10,12,1,2017,17,16117,1903,18020
2,10,12,1,2017,18,15292,1956,17248
2,10,12,1,2017,19,14970,2138,17108
2,10,12,1,2017,20,13916,2156,16072
2,10,12,1,2017,21,13374,2148,15522
2,10,12,1,2017,22,12925,2090,15015
2,10,12,1,2017,23,12648,1989,14637
2,10,12,1,2017,24,12466,1861,14327
1,11,12,1,2017,1,12710,1704,14414
1,11,12,1,2017,2,12705,1574,14279
1,11,12,1,2017,3,12864,1494,14358
1,11,12,1,2017,4,12906,1450,14356
1,11,12,1,2017,5,13225,1470,14695
1,11,12,1,2017,6,14716,1594,16310
1,11,12,1,2017,7,15767,1801,17568
1,11,12,1,2017,8,16721,1993,18714
1,11,12,1,2017,9,16653,2283,18936
1,11,12,1,2017,10,16582,2583,19165
1,11,12,1,2017,11,16594,2774,19368
1,11,12,1,2017,12,17302,2819,20121
1,11,12,1,2017,13,17211,2693,19904
1,11,12,1,2017,14,16792,2670,19462
1,11,12,1,2017,15,16884,2550,19434
1,11,12,1,2017,16,16600,2586,19186
1,11,12,1,2017,17,16576,2541,19117
1,11,12,1,2017,18,15451,2580,18031
1,11,12,1,2017,19,15318,2565,17883
1,11,12,1,2017,20,14520,2549,17069
1,11,12,1,2017,21,13735,2375,16110
1,11,12,1,2017,22,13244,2190,15434
1,11,12,1,2017,23,12789,2023,14812
1,11,12,1,2017,24,12873,1852,14725
1,12,12,1,2017,1,13084,1699,14783
1,12,12,1,2017,2,13136,1560,14696
1,12,12,1,2017,3,13126,1482,14608
1,12,12,1,2017,4,13247,1442,14689
1,12,12,1,2017,5,13836,1451,15287
1,12,12,1,2017,6,15107,1588,16695
1,12,12,1,2017,7,16662,1787,18449
1,12,12,1,2017,8,17148,1964,19112
1,12,12,1,2017,9,16914,2239,19153
1,12,12,1,2017,10,16640,2511,19151
1,12,12,1,2017,11,16912,2688,19600
1,12,12,1,2017,12,17200,2716,19916
1,12,12,1,2017,13,17051,2655,19706
1,12,12,1,2017,14,16807,2528,19335
1,12,12,1,2017,15,16712,2552,19264
1,12,12,1,2017,16,16659,2550,19209
1,12,12,1,2017,17,16393,2535,18928
1,12,12,1,2017,18,15810,2525,18335
1,12,12,1,2017,19,15414,2594,18008
1,12,12,1,2017,20,14581,2509,17090
1,12,12,1,2017,21,13685,2331,16016
1,12,12,1,2017,22,13136,2148,15284
1,12,12,1,2017,23,12789,1970,14759
1,12,12,1,2017,24,12770,1782,14552
1,13,12,1,2017,1,13084,1631,14715
1,13,12,1,2017,2,13083,1498,14581
1,13,12,1,2017,3,13011,1457,14468
1,13,12,1,2017,4,13187,1420,14607
1,13,12,1,2017,5,13398,1434,14832
1,13,12,1,2017,6,14935,1562,16497
1,13,12,1,2017,7,16511,1751,18262
1,13,12,1,2017,8,17391,1942,19333
1,13,12,1,2017,9,17183,2205,19388
1,13,12,1,2017,10,16984,2458,19442
1,13,12,1,2017,11,17307,2608,19915
1,13,12,1,2017,12,17617,2630,20247
1,13,12,1,2017,13,17408,2543,19951
1,13,12,1,2017,14,17223,2441,19664
1,13,12,1,2017,15,17077,2434,19511
1,13,12,1,2017,16,16637,2454,19091
1,13,12,1,2017,17,16612,2447,19059
1,13,12,1,2017,18,15962,2440,18402
1,13,12,1,2017,19,15672,2498,18170
1,13,12,1,2017,20,14688,2410,17098
1,13,12,1,2017,21,13895,2312,16207
1,13,12,1,2017,22,13270,2145,15415
1,13,12,1,2017,23,12829,1947,14776
1,13,12,1,2017,24,12688,1815,14503
1,14,12,1,2017,1,12952,1590,14542
1,14,12,1,2017,2,13066,1468,14534
1,14,12,1,2017,3,13268,1400,14668
1,14,12,1,2017,4,13164,1369,14533
1,14,12,1,2017,5,13525,1375,14900
1,14,12,1,2017,6,14973,1513,16486
1,14,12,1,2017,7,16612,1732,18344
1,14,12,1,2017,8,17333,1913,19246
1,14,12,1,2017,9,17336,2154,19490
1,14,12,1,2017,10,16976,2421,19397
1,14,12,1,2017,11,17360,2580,19940
1,14,12,1,2017,12,17557,2635,20192
1,14,12,1,2017,13,17575,2558,20133
1,14,12,1,2017,14,17097,2436,19533
1,14,12,1,2017,15,17084,2433,19517
1,14,12,1,2017,16,16847,2431,19278
1,14,12,1,2017,17,16778,2430,19208
1,14,12,1,2017,18,15467,2422,17889
1,14,12,1,2017,19,15397,2508,17905
1,14,12,1,2017,20,14525,2415,16940
1,14,12,1,2017,21,13776,2277,16053
1,14,12,1,2017,22,13303,2109,15412
1,14,12,1,2017,23,12950,1922,14872
1,14,12,1,2017,24,12742,1742,14484
1,15,12,1,2017,1,13128,1569,14697
1,15,12,1,2017,2,13225,1445,14670
1,15,12,1,2017,3,13275,1373,14648
1,15,12,1,2017,4,13426,1336,14762
1,15,12,1,2017,5,13838,1373,15211
1,15,12,1,2017,6,14968,1511,16479
1,15,12,1,2017,7,16065,1730,17795
1,15,12,1,2017,8,17109,1910,19019
1,15,12,1,2017,9,16872,2152,19024
1,15,12,1,2017,10,16762,2440,19202
1,15,12,1,2017,11,16539,2629,19168
1,15,12,1,2017,12,17045,2678,19723
1,15,12,1,2017,13,17079,2624,19703
1,15,12,1,2017,14,16694,2465,19159
1,15,12,1,2017,15,16516,2484,19000
1,15,12,1,2017,16,16381,2490,18871
1,15,12,1,2017,17,16175,2501,18676
1,15,12,1,2017,18,15647,2514,18161
1,15,12,1,2017,19,15353,2581,17934
1,15,12,1,2017,20,14318,2493,16811
1,15,12,1,2017,21,13646,2358,16004
1,15,12,1,2017,22,13186,2167,15353
1,15,12,1,2017,23,12919,1985,14904
1,15,12,1,2017,24,12721,1812,14533
2,16,12,1,2017,1,13106,1641,14747
2,16,12,1,2017,2,12943,1531,14474
2,16,12,1,2017,3,12871,1434,14305
2,16,12,1,2017,4,13042,1394,14436
2,16,12,1,2017,5,13438,1401,14839
2,16,12,1,2017,6,14667,1509,16176
2,16,12,1,2017,7,15993,1654,17647
2,16,12,1,2017,8,17086,1799,18885
2,16,12,1,2017,9,16875,2027,18902
2,16,12,1,2017,10,16624,2307,18931
2,16,12,1,2017,11,17074,2512,19586
2,16,12,1,2017,12,17397,2592,19989
2,16,12,1,2017,13,17362,2534,19896
2,16,12,1,2017,14,17018,2413,19431
2,16,12,1,2017,15,16844,2433,19277
2,16,12,1,2017,16,16572,2420,18992
2,16,12,1,2017,17,16685,2414,19099
2,16,12,1,2017,18,16029,2419,18448
2,16,12,1,2017,19,15383,2530,17913
2,16,12,1,2017,20,14682,2484,17166
2,16,12,1,2017,21,13719,2309,16028
2,16,12,1,2017,22,12904,2158,15062
2,16,12,1,2017,23,12986,2015,15001
2,16,12,1,2017,24,12765,1882,14647
2,17,12,1,2017,1,13132,1713,14845
2,17,12,1,2017,2,13202,1579,14781
2,17,12,1,2017,3,13310,1496,14806
2,17,12,1,2017,4,13368,1447,14815
2,17,12,1,2017,5,13726,1450,15176
2,17,12,1,2017,6,14546,1523,16069
2,17,12,1,2017,7,15629,1598,17227
2,17,12,1,2017,8,16204,1655,17859
2,17,12,1,2017,9,16215,1789,18004
2,17,12,1,2017,10,16663,1934,18597
2,17,12,1,2017,11,17049,2035,19084
2,17,12,1,2017,12,17428,2071,19499
2,17,12,1,2017,13,16932,2043,18975
2,17,12,1,2017,14,16591,1961,18552
2,17,12,1,2017,15,16362,1903,18265
2,17,12,1,2017,16,16485,1874,18359
2,17,12,1,2017,17,16047,1868,17915
2,17,12,1,2017,18,15336,1934,17270
2,17,12,1,2017,19,14892,2099,16991
2,17,12,1,2017,20,13887,2142,16029
2,17,12,1,2017,21,13202,2111,15313
2,17,12,1,2017,22,12622,2036,14658
2,17,12,1,2017,23,12582,1933,14515
2,17,12,1,2017,24,12313,1795,14108
1,18,12,1,2017,1,12643,1648,14291
1,18,12,1,2017,2,12470,1520,13990
1,18,12,1,2017,3,12570,1452,14022
1,18,12,1,2017,4,12644,1413,14057
1,18,12,1,2017,5,12969,1420,14389
1,18,12,1,2017,6,14100,1551,15651
1,18,12,1,2017,7,15667,1755,17422
1,18,12,1,2017,8,16782,1940,18722
1,18,12,1,2017,9,16644,2219,18863
1,18,12,1,2017,10,16679,2474,19153
1,18,12,1,2017,11,16948,2663,19611
1,18,12,1,2017,12,17317,2728,20045
1,18,12,1,2017,13,17334,2662,19996
1,18,12,1,2017,14,17042,2535,19577
1,18,12,1,2017,15,16828,2546,19374
1,18,12,1,2017,16,17006,2575,19581
1,18,12,1,2017,17,16488,2554,19042
1,18,12,1,2017,18,15797,2546,18343
1,18,12,1,2017,19,15261,2612,17873
1,18,12,1,2017,20,14495,2554,17049
1,18,12,1,2017,21,13703,2362,16065
1,18,12,1,2017,22,12977,2254,15231
1,18,12,1,2017,23,12588,1965,14553
1,18,12,1,2017,24,12473,1823,14296
1,19,12,1,2017,1,12621,1671,14292
1,19,12,1,2017,2,12546,1542,14088
1,19,12,1,2017,3,12554,1485,14039
1,19,12,1,2017,4,12589,1457,14046
1,19,12,1,2017,5,13268,1478,14746
1,19,12,1,2017,6,14174,1598,15772
1,19,12,1,2017,7,15659,1788,17447
1,19,12,1,2017,8,16774,1967,18741
1,19,12,1,2017,9,16997,2243,19240
1,19,12,1,2017,10,16391,2492,18883
1,19,12,1,2017,11,16620,2663,19283
1,19,12,1,2017,12,16995,2691,19686
1,19,12,1,2017,13,16596,2633,19229
1,19,12,1,2017,14,16200,2516,18716
1,19,12,1,2017,15,16578,2538,19116
1,19,12,1,2017,16,16542,2549,19091
1,19,12,1,2017,17,16292,2549,18841
1,19,12,1,2017,18,15719,2541,18260
1,19,12,1,2017,19,15219,2624,17843
1,19,12,1,2017,20,14343,2558,16901
1,19,12,1,2017,21,13480,2402,15882
1,19,12,1,2017,22,12580,2225,14805
1,19,12,1,2017,23,12167,2056,14223
1,19,12,1,2017,24,11930,1869,13799
1,20,12,1,2017,1,12403,1694,14097
1,20,12,1,2017,2,12189,1586,13775
1,20,12,1,2017,3,12387,1541,13928
1,20,12,1,2017,4,12501,1517,14018
1,20,12,1,2017,5,13056,1529,14585
1,20,12,1,2017,6,14241,1631,15872
1,20,12,1,2017,7,15840,1758,17598
1,20,12,1,2017,8,17003,1925,18928
1,20,12,1,2017,9,17248,2208,19456
1,20,12,1,2017,10,16984,2466,19450
1,20,12,1,2017,11,17232,2632,19864
1,20,12,1,2017,12,17403,2686,20089
1,20,12,1,2017,13,16890,2627,19517
1,20,12,1,2017,14,16726,2497,19223
1,20,12,1,2017,15,16690,2516,19206
1,20,12,1,2017,16,16680,2528,19208
1,20,12,1,2017,17,16327,2543,18870
1,20,12,1,2017,18,15698,2546,18244
1,20,12,1,2017,19,15534,2614,18148
1,20,12,1,2017,20,14482,2551,17033
1,20,12,1,2017,21,13680,2402,16082
1,20,12,1,2017,22,13119,2211,15330
1,20,12,1,2017,23,12563,2038,14601
1,20,12,1,2017,24,12255,1845,14100
1,21,12,1,2017,1,12849,1687,14536
1,21,12,1,2017,2,12417,1550,13967
1,21,12,1,2017,3,12622,1458,14080
1,21,12,1,2017,4,12664,1426,14090
1,21,12,1,2017,5,13123,1436,14559
1,21,12,1,2017,6,14216,1551,15767
1,21,12,1,2017,7,15887,1756,17643
1,21,12,1,2017,8,16939,1918,18857
1,21,12,1,2017,9,16993,2178,19171
1,21,12,1,2017,10,16800,2457,19257
1,21,12,1,2017,11,17281,2643,19924
1,21,12,1,2017,12,17711,2675,20386
1,21,12,1,2017,13,17171,2624,19795
1,21,12,1,2017,14,16931,2506,19437
1,21,12,1,2017,15,16888,2530,19418
1,21,12,1,2017,16,16636,2547,19183
1,21,12,1,2017,17,16580,2552,19132
1,21,12,1,2017,18,15700,2551,18251
1,21,12,1,2017,19,15351,2626,17977
1,21,12,1,2017,20,14419,2552,16971
1,21,12,1,2017,21,13705,2398,16103
1,21,12,1,2017,22,13110,2236,15346
1,21,12,1,2017,23,12731,2057,14788
1,21,12,1,2017,24,12485,1884,14369
1,22,12,1,2017,1,12552,1708,14260
1,22,12,1,2017,2,12727,1579,14306
1,22,12,1,2017,3,12677,1496,14173
1,22,12,1,2017,4,13007,1448,14455
1,22,12,1,2017,5,13272,1458,14730
1,22,12,1,2017,6,14324,1569,15893
1,22,12,1,2017,7,16060,1740,17800
1,22,12,1,2017,8,17039,1908,18947
1,22,12,1,2017,9,16954,2184,19138
1,22,12,1,2017,10,16685,2471,19156
1,22,12,1,2017,11,16844,2648,19492
1,22,12,1,2017,12,17343,2716,20059
1,22,12,1,2017,13,17071,2667,19738
1,22,12,1,2017,14,16770,2501,19271
1,22,12,1,2017,15,16655,2523,19178
1,22,12,1,2017,16,16363,2541,18904
1,22,12,1,2017,17,15887,2546,18433
1,22,12,1,2017,18,15113,2537,17650
1,22,12,1,2017,19,15100,2606,17706
1,22,12,1,2017,20,14381,2541,16922
1,22,12,1,2017,21,13465,2396,15861
1,22,12,1,2017,22,12865,2195,15060
1,22,12,1,2017,23,12244,2020,14264
1,22,12,1,2017,24,12205,1844,14049
2,23,12,1,2017,1,12537,1679,14216
2,23,12,1,2017,2,12427,1549,13976
2,23,12,1,2017,3,12433,1465,13898
2,23,12,1,2017,4,12680,1415,14095
2,23,12,1,2017,5,13070,1424,14494
2,23,12,1,2017,6,13999,1521,15520
2,23,12,1,2017,7,15618,1628,17246
2,23,12,1,2017,8,16574,1727,18301
2,23,12,1,2017,9,16804,1935,18739
2,23,12,1,2017,10,17336,2183,19519
2,23,12,1,2017,11,16885,2382,19267
2,23,12,1,2017,12,17658,2467,20125
2,23,12,1,2017,13,17374,2417,19791
2,23,12,1,2017,14,17081,2271,19352
2,23,12,1,2017,15,16922,2275,19197
2,23,12,1,2017,16,16874,2265,19139
2,23,12,1,2017,17,16597,2286,18883
2,23,12,1,2017,18,15831,2298,18129
2,23,12,1,2017,19,15264,2409,17673
2,23,12,1,2017,20,14326,2384,16710
2,23,12,1,2017,21,13386,2267,15653
2,23,12,1,2017,22,12897,2107,15004
2,23,12,1,2017,23,12562,1943,14505
2,23,12,1,2017,24,12513,1779,14292
2,24,12,1,2017,1,12816,1622,14438
2,24,12,1,2017,2,12542,1498,14040
2,24,12,1,2017,3,12695,1421,14116
2,24,12,1,2017,4,12843,1370,14213
2,24,12,1,2017,5,13255,1378,14633
2,24,12,1,2017,6,13946,1462,15408
2,24,12,1,2017,7,15211,1527,16738
2,24,12,1,2017,8,16298,1576,17874
2,24,12,1,2017,9,16792,1695,18487
2,24,12,1,2017,10,16578,1823,18401
2,24,12,1,2017,11,16856,1940,18796
2,24,12,1,2017,12,17646,1990,19636
2,24,12,1,2017,13,17220,1985,19205
2,24,12,1,2017,14,16952,1911,18863
2,24,12,1,2017,15,16919,1866,18785
2,24,12,1,2017,16,16647,1817,18464
2,24,12,1,2017,17,16227,1789,18016
2,24,12,1,2017,18,15142,1827,16969
2,24,12,1,2017,19,14759,2000,16759
2,24,12,1,2017,20,13984,2047,16031
2,24,12,1,2017,21,13129,2019,15148
2,24,12,1,2017,22,12278,1990,14268
2,24,12,1,2017,23,12112,1826,13938
2,24,12,1,2017,24,12056,1717,13773
1,26,12,1,2017,1,12615,1604,14219
1,26,12,1,2017,2,12607,1481,14088
1,26,12,1,2017,3,12533,1403,13936
1,26,12,1,2017,4,12678,1366,14044
1,26,12,1,2017,5,13031,1368,14399
1,26,12,1,2017,6,14124,1477,15601
1,26,12,1,2017,7,15546,1606,17152
1,26,12,1,2017,8,17033,1786,18819
1,26,12,1,2017,9,17175,2073,19248
1,26,12,1,2017,10,17143,2385,19528
1,26,12,1,2017,11,17289,2560,19849
1,26,12,1,2017,12,17796,2606,20402
1,26,12,1,2017,13,17445,2562,20007
1,26,12,1,2017,14,17219,2439,19658
1,26,12,1,2017,15,17121,2479,19600
1,26,12,1,2017,16,16799,2481,19280
1,26,12,1,2017,17,16742,2483,19225
1,26,12,1,2017,18,15897,2491,18388
1,26,12,1,2017,19,15510,2548,18058
1,26,12,1,2017,20,14533,2463,16996
1,26,12,1,2017,21,13701,2319,16020
1,26,12,1,2017,22,13080,2157,15237
1,26,12,1,2017,23,12660,1974,14634
1,26,12,1,2017,24,12626,1813,14439
1,27,12,1,2017,1,12709,1647,14356
1,27,12,1,2017,2,12846,1527,14373
1,27,12,1,2017,3,12754,1456,14210
1,27,12,1,2017,4,12907,1412,14319
1,27,12,1,2017,5,13443,1428,14871
1,27,12,1,2017,6,14160,1534,15694
1,27,12,1,2017,7,15819,1653,17472
1,27,12,1,2017,8,16738,1831,18569
1,27,12,1,2017,9,17291,2137,19428
1,27,12,1,2017,10,17023,2427,19450
1,27,12,1,2017,11,17269,2617,19886
1,27,12,1,2017,12,17249,2664,19913
1,27,12,1,2017,13,17047,2648,19695
1,27,12,1,2017,14,16739,2501,19240
1,27,12,1,2017,15,16722,2519,19241
1,27,12,1,2017,16,16449,2504,18953
1,27,12,1,2017,17,16262,2505,18767
1,27,12,1,2017,18,15492,2499,17991
1,27,12,1,2017,19,15277,2546,17823
1,27,12,1,2017,20,14733,2475,17208
1,27,12,1,2017,21,13771,2311,16082
1,27,12,1,2017,22,13062,2126,15188
1,27,12,1,2017,23,12651,1949,14600
1,27,12,1,2017,24,12446,1796,14242
1,28,12,1,2017,1,12412,1652,14064
1,28,12,1,2017,2,12434,1520,13954
1,28,12,1,2017,3,12480,1442,13922
1,28,12,1,2017,4,12624,1396,14020
1,28,12,1,2017,5,12822,1412,14234
1,28,12,1,2017,6,13917,1507,15424
1,28,12,1,2017,7,15582,1634,17216
1,28,12,1,2017,8,16372,1811,18183
1,28,12,1,2017,9,16914,2092,19006
1,28,12,1,2017,10,16919,2388,19307
1,28,12,1,2017,11,17063,2571,19634
1,28,12,1,2017,12,17498,2599,20097
1,28,12,1,2017,13,17164,2574,19738
1,28,12,1,2017,14,16848,2437,19285
1,28,12,1,2017,15,16673,2441,19114
1,28,12,1,2017,16,16532,2444,18976
1,28,12,1,2017,17,16733,2443,19176
1,28,12,1,2017,18,15098,2434,17532
1,28,12,1,2017,19,15034,2502,17536
1,28,12,1,2017,20,14384,2444,16828
1,28,12,1,2017,21,13726,2255,15981
1,28,12,1,2017,22,12803,2093,14896
1,28,12,1,2017,23,12601,1926,14527
1,28,12,1,2017,24,12404,1740,14144
1,29,12,1,2017,1,12596,1602,14198
1,29,12,1,2017,2,12693,1481,14174
1,29,12,1,2017,3,12544,1405,13949
1,29,12,1,2017,4,12521,1369,13890
1,29,12,1,2017,5,12890,1379,14269
1,29,12,1,2017,6,14043,1473,15516
1,29,12,1,2017,7,15396,1602,16998
1,29,12,1,2017,8,16726,1778,18504
1,29,12,1,2017,9,16669,2057,18726
1,29,12,1,2017,10,16795,2349,19144
1,29,12,1,2017,11,16559,2555,19114
1,29,12,1,2017,12,17416,2614,20030
1,29,12,1,2017,13,17045,2615,19660
1,29,12,1,2017,14,16960,2454,19414
1,29,12,1,2017,15,15991,2452,18443
1,29,12,1,2017,16,16096,2469,18565
1,29,12,1,2017,17,15879,2461,18340
1,29,12,1,2017,18,15228,2463,17691
1,29,12,1,2017,19,15084,2551,17635
1,29,12,1,2017,20,14319,2495,16814
1,29,12,1,2017,21,13380,2300,15680
1,29,12,1,2017,22,12776,2128,14904
1,29,12,1,2017,23,12415,1933,14348
1,29,12,1,2017,24,12305,1745,14050
2,30,12,1,2017,1,12575,1615,14190
2,30,12,1,2017,2,12542,1489,14031
2,30,12,1,2017,3,12442,1407,13849
2,30,12,1,2017,4,12489,1392,13881
2,30,12,1,2017,5,13000,1396,14396
2,30,12,1,2017,6,14069,1501,15570
2,30,12,1,2017,7,15357,1592,16949
2,30,12,1,2017,8,16689,1715,18404
2,30,12,1,2017,9,16822,1920,18742
2,30,12,1,2017,10,16717,2192,18909
2,30,12,1,2017,11,16825,2372,19197
2,30,12,1,2017,12,17623,2442,20065
2,30,12,1,2017,13,17432,2409,19841
2,30,12,1,2017,14,16848,2272,19120
2,30,12,1,2017,15,16728,2264,18992
2,30,12,1,2017,16,16577,2250,18827
2,30,12,1,2017,17,16440,2235,18675
2,30,12,1,2017,18,15296,2241,17537
2,30,12,1,2017,19,15085,2360,17445
2,30,12,1,2017,20,14169,2339,16508
2,30,12,1,2017,21,13440,2225,15665
2,30,12,1,2017,22,12548,2058,14606
2,30,12,1,2017,23,12296,1866,14162
2,30,12,1,2017,24,12246,1760,14006
2,31,12,1,2017,1,12562,1606,14168
2,31,12,1,2017,2,12422,1487,13909
2,31,12,1,2017,3,12468,1444,13912
2,31,12,1,2017,4,12615,1369,13984
2,31,12,1,2017,5,13072,1373,14445
2,31,12,1,2017,6,13681,1444,15125
2,31,12,1,2017,7,14894,1506,16400
2,31,12,1,2017,8,15946,1567,17513
2,31,12,1,2017,9,16546,1696,18242
2,31,12,1,2017,10,16762,1824,18586
2,31,12,1,2017,11,16706,1921,18627
2,31,12,1,2017,12,17641,1958,19599
2,31,12,1,2017,13,17403,1944,19347
2,31,12,1,2017,14,16871,1877,18748
2,31,12,1,2017,15,16658,1820,18478
2,31,12,1,2017,16,16350,1748,18098
2,31,12,1,2017,17,15727,1735,17462
2,31,12,1,2017,18,14514,1779,16293
2,31,12,1,2017,19,14000,1975,15975
2,31,12,1,2017,20,13389,2041,15430
2,31,12,1,2017,21,12529,1995,14524
2,31,12,1,2017,22,11724,1904,13628
2,31,12,1,2017,23,11418,1795,13213
2,31,12,1,2017,24,11558,1679,13237
